"","Player1","Player2","Opponent1","Opponent2","Rank","Year","Gender","Category","Matches","Wins","Losses","Points For","Points Against","Difference","win_pct","total_pts","shot_pct"
"1","Se Young AN",NA,"TAI Tzu Ying",NA,1,2023,"Women","Singles",7,6,1,328,271,57,0.857142857142857,599,0.547579298831386
"2","HAN Yue",NA,"ZHANG Yiman",NA,2,2023,"Women","Singles",6,4,2,294,281,13,0.666666666666667,575,0.511304347826087
"3","CHEN Yufei",NA,"Se Young AN",NA,3,2023,"Women","Singles",6,2,4,288,288,0,0.333333333333333,576,0.5
"4","Se Young AN",NA,"CHEN Yufei",NA,3,2023,"Women","Singles",6,4,2,288,288,0,0.666666666666667,576,0.5
"5","CHEN Yufei",NA,"Carolina MARIN",NA,5,2023,"Women","Singles",6,4,2,264,238,26,0.666666666666667,502,0.525896414342629
"6","Carolina MARIN",NA,"TAI Tzu Ying",NA,6,2023,"Women","Singles",5,3,2,255,221,34,0.6,476,0.535714285714286
"7","Se Young AN",NA,"HE Bingjiao",NA,7,2023,"Women","Singles",5,5,0,240,183,57,1,423,0.567375886524823
"8","Se Young AN",NA,"WANG Zhiyi",NA,8,2023,"Women","Singles",5,4,1,223,215,8,0.8,438,0.509132420091324
"9","Kirsty GILMOUR",NA,"Yvonne LI",NA,9,2023,"Women","Singles",5,3,2,222,198,24,0.6,420,0.528571428571429
"10","Gregoria Mariska TUNJUNG",NA,"PUSARLA V. Sindhu",NA,10,2023,"Women","Singles",5,2,3,221,203,18,0.4,424,0.52122641509434
"11","Se Young AN",NA,"Akane YAMAGUCHI",NA,11,2023,"Women","Singles",5,3,2,217,204,13,0.6,421,0.515439429928741
"12","Line HÃ¸jmark KJAERSFELDT",NA,"Yvonne LI",NA,12,2023,"Women","Singles",4,4,0,204,155,49,1,359,0.568245125348189
"13","CHEN Yufei",NA,"HAN Yue",NA,13,2023,"Women","Singles",4,4,0,202,147,55,1,349,0.578796561604584
"14","Akane YAMAGUCHI",NA,"Gregoria Mariska TUNJUNG",NA,14,2023,"Women","Singles",4,3,1,199,171,28,0.75,370,0.537837837837838
"15","HAN Yue",NA,"YEO Jia Min",NA,14,2023,"Women","Singles",4,4,0,199,152,47,1,351,0.566951566951567
"16","CHEN Yufei",NA,"HE Bingjiao",NA,16,2023,"Women","Singles",4,4,0,192,152,40,1,344,0.558139534883721
"17","Akane YAMAGUCHI",NA,"CHEN Yufei",NA,17,2023,"Women","Singles",4,3,1,188,176,12,0.75,364,0.516483516483517
"18","WANG Zhiyi",NA,"ZHANG Yiman",NA,18,2023,"Women","Singles",4,2,2,186,167,19,0.5,353,0.526912181303116
"19","CHEN Yufei",NA,"WANG Zhiyi",NA,19,2023,"Women","Singles",4,4,0,182,152,30,1,334,0.544910179640719
"20","TAI Tzu Ying",NA,"Supanida KATETHONG",NA,20,2023,"Women","Singles",4,4,0,178,141,37,1,319,0.557993730407524
"21","TAI Tzu Ying",NA,"ZHANG Yiman",NA,21,2023,"Women","Singles",4,3,1,174,125,49,0.75,299,0.581939799331104
"22","WANG Zhiyi",NA,"Saena KAWAKAMI",NA,22,2023,"Women","Singles",4,4,0,170,109,61,1,279,0.609318996415771
"23","Ratchanok INTANON",NA,"Wen Chi HSU",NA,23,2023,"Women","Singles",4,4,0,168,117,51,1,285,0.589473684210526
"24","Busanan ONGBAMRUNGPHAN",NA,"Aya OHORI",NA,24,2023,"Women","Singles",4,3,1,166,152,14,0.75,318,0.522012578616352
"25","Gregoria Mariska TUNJUNG",NA,"KIM Ga Eun",NA,25,2023,"Women","Singles",3,3,0,162,142,20,1,304,0.532894736842105
"26","BAEK Ha Na","LEE So Hee","Nami MATSUYAMA","Chiharu SHIDA",1,2023,"Women","Doubles",7,6,1,352,329,23,0.857142857142857,681,0.516886930983847
"27","Nami MATSUYAMA","Chiharu SHIDA","Benyapa AIMSAARD","Nuntakarn AIMSAARD",2,2023,"Women","Doubles",5,4,1,238,199,39,0.8,437,0.544622425629291
"28","CHEN Qingchen","JIA Yifan","Nami MATSUYAMA","Chiharu SHIDA",3,2023,"Women","Doubles",5,4,1,204,165,39,0.8,369,0.552845528455285
"29","CHEN Qingchen","JIA Yifan","KIM So Yeong","KONG Hee Yong",4,2023,"Women","Doubles",4,2,2,195,171,24,0.5,366,0.532786885245902
"30","Nami MATSUYAMA","Chiharu SHIDA","Yuki FUKUSHIMA","Sayaka HIROTA",5,2023,"Women","Doubles",4,4,0,193,150,43,1,343,0.56268221574344
"31","Jongkolphan KITITHARAKUL","Rawinda PRAJONGJAI","Rin IWANAGA","Kie NAKANISHI",6,2023,"Women","Doubles",4,3,1,191,160,31,0.75,351,0.544159544159544
"32","LI Yijing","LUO Xumin","HSU Ya Ching","LIN Wan Ching",6,2023,"Women","Doubles",3,2,1,191,168,23,0.666666666666667,359,0.532033426183844
"33","Yuki FUKUSHIMA","Sayaka HIROTA","LI Wenmei","LIU Xuanxuan",8,2023,"Women","Doubles",5,2,3,185,155,30,0.4,340,0.544117647058823
"34","BAEK Ha Na","LEE So Hee","Apriyani RAHAYU","Siti Fadia Silva RAMADHANTI",10,2023,"Women","Doubles",4,3,1,184,157,27,0.75,341,0.539589442815249
"35","Maiken FRUERGAARD","Sara THYGESEN","Chloe BIRCH","Lauren SMITH",10,2023,"Women","Doubles",4,4,0,184,137,47,1,321,0.573208722741433
"36","Mayu MATSUMOTO","Wakana NAGAHARA","HSU Ya Ching","LIN Wan Ching",10,2023,"Women","Doubles",4,4,0,184,119,65,1,303,0.607260726072607
"37","KIM So Yeong","KONG Hee Yong","LI Wenmei","LIU Xuanxuan",12,2023,"Women","Doubles",3,2,1,178,170,8,0.666666666666667,348,0.511494252873563
"38","Rena MIYAURA","Ayako SAKURAMOTO","LIU Sheng Shu","TAN Ning",13,2023,"Women","Doubles",3,2,1,172,167,5,0.666666666666667,339,0.507374631268437
"39","KIM So Yeong","KONG Hee Yong","Benyapa AIMSAARD","Nuntakarn AIMSAARD",14,2023,"Women","Doubles",4,4,0,170,110,60,1,280,0.607142857142857
"40","Febriana Dwipuji KUSUMA","Amalia Cahaya PRATIWI","Lanny Tria MAYASARI","Ribka SUGIARTO",15,2023,"Women","Doubles",4,3,1,169,150,19,0.75,319,0.529780564263323
"41","LIU Sheng Shu","TAN Ning","Maiken FRUERGAARD","Sara THYGESEN",16,2023,"Women","Doubles",4,4,0,168,120,48,1,288,0.583333333333333
"42","LIU Sheng Shu","TAN Ning","Mayu MATSUMOTO","Wakana NAGAHARA",17,2023,"Women","Doubles",4,3,1,164,146,18,0.75,310,0.529032258064516
"43","LEE Yu Lim","SHIN Seung Chan","Febriana Dwipuji KUSUMA","Amalia Cahaya PRATIWI",17,2023,"Women","Doubles",3,3,0,164,140,24,1,304,0.539473684210526
"44","Yuki FUKUSHIMA","Sayaka HIROTA","Apriyani RAHAYU","Siti Fadia Silva RAMADHANTI",19,2023,"Women","Doubles",4,2,2,163,150,13,0.5,313,0.520766773162939
"45","CHEN Qingchen","JIA Yifan","BAEK Ha Na","LEE So Hee",20,2023,"Women","Doubles",4,3,1,156,130,26,0.75,286,0.545454545454545
"46","Rin IWANAGA","Kie NAKANISHI","LEE Chia Hsin","TENG Chun Hsun",21,2023,"Women","Doubles",3,3,0,153,129,24,1,282,0.542553191489362
"47","TAN Pearly Koong Le","Muralitharan THINAAH","Mayu MATSUMOTO","Wakana NAGAHARA",22,2023,"Women","Doubles",3,2,1,152,140,12,0.666666666666667,292,0.520547945205479
"48","Mayu MATSUMOTO","Wakana NAGAHARA","Benyapa AIMSAARD","Nuntakarn AIMSAARD",23,2023,"Women","Doubles",3,2,1,151,127,24,0.666666666666667,278,0.543165467625899
"49","KIM So Yeong","KONG Hee Yong","Mayu MATSUMOTO","Wakana NAGAHARA",24,2023,"Women","Doubles",3,2,1,150,135,15,0.666666666666667,285,0.526315789473684
"50","Nami MATSUYAMA","Chiharu SHIDA","LIU Sheng Shu","TAN Ning",24,2023,"Women","Doubles",3,2,1,150,134,16,0.666666666666667,284,0.528169014084507
"51","Kodai NARAOKA",NA,"SHI Yuqi",NA,1,2023,"Men","Singles",6,4,2,301,287,14,0.666666666666667,588,0.511904761904762
"52","Kodai NARAOKA",NA,"Anders ANTONSEN",NA,2,2023,"Men","Singles",6,4,2,266,262,4,0.666666666666667,528,0.503787878787879
"53","SHI Yuqi",NA,"LU Guangzu",NA,3,2023,"Men","Singles",5,4,1,230,208,22,0.8,438,0.525114155251142
"54","Viktor AXELSEN",NA,"Christo POPOV",NA,4,2023,"Men","Singles",4,4,0,200,146,54,1,346,0.578034682080925
"55","Anders ANTONSEN",NA,"WENG Hongyang",NA,5,2023,"Men","Singles",4,4,0,197,174,23,1,371,0.53099730458221
"56","Anthony Sinisuka GINTING",NA,"LI Shifeng",NA,6,2023,"Men","Singles",4,3,1,187,170,17,0.75,357,0.523809523809524
"57","LIN Chun-Yi",NA,"Toma Junior POPOV",NA,7,2023,"Men","Singles",4,2,2,185,183,2,0.5,368,0.502717391304348
"58","Viktor AXELSEN",NA,"Jonatan CHRISTIE",NA,8,2023,"Men","Singles",4,4,0,183,122,61,1,305,0.6
"59","WENG Hongyang",NA,"LEE Zii Jia",NA,9,2023,"Men","Singles",4,3,1,182,173,9,0.75,355,0.512676056338028
"60","Viktor AXELSEN",NA,"SHI Yuqi",NA,10,2023,"Men","Singles",4,3,1,181,148,33,0.75,329,0.550151975683891
"61","LOH Kean Yew",NA,"Kodai NARAOKA",NA,10,2023,"Men","Singles",3,3,0,181,135,46,1,316,0.572784810126582
"62","Kodai NARAOKA",NA,"PRANNOY H. S.",NA,12,2023,"Men","Singles",4,3,1,179,146,33,0.75,325,0.550769230769231
"63","LI Shifeng",NA,"LEE Zii Jia",NA,13,2023,"Men","Singles",3,2,1,175,156,19,0.666666666666667,331,0.528700906344411
"64","Kenta NISHIMOTO",NA,"Jonatan CHRISTIE",NA,15,2023,"Men","Singles",4,2,2,174,160,14,0.5,334,0.520958083832335
"65","WENG Hongyang",NA,"KIDAMBI Srikanth",NA,15,2023,"Men","Singles",3,2,1,174,147,27,0.666666666666667,321,0.542056074766355
"66","PRANNOY H. S.",NA,"LEE Cheuk Yiu",NA,15,2023,"Men","Singles",3,2,1,174,173,1,0.666666666666667,347,0.501440922190202
"67","Mads CHRISTOPHERSEN",NA,"Alex LANIER",NA,17,2023,"Men","Singles",3,1,2,171,171,0,0.333333333333333,342,0.5
"68","Alex LANIER",NA,"Mads CHRISTOPHERSEN",NA,17,2023,"Men","Singles",3,2,1,171,171,0,0.666666666666667,342,0.5
"69","Anders ANTONSEN",NA,"Toma Junior POPOV",NA,19,2023,"Men","Singles",3,3,0,169,151,18,1,320,0.528125
"70","LEE Zii Jia",NA,"Tze Yong NG",NA,20,2023,"Men","Singles",3,3,0,168,147,21,1,315,0.533333333333333
"71","LOH Kean Yew",NA,"Christo POPOV",NA,21,2023,"Men","Singles",4,2,2,166,158,8,0.5,324,0.512345679012346
"72","Kenta NISHIMOTO",NA,"LEE Zii Jia",NA,23,2023,"Men","Singles",4,2,2,165,165,0,0.5,330,0.5
"73","LEE Zii Jia",NA,"Kenta NISHIMOTO",NA,23,2023,"Men","Singles",4,2,2,165,165,0,0.5,330,0.5
"74","Kunlavut VITIDSARN",NA,"WANG Tzu Wei",NA,23,2023,"Men","Singles",3,3,0,165,132,33,1,297,0.555555555555556
"75","LEE Zii Jia",NA,"Kodai NARAOKA",NA,23,2023,"Men","Singles",3,1,2,165,157,8,0.333333333333333,322,0.512422360248447
"76","Min Hyuk KANG","SEO Seung Jae","Fajar ALFIAN","Muhammad Rian ARDIANTO",1,2023,"Men","Doubles",6,3,3,302,302,0,0.5,604,0.5
"77","Fajar ALFIAN","Muhammad Rian ARDIANTO","Min Hyuk KANG","SEO Seung Jae",1,2023,"Men","Doubles",6,3,3,302,302,0,0.5,604,0.5
"78","LIANG Weikeng","WANG Chang","Aaron CHIA","SOH Wooi Yik",3,2023,"Men","Doubles",5,4,1,249,227,22,0.8,476,0.523109243697479
"79","Pramudya Kusumawardana RIYANTO","Yeremia Erich Yoche YACOB","Ayato ENDO","Yuta TAKEI",4,2023,"Men","Doubles",4,4,0,229,194,35,1,423,0.541371158392435
"80","Min Hyuk KANG","SEO Seung Jae","Takuro HOKI","Yugo KOBAYASHI",5,2023,"Men","Doubles",5,4,1,216,195,21,0.8,411,0.525547445255474
"81","Satwiksairaj RANKIREDDY","Chirag SHETTY","LIANG Weikeng","WANG Chang",6,2023,"Men","Doubles",4,1,3,213,202,11,0.25,415,0.513253012048193
"82","Min Hyuk KANG","SEO Seung Jae","Mohammad AHSAN","Hendra SETIAWAN",7,2023,"Men","Doubles",4,3,1,210,186,24,0.75,396,0.53030303030303
"83","Min Hyuk KANG","SEO Seung Jae","LEE Yang","WANG Chi-Lin",8,2023,"Men","Doubles",4,3,1,206,183,23,0.75,389,0.529562982005141
"84","LIU Yuchen","OU Xuanyi","Ben LANE","Sean VENDY",9,2023,"Men","Doubles",4,4,0,205,184,21,1,389,0.526992287917738
"85","Mohammad AHSAN","Hendra SETIAWAN","Pramudya Kusumawardana RIYANTO","Yeremia Erich Yoche YACOB",10,2023,"Men","Doubles",4,3,1,200,182,18,0.75,382,0.523560209424084
"86","Kim ASTRUP","Anders Skaarup RASMUSSEN","Mark LAMSFUSS","Marvin SEIDEL",11,2023,"Men","Doubles",3,2,1,178,161,17,0.666666666666667,339,0.525073746312684
"87","LEE Yang","WANG Chi-Lin","ONG Yew Sin","TEO Ee Yi",12,2023,"Men","Doubles",3,2,1,172,166,6,0.666666666666667,338,0.50887573964497
"88","Fajar ALFIAN","Muhammad Rian ARDIANTO","Muhammad Shohibul FIKRI","Bagas MAULANA",13,2023,"Men","Doubles",4,3,1,170,157,13,0.75,327,0.519877675840979
"89","Min Hyuk KANG","SEO Seung Jae","LIU Yuchen","OU Xuanyi",15,2023,"Men","Doubles",4,4,0,168,123,45,1,291,0.577319587628866
"90","Kim ASTRUP","Anders Skaarup RASMUSSEN","Keiichiro MATSUI","Yoshinori TAKEUCHI",15,2023,"Men","Doubles",4,4,0,168,109,59,1,277,0.606498194945848
"91","Akira KOGA","Taichi SAITO","Aaron CHIA","SOH Wooi Yik",15,2023,"Men","Doubles",4,3,1,168,161,7,0.75,329,0.51063829787234
"92","Aaron CHIA","SOH Wooi Yik","Muhammad Shohibul FIKRI","Bagas MAULANA",15,2023,"Men","Doubles",4,4,0,168,115,53,1,283,0.593639575971731
"93","LIANG Weikeng","WANG Chang","Mohammad AHSAN","Hendra SETIAWAN",18,2023,"Men","Doubles",3,2,1,167,159,8,0.666666666666667,326,0.512269938650307
"94","LIU Yuchen","OU Xuanyi","Akira KOGA","Taichi SAITO",19,2023,"Men","Doubles",3,2,1,164,151,13,0.666666666666667,315,0.520634920634921
"95","LIANG Weikeng","WANG Chang","Pramudya Kusumawardana RIYANTO","Yeremia Erich Yoche YACOB",20,2023,"Men","Doubles",3,2,1,159,138,21,0.666666666666667,297,0.535353535353535
"96","Muhammad Shohibul FIKRI","Bagas MAULANA","Satwiksairaj RANKIREDDY","Chirag SHETTY",21,2023,"Men","Doubles",3,2,1,158,152,6,0.666666666666667,310,0.509677419354839
"97","Satwiksairaj RANKIREDDY","Chirag SHETTY","Leo Rolly CARNANDO","Daniel MARTHIN",22,2023,"Men","Doubles",3,3,0,156,125,31,1,281,0.555160142348754
"98","Kim ASTRUP","Anders Skaarup RASMUSSEN","Leo Rolly CARNANDO","Daniel MARTHIN",22,2023,"Men","Doubles",3,2,1,156,133,23,0.666666666666667,289,0.539792387543253
"99","Leo Rolly CARNANDO","Daniel MARTHIN","Aaron CHIA","SOH Wooi Yik",24,2023,"Men","Doubles",4,3,1,155,150,5,0.75,305,0.508196721311475
"100","LEE Jhe-Huei","YANG Po-Hsuan","Keiichiro MATSUI","Yoshinori TAKEUCHI",25,2023,"Men","Doubles",3,2,1,153,132,21,0.666666666666667,285,0.536842105263158
"101","ZHENG Siwei","HUANG Yaqiong","SEO Seung Jae","CHAE YuJung",1,2023,"Mixed","Doubles",8,6,2,401,324,77,0.75,725,0.553103448275862
"102","Yuta WATANABE","Arisa HIGASHINO","TANG Chun Man","TSE Ying Suet",2,2023,"Mixed","Doubles",6,5,1,278,243,35,0.833333333333333,521,0.533589251439539
"103","TANG Chun Man","TSE Ying Suet","Rehan Naufal KUSHARJANTO","Lisa Ayu KUSUMAWATI",3,2023,"Mixed","Doubles",5,5,0,265,196,69,1,461,0.574837310195228
"104","FENG Yanzhe","HUANG Dongping","Dechapol PUAVARANUKROH","Sapsiree TAERATTANACHAI",4,2023,"Mixed","Doubles",5,3,2,253,248,5,0.6,501,0.50499001996008
"105","Dechapol PUAVARANUKROH","Sapsiree TAERATTANACHAI","SEO Seung Jae","CHAE YuJung",5,2023,"Mixed","Doubles",5,3,2,238,231,7,0.6,469,0.507462686567164
"106","ZHENG Siwei","HUANG Yaqiong","FENG Yanzhe","HUANG Dongping",6,2023,"Mixed","Doubles",5,4,1,232,182,50,0.8,414,0.560386473429952
"107","TANG Chun Man","TSE Ying Suet","GOH Soon Huat","LAI Shevon Jemie",7,2023,"Mixed","Doubles",5,5,0,231,172,59,1,403,0.573200992555831
"108","SEO Seung Jae","CHAE YuJung","JIANG Zhenbang","WEI Yaxin",7,2023,"Mixed","Doubles",5,4,1,231,202,29,0.8,433,0.533487297921478
"109","FENG Yanzhe","HUANG Dongping","Yuta WATANABE","Arisa HIGASHINO",9,2023,"Mixed","Doubles",4,3,1,227,208,19,0.75,435,0.52183908045977
"110","FENG Yanzhe","HUANG Dongping","Hiroki MIDORIKAWA","Natsu SAITO",10,2023,"Mixed","Doubles",5,5,0,226,160,66,1,386,0.585492227979275
"111","FENG Yanzhe","HUANG Dongping","JIANG Zhenbang","WEI Yaxin",10,2023,"Mixed","Doubles",5,5,0,226,172,54,1,398,0.5678391959799
"112","Dechapol PUAVARANUKROH","Sapsiree TAERATTANACHAI","Mathias CHRISTIANSEN","Alexandra BÃJE",12,2023,"Mixed","Doubles",5,3,2,210,178,32,0.6,388,0.541237113402062
"113","Yuta WATANABE","Arisa HIGASHINO","LEE Chun Hei Reginald","NG Tsz Yau",13,2023,"Mixed","Doubles",4,4,0,205,150,55,1,355,0.577464788732394
"114","KIM Won Ho","JEONG Na Eun","Kyohei YAMASHITA","Naru SHINOYA",14,2023,"Mixed","Doubles",4,3,1,204,189,15,0.75,393,0.519083969465649
"115","JIANG Zhenbang","WEI Yaxin","Praveen JORDAN","Melati Daeva OKTAVIANTI",15,2023,"Mixed","Doubles",4,3,1,197,167,30,0.75,364,0.541208791208791
"116","ZHENG Siwei","HUANG Yaqiong","KIM Won Ho","JEONG Na Eun",16,2023,"Mixed","Doubles",4,2,2,188,165,23,0.5,353,0.53257790368272
"117","Mathias CHRISTIANSEN","Alexandra BÃJE","YANG Po-Hsuan","HU Ling Fang",17,2023,"Mixed","Doubles",3,3,0,185,150,35,1,335,0.552238805970149
"118","Dechapol PUAVARANUKROH","Sapsiree TAERATTANACHAI","CHEN Tang Jie","TOH Ee Wei",18,2023,"Mixed","Doubles",4,3,1,175,150,25,0.75,325,0.538461538461538
"119","ZHENG Siwei","HUANG Yaqiong","Yuta WATANABE","Arisa HIGASHINO",19,2023,"Mixed","Doubles",4,2,2,172,157,15,0.5,329,0.522796352583587
"120","Yuta WATANABE","Arisa HIGASHINO","YE Hong Wei","LEE Chia Hsin",19,2023,"Mixed","Doubles",4,2,2,172,169,3,0.5,341,0.504398826979472
"121","ZHENG Siwei","HUANG Yaqiong","Dejan FERDINANSYAH","Gloria Emanuelle WIDJAJA",21,2023,"Mixed","Doubles",4,4,0,168,106,62,1,274,0.613138686131387
"122","Hiroki NISHI","Akari SATO","Ruttanapak OUPTHONG","Kwanchanok SUDJAIPRAPARAT",22,2023,"Mixed","Doubles",3,2,1,167,150,17,0.666666666666667,317,0.526813880126183
"123","TANG Chun Man","TSE Ying Suet","KIM Won Ho","JEONG Na Eun",23,2023,"Mixed","Doubles",3,2,1,165,158,7,0.666666666666667,323,0.510835913312694
"124","LEE Chun Hei Reginald","NG Tsz Yau","YE Hong Wei","LEE Chia Hsin",24,2023,"Mixed","Doubles",3,2,1,163,150,13,0.666666666666667,313,0.520766773162939
"125","HEE Yong Kai Terry","TAN Wei Han","DHRUV KAPILA","Tanisha CRASTO",24,2023,"Mixed","Doubles",3,2,1,163,149,14,0.666666666666667,312,0.522435897435897
"126","CHEN Yufei",NA,"TAI Tzu Ying",NA,1,2022,"Women","Singles",5,3,2,267,252,15,0.6,519,0.514450867052023
"127","Akane YAMAGUCHI",NA,"WANG Zhiyi",NA,2,2022,"Women","Singles",5,3,2,262,247,15,0.6,509,0.514734774066798
"128","TAI Tzu Ying",NA,"Ratchanok INTANON",NA,3,2022,"Women","Singles",5,4,1,247,209,38,0.8,456,0.541666666666667
"129","Akane YAMAGUCHI",NA,"CHEN Yufei",NA,4,2022,"Women","Singles",5,4,1,233,201,32,0.8,434,0.536866359447005
"130","Akane YAMAGUCHI",NA,"Se Young AN",NA,5,2022,"Women","Singles",5,4,1,225,176,49,0.8,401,0.561097256857855
"131","CHEN Yufei",NA,"ZHANG Yiman",NA,6,2022,"Women","Singles",5,5,0,221,164,57,1,385,0.574025974025974
"132","Se Young AN",NA,"HAN Yue",NA,6,2022,"Women","Singles",4,3,1,221,202,19,0.75,423,0.522458628841608
"133","CHEN Yufei",NA,"Ratchanok INTANON",NA,8,2022,"Women","Singles",4,3,1,211,183,28,0.75,394,0.535532994923858
"134","Se Young AN",NA,"Gregoria Mariska TUNJUNG",NA,9,2022,"Women","Singles",4,4,0,192,133,59,1,325,0.590769230769231
"135","HE Bingjiao",NA,"CHEN Yufei",NA,10,2022,"Women","Singles",5,3,2,190,176,14,0.6,366,0.519125683060109
"136","Gregoria Mariska TUNJUNG",NA,"Akane YAMAGUCHI",NA,11,2022,"Women","Singles",4,2,2,184,179,5,0.5,363,0.506887052341598
"137","Nozomi OKUHARA",NA,"Wen Chi HSU",NA,12,2022,"Women","Singles",3,3,0,179,146,33,1,325,0.550769230769231
"138","TAI Tzu Ying",NA,"Busanan ONGBAMRUNGPHAN",NA,13,2022,"Women","Singles",4,4,0,170,131,39,1,301,0.564784053156146
"139","HE Bingjiao",NA,"TAI Tzu Ying",NA,14,2022,"Women","Singles",4,2,2,165,161,4,0.5,326,0.506134969325153
"140","Supanida KATETHONG",NA,"PUSARLA V. Sindhu",NA,15,2022,"Women","Singles",3,1,2,163,155,8,0.333333333333333,318,0.512578616352201
"141","Yvonne LI",NA,"Julie Dawall JAKOBSEN",NA,16,2022,"Women","Singles",3,2,1,155,136,19,0.666666666666667,291,0.532646048109966
"142","HE Bingjiao",NA,"Busanan ONGBAMRUNGPHAN",NA,16,2022,"Women","Singles",3,3,0,155,120,35,1,275,0.563636363636364
"143","Ratchanok INTANON",NA,"HAN Yue",NA,18,2022,"Women","Singles",3,3,0,153,141,12,1,294,0.520408163265306
"144","PUSARLA V. Sindhu",NA,"HE Bingjiao",NA,19,2022,"Women","Singles",3,2,1,146,140,6,0.666666666666667,286,0.510489510489511
"145","CHEN Yufei",NA,"Michelle LI",NA,19,2022,"Women","Singles",3,3,0,146,110,36,1,256,0.5703125
"146","PUSARLA V. Sindhu",NA,"Lauren LAM",NA,22,2022,"Women","Singles",3,3,0,145,116,29,1,261,0.555555555555556
"147","Carolina MARIN",NA,"ZHANG Yiman",NA,22,2022,"Women","Singles",3,2,1,145,130,15,0.666666666666667,275,0.527272727272727
"148","Ratchanok INTANON",NA,"Kirsty GILMOUR",NA,22,2022,"Women","Singles",3,3,0,145,107,38,1,252,0.575396825396825
"149","HE Bingjiao",NA,"Akane YAMAGUCHI",NA,24,2022,"Women","Singles",3,2,1,144,139,5,0.666666666666667,283,0.508833922261484
"150","CHEN Yufei",NA,"Pornpawee CHOCHUWONG",NA,25,2022,"Women","Singles",3,3,0,143,116,27,1,259,0.552123552123552
"151","Benyapa AIMSAARD","Nuntakarn AIMSAARD","JEONG Na Eun","KIM Hye Jeong",1,2022,"Women","Doubles",6,4,2,250,230,20,0.666666666666667,480,0.520833333333333
"152","CHEN Qingchen","JIA Yifan","Jongkolphan KITITHARAKUL","Rawinda PRAJONGJAI",2,2022,"Women","Doubles",5,4,1,219,175,44,0.8,394,0.555837563451777
"153","DU Yue","LI Wenmei","Jongkolphan KITITHARAKUL","Rawinda PRAJONGJAI",3,2022,"Women","Doubles",4,3,1,208,185,23,0.75,393,0.529262086513995
"154","Nami MATSUYAMA","Chiharu SHIDA","JEONG Na Eun","KIM Hye Jeong",4,2022,"Women","Doubles",5,3,2,205,174,31,0.6,379,0.54089709762533
"155","CHEN Qingchen","JIA Yifan","Apriyani RAHAYU","Siti Fadia Silva RAMADHANTI",5,2022,"Women","Doubles",4,3,1,200,174,26,0.75,374,0.53475935828877
"156","TAN Pearly Koong Le","Muralitharan THINAAH","Apriyani RAHAYU","Siti Fadia Silva RAMADHANTI",6,2022,"Women","Doubles",4,2,2,195,190,5,0.5,385,0.506493506493506
"157","Apriyani RAHAYU","Siti Fadia Silva RAMADHANTI","ZHANG Shuxian","ZHENG Yu",7,2022,"Women","Doubles",4,3,1,187,186,1,0.75,373,0.501340482573727
"158","ZHANG Shuxian","ZHENG Yu","Jongkolphan KITITHARAKUL","Rawinda PRAJONGJAI",8,2022,"Women","Doubles",4,2,2,178,163,15,0.5,341,0.521994134897361
"159","TAN Pearly Koong Le","Muralitharan THINAAH","Yuki FUKUSHIMA","Sayaka HIROTA",9,2022,"Women","Doubles",4,2,2,174,165,9,0.5,339,0.513274336283186
"160","Jongkolphan KITITHARAKUL","Rawinda PRAJONGJAI","Treesa JOLLY","GAYATRI GOPICHAND PULLELA",10,2022,"Women","Doubles",4,4,0,173,137,36,1,310,0.558064516129032
"161","KIM So Yeong","KONG Hee Yong","Rachel HONDERICH","Kristen TSAI",11,2022,"Women","Doubles",3,3,0,164,124,40,1,288,0.569444444444444
"162","LEE So Hee","SHIN Seung Chan","ZHANG Shuxian","ZHENG Yu",12,2022,"Women","Doubles",3,1,2,153,147,6,0.333333333333333,300,0.51
"163","Jongkolphan KITITHARAKUL","Rawinda PRAJONGJAI","Benyapa AIMSAARD","Nuntakarn AIMSAARD",13,2022,"Women","Doubles",3,2,1,150,140,10,0.666666666666667,290,0.517241379310345
"164","CHEN Qingchen","JIA Yifan","TAN Pearly Koong Le","Muralitharan THINAAH",14,2022,"Women","Doubles",3,3,0,146,114,32,1,260,0.561538461538462
"165","ZHANG Shuxian","ZHENG Yu","Febriana Dwipuji KUSUMA","Amalia Cahaya PRATIWI",15,2022,"Women","Doubles",3,3,0,144,103,41,1,247,0.582995951417004
"166","CHEN Qingchen","JIA Yifan","ZHANG Shuxian","ZHENG Yu",15,2022,"Women","Doubles",3,3,0,144,120,24,1,264,0.545454545454545
"167","CHEN Qingchen","JIA Yifan","Nami MATSUYAMA","Chiharu SHIDA",17,2022,"Women","Doubles",3,2,1,135,116,19,0.666666666666667,251,0.537848605577689
"168","Nami MATSUYAMA","Chiharu SHIDA","TAN Pearly Koong Le","Muralitharan THINAAH",18,2022,"Women","Doubles",3,2,1,133,123,10,0.666666666666667,256,0.51953125
"169","ZHANG Shuxian","ZHENG Yu","Gabriela STOEVA","Stefani STOEVA",19,2022,"Women","Doubles",3,2,1,132,116,16,0.666666666666667,248,0.532258064516129
"170","CHEN Qingchen","JIA Yifan","Vivian HOO","LIM Chiew Sien",20,2022,"Women","Doubles",3,3,0,129,103,26,1,232,0.556034482758621
"171","Benyapa AIMSAARD","Nuntakarn AIMSAARD","Vivian HOO","LIM Chiew Sien",21,2022,"Women","Doubles",3,3,0,126,72,54,1,198,0.636363636363636
"172","Rena MIYAURA","Ayako SAKURAMOTO","Rui HIROKAMI","Yuna KATO",22,2022,"Women","Doubles",3,2,1,123,84,39,0.666666666666667,207,0.594202898550725
"173","JEONG Na Eun","KIM Hye Jeong","Supissara PAEWSAMPRAN","Puttita SUPAJIRAKUL",23,2022,"Women","Doubles",2,2,0,122,88,34,1,210,0.580952380952381
"174","CHEN Qingchen","JIA Yifan","BAEK Ha Na","LEE Yu Lim",23,2022,"Women","Doubles",2,1,1,122,111,11,0.5,233,0.523605150214592
"175","DU Yue","LI Wenmei","ZHANG Shuxian","ZHENG Yu",25,2022,"Women","Doubles",3,2,1,120,105,15,0.666666666666667,225,0.533333333333333
"176","Viktor AXELSEN",NA,"Anthony Sinisuka GINTING",NA,1,2022,"Men","Singles",6,6,0,289,183,106,1,472,0.61228813559322
"177","CHOU Tien Chen",NA,"LEE Cheuk Yiu",NA,2,2022,"Men","Singles",5,3,2,272,263,9,0.6,535,0.508411214953271
"178","Lakshya SEN",NA,"PRANNOY H. S.",NA,3,2022,"Men","Singles",5,3,2,213,203,10,0.6,416,0.512019230769231
"179","LEE Zii Jia",NA,"Shesar Hiren RHUSTAVITO",NA,4,2022,"Men","Singles",4,2,2,192,184,8,0.5,376,0.51063829787234
"180","Jonatan CHRISTIE",NA,"KIDAMBI Srikanth",NA,5,2022,"Men","Singles",4,2,2,170,162,8,0.5,332,0.512048192771084
"181","PRANNOY H. S.",NA,"LIEW Daren",NA,5,2022,"Men","Singles",3,2,1,170,163,7,0.666666666666667,333,0.510510510510511
"182","PRANNOY H. S.",NA,"CHOU Tien Chen",NA,7,2022,"Men","Singles",3,2,1,157,139,18,0.666666666666667,296,0.530405405405405
"183","Anthony Sinisuka GINTING",NA,"LOH Kean Yew",NA,8,2022,"Men","Singles",4,3,1,155,133,22,0.75,288,0.538194444444444
"184","CHEAM June Wei",NA,"LEONG Jun Hao",NA,9,2022,"Men","Singles",3,1,2,154,139,15,0.333333333333333,293,0.525597269624573
"185","CHOU Tien Chen",NA,"Jonatan CHRISTIE",NA,10,2022,"Men","Singles",3,2,1,150,131,19,0.666666666666667,281,0.533807829181495
"186","Viktor AXELSEN",NA,"Kodai NARAOKA",NA,11,2022,"Men","Singles",4,3,1,147,100,47,0.75,247,0.595141700404858
"187","KIDAMBI Srikanth",NA,"Brice LEVERDEZ",NA,12,2022,"Men","Singles",3,2,1,146,129,17,0.666666666666667,275,0.530909090909091
"188","LEE Zii Jia",NA,"Mark CALJOUW",NA,13,2022,"Men","Singles",3,3,0,145,98,47,1,243,0.596707818930041
"189","Jonatan CHRISTIE",NA,"Kodai NARAOKA",NA,14,2022,"Men","Singles",3,1,2,144,128,16,0.333333333333333,272,0.529411764705882
"190","Anthony Sinisuka GINTING",NA,"Sitthikom THAMMASIN",NA,15,2022,"Men","Singles",3,3,0,143,110,33,1,253,0.565217391304348
"191","Viktor AXELSEN",NA,"LU Guangzu",NA,15,2022,"Men","Singles",3,3,0,143,90,53,1,233,0.613733905579399
"192","PRANNOY H. S.",NA,"NG Ka Long Angus",NA,17,2022,"Men","Singles",4,3,1,142,131,11,0.75,273,0.52014652014652
"193","Viktor AXELSEN",NA,"Lakshya SEN",NA,18,2022,"Men","Singles",3,2,1,138,106,32,0.666666666666667,244,0.565573770491803
"194","ZHAO Junpeng",NA,"PRANNOY H. S.",NA,19,2022,"Men","Singles",3,2,1,136,119,17,0.666666666666667,255,0.533333333333333
"195","Kunlavut VITIDSARN",NA,"Jonatan CHRISTIE",NA,20,2022,"Men","Singles",3,1,2,135,121,14,0.333333333333333,256,0.52734375
"196","Kenta NISHIMOTO",NA,"Jonatan CHRISTIE",NA,20,2022,"Men","Singles",3,2,1,135,127,8,0.666666666666667,262,0.515267175572519
"197","Lakshya SEN",NA,"Anthony Sinisuka GINTING",NA,22,2022,"Men","Singles",3,3,0,134,98,36,1,232,0.577586206896552
"198","Kodai NARAOKA",NA,"Shesar Hiren RHUSTAVITO",NA,22,2022,"Men","Singles",3,2,1,134,113,21,0.666666666666667,247,0.54251012145749
"199","LU Guangzu",NA,"LI Shifeng",NA,24,2022,"Men","Singles",3,3,0,132,99,33,1,231,0.571428571428571
"200","Viktor AXELSEN",NA,"CHOU Tien Chen",NA,25,2022,"Men","Singles",3,3,0,126,82,44,1,208,0.605769230769231
"201","Fajar ALFIAN","Muhammad Rian ARDIANTO","ONG Yew Sin","TEO Ee Yi",1,2022,"Men","Doubles",5,4,1,237,202,35,0.8,439,0.539863325740319
"202","Fajar ALFIAN","Muhammad Rian ARDIANTO","LIU Yuchen","OU Xuanyi",2,2022,"Men","Doubles",4,2,2,198,188,10,0.5,386,0.512953367875648
"203","Kim ASTRUP","Anders Skaarup RASMUSSEN","Takuro HOKI","Yugo KOBAYASHI",3,2022,"Men","Doubles",3,2,1,185,181,4,0.666666666666667,366,0.505464480874317
"204","CHOI SolGyu","KIM Won Ho","Kim ASTRUP","Anders Skaarup RASMUSSEN",4,2022,"Men","Doubles",3,3,0,170,167,3,1,337,0.504451038575668
"205","Fajar ALFIAN","Muhammad Rian ARDIANTO","GOH Sze Fei","Nur IZZUDDIN",5,2022,"Men","Doubles",4,4,0,169,130,39,1,299,0.565217391304348
"206","Mohammad AHSAN","Hendra SETIAWAN","M.R. ARJUN","DHRUV KAPILA",6,2022,"Men","Doubles",4,4,0,159,134,25,1,293,0.542662116040956
"207","Fajar ALFIAN","Muhammad Rian ARDIANTO","Aaron CHIA","SOH Wooi Yik",6,2022,"Men","Doubles",3,3,0,159,127,32,1,286,0.555944055944056
"208","Aaron CHIA","SOH Wooi Yik","Satwiksairaj RANKIREDDY","Chirag SHETTY",8,2022,"Men","Doubles",3,3,0,158,142,16,1,300,0.526666666666667
"209","Min Hyuk KANG","SEO Seung Jae","Mohammad AHSAN","Hendra SETIAWAN",9,2022,"Men","Doubles",3,2,1,154,148,6,0.666666666666667,302,0.509933774834437
"210","LIU Yuchen","OU Xuanyi","Mohammad AHSAN","Hendra SETIAWAN",10,2022,"Men","Doubles",3,3,0,148,120,28,1,268,0.552238805970149
"211","LIU Yuchen","OU Xuanyi","CHOI SolGyu","KIM Won Ho",11,2022,"Men","Doubles",3,3,0,146,130,16,1,276,0.528985507246377
"212","LU Ching Yao","YANG Po Han","Ben LANE","Sean VENDY",12,2022,"Men","Doubles",3,3,0,143,105,38,1,248,0.576612903225806
"213","Mohammad AHSAN","Hendra SETIAWAN","REN Xiangyu","TAN Qiang",12,2022,"Men","Doubles",3,2,1,143,142,1,0.666666666666667,285,0.501754385964912
"214","CHOI SolGyu","KIM Won Ho","ONG Yew Sin","TEO Ee Yi",14,2022,"Men","Doubles",3,2,1,139,131,8,0.666666666666667,270,0.514814814814815
"215","Mohammad AHSAN","Hendra SETIAWAN","Muhammad Shohibul FIKRI","Bagas MAULANA",15,2022,"Men","Doubles",3,2,1,134,129,5,0.666666666666667,263,0.509505703422053
"216","Kim ASTRUP","Anders Skaarup RASMUSSEN","LU Ching Yao","YANG Po Han",16,2022,"Men","Doubles",3,2,1,133,105,28,0.666666666666667,238,0.558823529411765
"217","Aaron CHIA","SOH Wooi Yik","Mohammad AHSAN","Hendra SETIAWAN",17,2022,"Men","Doubles",3,2,1,131,129,2,0.666666666666667,260,0.503846153846154
"218","Fajar ALFIAN","Muhammad Rian ARDIANTO","M.R. ARJUN","DHRUV KAPILA",18,2022,"Men","Doubles",3,3,0,129,101,28,1,230,0.560869565217391
"219","Fajar ALFIAN","Muhammad Rian ARDIANTO","Akira KOGA","Taichi SAITO",19,2022,"Men","Doubles",3,3,0,128,105,23,1,233,0.549356223175966
"220","LIU Yuchen","OU Xuanyi","Christo POPOV","Toma Junior POPOV",20,2022,"Men","Doubles",2,2,0,122,108,14,1,230,0.530434782608696
"221","Muhammad Shohibul FIKRI","Bagas MAULANA","GOH Sze Fei","Nur IZZUDDIN",21,2022,"Men","Doubles",2,2,0,121,113,8,1,234,0.517094017094017
"222","Fajar ALFIAN","Muhammad Rian ARDIANTO","HEE Yong Kai Terry","LOH Kean Hean",22,2022,"Men","Doubles",2,2,0,119,98,21,1,217,0.548387096774194
"223","LIU Yuchen","OU Xuanyi","ONG Yew Sin","TEO Ee Yi",23,2022,"Men","Doubles",3,2,1,118,112,6,0.666666666666667,230,0.51304347826087
"224","Ruben JILLE","Ties VAN DER LECQ","Christo POPOV","Toma Junior POPOV",24,2022,"Men","Doubles",2,2,0,117,110,7,1,227,0.515418502202643
"225","Takuro HOKI","Yugo KOBAYASHI","Muhammad Shohibul FIKRI","Bagas MAULANA",24,2022,"Men","Doubles",2,1,1,117,112,5,0.5,229,0.510917030567686
"226","Dechapol PUAVARANUKROH","Sapsiree TAERATTANACHAI","WANG Yilyu","HUANG Dongping",1,2022,"Mixed","Doubles",5,5,0,249,204,45,1,453,0.549668874172185
"227","ZHENG Siwei","HUANG Yaqiong","Yuta WATANABE","Arisa HIGASHINO",2,2022,"Mixed","Doubles",4,3,1,205,165,40,0.75,370,0.554054054054054
"228","ZHENG Siwei","HUANG Yaqiong","WANG Yilyu","HUANG Dongping",3,2022,"Mixed","Doubles",4,3,1,179,147,32,0.75,326,0.549079754601227
"229","ZHENG Siwei","HUANG Yaqiong","Thom GICQUEL","Delphine DELRUE",4,2022,"Mixed","Doubles",4,4,0,174,120,54,1,294,0.591836734693878
"230","GOH Soon Huat","LAI Shevon Jemie","TAN Kian Meng","LAI Pei Jing",5,2022,"Mixed","Doubles",3,3,0,170,159,11,1,329,0.516717325227964
"231","Thom GICQUEL","Delphine DELRUE","Jones Ralfy JANSEN","Linda EFLER",6,2022,"Mixed","Doubles",3,3,0,164,137,27,1,301,0.54485049833887
"232","ZHENG Siwei","HUANG Yaqiong","Mathias CHRISTIANSEN","Alexandra BÃJE",7,2022,"Mixed","Doubles",3,3,0,163,131,32,1,294,0.554421768707483
"233","ZHENG Siwei","HUANG Yaqiong","Dechapol PUAVARANUKROH","Sapsiree TAERATTANACHAI",8,2022,"Mixed","Doubles",3,3,0,162,131,31,1,293,0.552901023890785
"234","Rehan Naufal KUSHARJANTO","Lisa Ayu KUSUMAWATI","Thom GICQUEL","Delphine DELRUE",9,2022,"Mixed","Doubles",3,3,0,161,132,29,1,293,0.549488054607508
"235","Yuta WATANABE","Arisa HIGASHINO","GOH Soon Huat","LAI Shevon Jemie",10,2022,"Mixed","Doubles",4,3,1,158,128,30,0.75,286,0.552447552447552
"236","ZHENG Siwei","HUANG Yaqiong","Supak JOMKOH","Supissara PAEWSAMPRAN",11,2022,"Mixed","Doubles",3,3,0,145,98,47,1,243,0.596707818930041
"237","Supak JOMKOH","Supissara PAEWSAMPRAN","Zachariah Josiahno SUMANTI","Hediana JULIMARBELA",12,2022,"Mixed","Doubles",3,2,1,144,133,11,0.666666666666667,277,0.51985559566787
"238","Marcus ELLIS","Lauren SMITH","Rinov RIVALDY","Pitha Haningtyas MENTARI",13,2022,"Mixed","Doubles",3,3,0,142,125,17,1,267,0.531835205992509
"239","Mathias CHRISTIANSEN","Alexandra BÃJE","TAN Kian Meng","LAI Pei Jing",14,2022,"Mixed","Doubles",3,1,2,132,129,3,0.333333333333333,261,0.505747126436782
"240","Mark LAMSFUSS","Isabel HERTTRICH","Rehan Naufal KUSHARJANTO","Lisa Ayu KUSUMAWATI",15,2022,"Mixed","Doubles",3,2,1,131,125,6,0.666666666666667,256,0.51171875
"241","Dechapol PUAVARANUKROH","Sapsiree TAERATTANACHAI","Supak JOMKOH","Supissara PAEWSAMPRAN",15,2022,"Mixed","Doubles",3,3,0,131,97,34,1,228,0.574561403508772
"242","Mathias CHRISTIANSEN","Alexandra BÃJE","HEE Yong Kai Terry","TAN Wei Han",17,2022,"Mixed","Doubles",3,3,0,127,99,28,1,226,0.561946902654867
"243","WANG Yilyu","HUANG Dongping","Rinov RIVALDY","Pitha Haningtyas MENTARI",18,2022,"Mixed","Doubles",3,3,0,126,85,41,1,211,0.597156398104265
"244","ZHENG Siwei","HUANG Yaqiong","TAN Kian Meng","LAI Pei Jing",18,2022,"Mixed","Doubles",3,3,0,126,73,53,1,199,0.633165829145729
"245","Rinov RIVALDY","Pitha Haningtyas MENTARI","Jones Ralfy JANSEN","Linda EFLER",20,2022,"Mixed","Doubles",2,2,0,121,100,21,1,221,0.547511312217195
"246","Thom GICQUEL","Delphine DELRUE","Mark LAMSFUSS","Isabel HERTTRICH",20,2022,"Mixed","Doubles",2,1,1,121,113,8,0.5,234,0.517094017094017
"247","Dechapol PUAVARANUKROH","Sapsiree TAERATTANACHAI","GOH Soon Huat","LAI Shevon Jemie",23,2022,"Mixed","Doubles",2,1,1,118,108,10,0.5,226,0.52212389380531
"248","ZHENG Siwei","HUANG Yaqiong","YANG Po-Hsuan","HU Ling Fang",23,2022,"Mixed","Doubles",2,2,0,118,102,16,1,220,0.536363636363636
"249","Yuta WATANABE","Arisa HIGASHINO","Mathias CHRISTIANSEN","Alexandra BÃJE",23,2022,"Mixed","Doubles",2,1,1,118,113,5,0.5,231,0.510822510822511
"250","Yuki KANEKO","Misaki MATSUTOMO","Robin TABELING","Selena PIEK",25,2022,"Mixed","Doubles",2,2,0,114,105,9,1,219,0.520547945205479
"251","Akane YAMAGUCHI",NA,"Se Young AN",NA,1,2021,"Women","Singles",6,4,2,281,274,7,0.666666666666667,555,0.506306306306306
"252","Akane YAMAGUCHI",NA,"Pornpawee CHOCHUWONG",NA,2,2021,"Women","Singles",4,3,1,210,207,3,0.75,417,0.503597122302158
"253","Mia BLICHFELDT",NA,"Yvonne LI",NA,3,2021,"Women","Singles",4,3,1,187,181,6,0.75,368,0.508152173913043
"254","Akane YAMAGUCHI",NA,"PUSARLA V. Sindhu",NA,4,2021,"Women","Singles",4,1,3,186,180,6,0.25,366,0.508196721311475
"255","PUSARLA V. Sindhu",NA,"Busanan ONGBAMRUNGPHAN",NA,5,2021,"Women","Singles",4,4,0,182,147,35,1,329,0.553191489361702
"256","TAI Tzu Ying",NA,"Ratchanok INTANON",NA,6,2021,"Women","Singles",3,3,0,177,157,20,1,334,0.529940119760479
"257","Se Young AN",NA,"Pornpawee CHOCHUWONG",NA,7,2021,"Women","Singles",4,4,0,172,132,40,1,304,0.565789473684211
"258","Pornpawee CHOCHUWONG",NA,"PUSARLA V. Sindhu",NA,8,2021,"Women","Singles",4,2,2,168,157,11,0.5,325,0.516923076923077
"259","Neslihan YIGIT",NA,"Yvonne LI",NA,9,2021,"Women","Singles",3,2,1,159,150,9,0.666666666666667,309,0.514563106796116
"260","Carolina MARIN",NA,"Pornpawee CHOCHUWONG",NA,10,2021,"Women","Singles",3,3,0,146,102,44,1,248,0.588709677419355
"261","TAI Tzu Ying",NA,"PUSARLA V. Sindhu",NA,11,2021,"Women","Singles",3,3,0,145,110,35,1,255,0.568627450980392
"262","PUSARLA V. Sindhu",NA,"Mia BLICHFELDT",NA,12,2021,"Women","Singles",3,2,1,143,121,22,0.666666666666667,264,0.541666666666667
"263","Ratchanok INTANON",NA,"PUSARLA V. Sindhu",NA,13,2021,"Women","Singles",3,3,0,141,97,44,1,238,0.592436974789916
"264","Akane YAMAGUCHI",NA,"KIM Ga Eun",NA,14,2021,"Women","Singles",3,3,0,140,127,13,1,267,0.524344569288389
"265","Carolina MARIN",NA,"Se Young AN",NA,14,2021,"Women","Singles",3,2,1,140,124,16,0.666666666666667,264,0.53030303030303
"266","Carolina MARIN",NA,"TAI Tzu Ying",NA,16,2021,"Women","Singles",3,2,1,132,117,15,0.666666666666667,249,0.530120481927711
"267","Pornpawee CHOCHUWONG",NA,"Line CHRISTOPHERSEN",NA,17,2021,"Women","Singles",3,3,0,129,90,39,1,219,0.589041095890411
"268","PUSARLA V. Sindhu",NA,"Neslihan YIGIT",NA,19,2021,"Women","Singles",3,3,0,126,80,46,1,206,0.611650485436893
"269","PUSARLA V. Sindhu",NA,"Line CHRISTOPHERSEN",NA,19,2021,"Women","Singles",3,3,0,126,74,52,1,200,0.63
"270","Se Young AN",NA,"Evgeniya KOSETSKAYA",NA,19,2021,"Women","Singles",3,3,0,126,73,53,1,199,0.633165829145729
"271","Se Young AN",NA,"Phittayaporn CHAIWAN",NA,19,2021,"Women","Singles",3,3,0,126,73,53,1,199,0.633165829145729
"272","Pornpawee CHOCHUWONG",NA,"Gregoria Mariska TUNJUNG",NA,22,2021,"Women","Singles",2,2,0,110,91,19,1,201,0.54726368159204
"273","Akane YAMAGUCHI",NA,"Line HÃ¸jmark KJAERSFELDT",NA,23,2021,"Women","Singles",2,2,0,105,76,29,1,181,0.580110497237569
"274","Akane YAMAGUCHI",NA,"YEO Jia Min",NA,24,2021,"Women","Singles",2,2,0,103,75,28,1,178,0.578651685393258
"275","Evgeniya KOSETSKAYA",NA,"PAI Yu Po",NA,24,2021,"Women","Singles",2,2,0,103,80,23,1,183,0.562841530054645
"276","KIM So Yeong","KONG Hee Yong","Jongkolphan KITITHARAKUL","Rawinda PRAJONGJAI",1,2021,"Women","Doubles",6,5,1,302,254,48,0.833333333333333,556,0.543165467625899
"277","LEE So Hee","SHIN Seung Chan","KIM So Yeong","KONG Hee Yong",2,2021,"Women","Doubles",6,4,2,268,267,1,0.666666666666667,535,0.500934579439252
"278","Jongkolphan KITITHARAKUL","Rawinda PRAJONGJAI","Ashwini PONNAPPA","REDDY N. Sikki",3,2021,"Women","Doubles",5,5,0,212,142,70,1,354,0.598870056497175
"279","Greysia POLII","Apriyani RAHAYU","TAN Pearly Koong Le","Muralitharan THINAAH",4,2021,"Women","Doubles",4,4,0,203,163,40,1,366,0.554644808743169
"280","Greysia POLII","Apriyani RAHAYU","LEE So Hee","SHIN Seung Chan",5,2021,"Women","Doubles",4,3,1,197,186,11,0.75,383,0.514360313315927
"281","KIM So Yeong","KONG Hee Yong","Linda EFLER","Isabel HERTTRICH",6,2021,"Women","Doubles",4,4,0,187,107,80,1,294,0.636054421768708
"282","Greysia POLII","Apriyani RAHAYU","Jongkolphan KITITHARAKUL","Rawinda PRAJONGJAI",7,2021,"Women","Doubles",4,4,0,185,143,42,1,328,0.564024390243902
"283","Puttita SUPAJIRAKUL","Sapsiree TAERATTANACHAI","Siti Fadia Silva RAMADHANTI","Ribka SUGIARTO",8,2021,"Women","Doubles",4,2,2,171,167,4,0.5,338,0.505917159763314
"284","Jongkolphan KITITHARAKUL","Rawinda PRAJONGJAI","Gabriela STOEVA","Stefani STOEVA",9,2021,"Women","Doubles",4,2,2,163,156,7,0.5,319,0.510971786833856
"285","Greysia POLII","Apriyani RAHAYU","Puttita SUPAJIRAKUL","Sapsiree TAERATTANACHAI",10,2021,"Women","Doubles",3,2,1,151,132,19,0.666666666666667,283,0.53356890459364
"286","Nami MATSUYAMA","Chiharu SHIDA","Puttita SUPAJIRAKUL","Sapsiree TAERATTANACHAI",11,2021,"Women","Doubles",3,3,0,148,122,26,1,270,0.548148148148148
"287","Nami MATSUYAMA","Chiharu SHIDA","TAN Pearly Koong Le","Muralitharan THINAAH",12,2021,"Women","Doubles",3,3,0,146,112,34,1,258,0.565891472868217
"288","Nami MATSUYAMA","Chiharu SHIDA","Chloe BIRCH","Lauren SMITH",13,2021,"Women","Doubles",4,3,1,145,107,38,0.75,252,0.575396825396825
"289","Jongkolphan KITITHARAKUL","Rawinda PRAJONGJAI","Benyapa AIMSAARD","Nuntakarn AIMSAARD",14,2021,"Women","Doubles",3,3,0,140,110,30,1,250,0.56
"290","Gabriela STOEVA","Stefani STOEVA","Chloe BIRCH","Lauren SMITH",16,2021,"Women","Doubles",3,3,0,126,75,51,1,201,0.626865671641791
"291","LEE So Hee","SHIN Seung Chan","Vivian HOO","YAP Cheng Wen",16,2021,"Women","Doubles",3,3,0,126,85,41,1,211,0.597156398104265
"292","Ashwini PONNAPPA","REDDY N. Sikki","Gabriela STOEVA","Stefani STOEVA",16,2021,"Women","Doubles",3,1,2,126,120,6,0.333333333333333,246,0.51219512195122
"293","LEE So Hee","SHIN Seung Chan","Nita Violina MARWAH","Putri SYAIKAH",18,2021,"Women","Doubles",2,2,0,112,107,5,1,219,0.511415525114155
"294","Anastasiia AKCHURINA","Olga MOROZOVA","Emilie LEFEL","Anne TRAN",19,2021,"Women","Doubles",2,2,0,109,95,14,1,204,0.534313725490196
"295","Chloe BIRCH","Lauren SMITH","Linda EFLER","Isabel HERTTRICH",20,2021,"Women","Doubles",2,2,0,104,74,30,1,178,0.584269662921348
"296","CHEN Qingchen","JIA Yifan","KIM So Yeong","KONG Hee Yong",21,2021,"Women","Doubles",2,2,0,103,77,26,1,180,0.572222222222222
"297","Chisato HOSHI","Aoi MATSUDA","Chloe BIRCH","Lauren SMITH",21,2021,"Women","Doubles",2,2,0,103,91,12,1,194,0.530927835051546
"298","LEE So Hee","SHIN Seung Chan","Maiken FRUERGAARD","Sara THYGESEN",23,2021,"Women","Doubles",2,1,1,102,93,9,0.5,195,0.523076923076923
"299","Jongkolphan KITITHARAKUL","Rawinda PRAJONGJAI","Julie FINNE-IPSEN","Mai SURROW",24,2021,"Women","Doubles",2,2,0,101,84,17,1,185,0.545945945945946
"300","Alexandra BÃJE","Mette POULSEN","Vivian HOO","LIM Chiew Sien",25,2021,"Women","Doubles",2,1,1,100,89,11,0.5,189,0.529100529100529
"301","Kento MOMOTA",NA,"LEE Zii Jia",NA,1,2021,"Men","Singles",4,2,2,175,167,8,0.5,342,0.511695906432749
"302","PRANNOY H. S.",NA,"LIEW Daren",NA,2,2021,"Men","Singles",4,3,1,162,125,37,0.75,287,0.564459930313589
"303","Anders ANTONSEN",NA,"WANG Tzu Wei",NA,3,2021,"Men","Singles",3,2,1,146,145,1,0.666666666666667,291,0.501718213058419
"304","Viktor AXELSEN",NA,"LEE Zii Jia",NA,4,2021,"Men","Singles",3,2,1,144,128,16,0.666666666666667,272,0.529411764705882
"305","WANG Tzu Wei",NA,"NG Ka Long Angus",NA,5,2021,"Men","Singles",3,2,1,140,106,34,0.666666666666667,246,0.569105691056911
"306","Viktor AXELSEN",NA,"Anthony Sinisuka GINTING",NA,6,2021,"Men","Singles",3,3,0,139,102,37,1,241,0.576763485477178
"307","Anders ANTONSEN",NA,"Sameer VERMA",NA,7,2021,"Men","Singles",3,2,1,137,126,11,0.666666666666667,263,0.520912547528517
"308","LOH Kean Yew",NA,"Viktor AXELSEN",NA,8,2021,"Men","Singles",3,1,2,136,129,7,0.333333333333333,265,0.513207547169811
"309","Viktor AXELSEN",NA,"KIDAMBI Srikanth",NA,11,2021,"Men","Singles",3,3,0,126,89,37,1,215,0.586046511627907
"310","Viktor AXELSEN",NA,"Kunlavut VITIDSARN",NA,11,2021,"Men","Singles",3,3,0,126,66,60,1,192,0.65625
"311","Anthony Sinisuka GINTING",NA,"LEE Zii Jia",NA,11,2021,"Men","Singles",3,2,1,126,120,6,0.666666666666667,246,0.51219512195122
"312","Viktor AXELSEN",NA,"Lakshya SEN",NA,11,2021,"Men","Singles",3,3,0,126,75,51,1,201,0.626865671641791
"313","Viktor AXELSEN",NA,"CHOU Tien Chen",NA,11,2021,"Men","Singles",3,3,0,126,83,43,1,209,0.602870813397129
"314","NG Ka Long Angus",NA,"CHOU Tien Chen",NA,14,2021,"Men","Singles",2,1,1,117,108,9,0.5,225,0.52
"315","Kunlavut VITIDSARN",NA,"LEE Zii Jia",NA,15,2021,"Men","Singles",3,2,1,115,106,9,0.666666666666667,221,0.520361990950226
"316","Kenta NISHIMOTO",NA,"CHOU Tien Chen",NA,16,2021,"Men","Singles",2,1,1,114,108,6,0.5,222,0.513513513513513
"317","Rasmus GEMKE",NA,"Ajay JAYARAM",NA,17,2021,"Men","Singles",2,1,1,113,110,3,0.5,223,0.506726457399103
"318","Viktor AXELSEN",NA,"Anders ANTONSEN",NA,18,2021,"Men","Singles",3,1,2,112,92,20,0.333333333333333,204,0.549019607843137
"319","KIDAMBI Srikanth",NA,"NG Ka Long Angus",NA,18,2021,"Men","Singles",2,1,1,112,105,7,0.5,217,0.516129032258065
"320","Anders ANTONSEN",NA,"Hans-Kristian Solberg VITTINGHUS",NA,21,2021,"Men","Singles",3,2,1,111,106,5,0.666666666666667,217,0.511520737327189
"321","Vladimir MALKOV",NA,"Toma Junior POPOV",NA,21,2021,"Men","Singles",2,1,1,111,104,7,0.5,215,0.516279069767442
"322","Kunlavut VITIDSARN",NA,"Toma Junior POPOV",NA,21,2021,"Men","Singles",2,1,1,111,90,21,0.5,201,0.552238805970149
"323","Jonatan CHRISTIE",NA,"LOH Kean Yew",NA,21,2021,"Men","Singles",2,2,0,111,106,5,1,217,0.511520737327189
"324","Kento MOMOTA",NA,"KIDAMBI Srikanth",NA,24,2021,"Men","Singles",2,2,0,106,89,17,1,195,0.543589743589744
"325","Hans-Kristian Solberg VITTINGHUS",NA,"Kanta TSUNEYAMA",NA,25,2021,"Men","Singles",2,2,0,105,103,2,1,208,0.504807692307692
"326","Kim ASTRUP","Anders Skaarup RASMUSSEN","Mark LAMSFUSS","Marvin SEIDEL",1,2021,"Men","Doubles",5,2,3,216,211,5,0.4,427,0.505854800936768
"327","Takuro HOKI","Yugo KOBAYASHI","Aaron CHIA","SOH Wooi Yik",2,2021,"Men","Doubles",4,3,1,202,168,34,0.75,370,0.545945945945946
"328","ONG Yew Sin","TEO Ee Yi","Satwiksairaj RANKIREDDY","Chirag SHETTY",3,2021,"Men","Doubles",4,2,2,195,187,8,0.5,382,0.510471204188482
"329","Kim ASTRUP","Anders Skaarup RASMUSSEN","Satwiksairaj RANKIREDDY","Chirag SHETTY",4,2021,"Men","Doubles",4,3,1,191,161,30,0.75,352,0.542613636363636
"330","Kim ASTRUP","Anders Skaarup RASMUSSEN","Christo POPOV","Toma Junior POPOV",5,2021,"Men","Doubles",4,4,0,188,130,58,1,318,0.591194968553459
"331","Mohammad AHSAN","Hendra SETIAWAN","CHOI SolGyu","SEO Seung Jae",6,2021,"Men","Doubles",4,2,2,175,169,6,0.5,344,0.508720930232558
"332","Marcus Fernaldi GIDEON","Kevin Sanjaya SUKAMULJO","LEE Yang","WANG Chi-Lin",7,2021,"Men","Doubles",3,2,1,162,156,6,0.666666666666667,318,0.509433962264151
"333","Takuro HOKI","Yugo KOBAYASHI","Kim ASTRUP","Anders Skaarup RASMUSSEN",8,2021,"Men","Doubles",3,3,0,159,134,25,1,293,0.542662116040956
"334","Marcus Fernaldi GIDEON","Kevin Sanjaya SUKAMULJO","ONG Yew Sin","TEO Ee Yi",8,2021,"Men","Doubles",3,3,0,159,133,26,1,292,0.544520547945205
"335","Mohammad AHSAN","Hendra SETIAWAN","Aaron CHIA","SOH Wooi Yik",10,2021,"Men","Doubles",3,2,1,154,143,11,0.666666666666667,297,0.518518518518518
"336","Marcus Fernaldi GIDEON","Kevin Sanjaya SUKAMULJO","Takuro HOKI","Yugo KOBAYASHI",11,2021,"Men","Doubles",3,1,2,147,146,1,0.333333333333333,293,0.501706484641638
"337","LEE Yang","WANG Chi-Lin","Mohammad AHSAN","Hendra SETIAWAN",12,2021,"Men","Doubles",3,3,0,143,112,31,1,255,0.56078431372549
"338","LEE Yang","WANG Chi-Lin","ONG Yew Sin","TEO Ee Yi",13,2021,"Men","Doubles",3,2,1,142,130,12,0.666666666666667,272,0.522058823529412
"339","Takuro HOKI","Yugo KOBAYASHI","ONG Yew Sin","TEO Ee Yi",14,2021,"Men","Doubles",3,3,0,138,105,33,1,243,0.567901234567901
"340","Aaron CHIA","SOH Wooi Yik","Marcus Fernaldi GIDEON","Kevin Sanjaya SUKAMULJO",15,2021,"Men","Doubles",3,2,1,137,116,21,0.666666666666667,253,0.541501976284585
"341","LEE Yang","WANG Chi-Lin","Ben LANE","Sean VENDY",16,2021,"Men","Doubles",3,3,0,127,100,27,1,227,0.559471365638767
"342","ONG Yew Sin","TEO Ee Yi","GOH Sze Fei","Nur IZZUDDIN",17,2021,"Men","Doubles",2,2,0,125,113,12,1,238,0.525210084033613
"343","ONG Yew Sin","TEO Ee Yi","Joel EIPE","Rasmus KJÃR",18,2021,"Men","Doubles",3,3,0,123,92,31,1,215,0.572093023255814
"344","Kim ASTRUP","Anders Skaarup RASMUSSEN","GOH Sze Fei","Nur IZZUDDIN",18,2021,"Men","Doubles",2,2,0,123,98,25,1,221,0.556561085972851
"345","Takuro HOKI","Yugo KOBAYASHI","Akira KOGA","Taichi SAITO",21,2021,"Men","Doubles",3,2,1,112,111,1,0.666666666666667,223,0.502242152466368
"346","Marcus Fernaldi GIDEON","Kevin Sanjaya SUKAMULJO","Kim ASTRUP","Anders Skaarup RASMUSSEN",21,2021,"Men","Doubles",2,2,0,112,94,18,1,206,0.543689320388349
"347","Takuro HOKI","Yugo KOBAYASHI","Mohammad AHSAN","Hendra SETIAWAN",21,2021,"Men","Doubles",2,2,0,112,105,7,1,217,0.516129032258065
"348","Satwiksairaj RANKIREDDY","Chirag SHETTY","LEE Jhe-Huei","YANG Po-Hsuan",23,2021,"Men","Doubles",2,2,0,108,93,15,1,201,0.537313432835821
"349","ONG Yew Sin","TEO Ee Yi","Phillip CHEW","Ryan CHEW",24,2021,"Men","Doubles",2,2,0,105,66,39,1,171,0.614035087719298
"350","Kim ASTRUP","Anders Skaarup RASMUSSEN","Vladimir IVANOV","Ivan SOZONOV",25,2021,"Men","Doubles",2,2,0,104,78,26,1,182,0.571428571428571
"351","Dechapol PUAVARANUKROH","Sapsiree TAERATTANACHAI","Praveen JORDAN","Melati Daeva OKTAVIANTI",1,2021,"Mixed","Doubles",5,5,0,274,226,48,1,500,0.548
"352","Dechapol PUAVARANUKROH","Sapsiree TAERATTANACHAI","Yuta WATANABE","Arisa HIGASHINO",2,2021,"Mixed","Doubles",6,3,3,242,224,18,0.5,466,0.51931330472103
"353","Yuta WATANABE","Arisa HIGASHINO","TAN Kian Meng","LAI Pei Jing",3,2021,"Mixed","Doubles",5,5,0,241,184,57,1,425,0.567058823529412
"354","Yuta WATANABE","Arisa HIGASHINO","Mathias CHRISTIANSEN","Alexandra BÃJE",4,2021,"Mixed","Doubles",5,5,0,230,163,67,1,393,0.585241730279898
"355","Yuta WATANABE","Arisa HIGASHINO","TANG Chun Man","TSE Ying Suet",5,2021,"Mixed","Doubles",4,3,1,204,172,32,0.75,376,0.542553191489362
"356","Dechapol PUAVARANUKROH","Sapsiree TAERATTANACHAI","GOH Soon Huat","LAI Shevon Jemie",6,2021,"Mixed","Doubles",4,4,0,188,135,53,1,323,0.582043343653251
"357","Dechapol PUAVARANUKROH","Sapsiree TAERATTANACHAI","SEO Seung Jae","CHAE YuJung",7,2021,"Mixed","Doubles",4,3,1,187,183,4,0.75,370,0.505405405405405
"358","Dechapol PUAVARANUKROH","Sapsiree TAERATTANACHAI","KO Sung Hyun","EOM Hye Won",8,2021,"Mixed","Doubles",3,3,0,176,146,30,1,322,0.546583850931677
"359","Mathias CHRISTIANSEN","Alexandra BÃJE","Marcus ELLIS","Lauren SMITH",9,2021,"Mixed","Doubles",4,3,1,175,167,8,0.75,342,0.511695906432749
"360","Dechapol PUAVARANUKROH","Sapsiree TAERATTANACHAI","TANG Chun Man","TSE Ying Suet",10,2021,"Mixed","Doubles",3,3,0,161,116,45,1,277,0.581227436823105
"361","Dechapol PUAVARANUKROH","Sapsiree TAERATTANACHAI","CHEN Tang Jie","PECK Yen Wei",11,2021,"Mixed","Doubles",3,3,0,144,121,23,1,265,0.543396226415094
"362","Dechapol PUAVARANUKROH","Sapsiree TAERATTANACHAI","HOO Pang Ron","CHEAH Yee See",11,2021,"Mixed","Doubles",3,3,0,144,107,37,1,251,0.573705179282869
"363","TANG Chun Man","TSE Ying Suet","Mark LAMSFUSS","Isabel HERTTRICH",13,2021,"Mixed","Doubles",4,2,2,143,123,20,0.5,266,0.537593984962406
"364","Thom GICQUEL","Delphine DELRUE","Mikkel MIKKELSEN","Rikke SÃBY",14,2021,"Mixed","Doubles",3,3,0,140,111,29,1,251,0.557768924302789
"365","Thom GICQUEL","Delphine DELRUE","Rodion ALIMOV","Alina DAVLETOVA",15,2021,"Mixed","Doubles",3,1,2,132,130,2,0.333333333333333,262,0.50381679389313
"366","Niclas NOHR","Amalie MAGELUND","LEE Jhe-Huei","HSU Ya Ching",16,2021,"Mixed","Doubles",2,1,1,131,122,9,0.5,253,0.517786561264822
"367","Yuta WATANABE","Arisa HIGASHINO","HOO Pang Ron","CHEAH Yee See",17,2021,"Mixed","Doubles",3,3,0,126,89,37,1,215,0.586046511627907
"368","Dechapol PUAVARANUKROH","Sapsiree TAERATTANACHAI","Robin TABELING","Selena PIEK",17,2021,"Mixed","Doubles",3,3,0,126,96,30,1,222,0.567567567567568
"369","Mathias CHRISTIANSEN","Alexandra BÃJE","Praveen JORDAN","Melati Daeva OKTAVIANTI",19,2021,"Mixed","Doubles",3,1,2,124,123,1,0.333333333333333,247,0.502024291497976
"370","WANG Yilyu","HUANG Dongping","Yuta WATANABE","Arisa HIGASHINO",20,2021,"Mixed","Doubles",2,1,1,118,110,8,0.5,228,0.517543859649123
"371","CHAN Peng Soon","GOH Liu Ying","Mathias CHRISTIANSEN","Alexandra BÃJE",21,2021,"Mixed","Doubles",2,1,1,116,110,6,0.5,226,0.513274336283186
"372","Dechapol PUAVARANUKROH","Sapsiree TAERATTANACHAI","Marcus ELLIS","Lauren SMITH",22,2021,"Mixed","Doubles",3,2,1,115,96,19,0.666666666666667,211,0.545023696682464
"373","Satwiksairaj RANKIREDDY","Ashwini PONNAPPA","Hafiz FAIZAL","Gloria Emanuelle WIDJAJA",23,2021,"Mixed","Doubles",2,2,0,111,84,27,1,195,0.569230769230769
"374","Rodion ALIMOV","Alina DAVLETOVA","Robin TABELING","Selena PIEK",24,2021,"Mixed","Doubles",2,2,0,106,91,15,1,197,0.538071065989848
"375","Supak JOMKOH","Supissara PAEWSAMPRAN","TAN Kian Meng","LAI Pei Jing",24,2021,"Mixed","Doubles",2,2,0,106,90,16,1,196,0.540816326530612
"376","Lianne TAN",NA,"Sabrina JAQUET",NA,1,2020,"Women","Singles",3,3,0,150,150,0,1,300,0.5
"377","Sabrina JAQUET",NA,"Lianne TAN",NA,1,2020,"Women","Singles",3,0,3,150,150,0,0,300,0.5
"378","Carolina MARIN",NA,"Akane YAMAGUCHI",NA,3,2020,"Women","Singles",3,2,1,147,111,36,0.666666666666667,258,0.569767441860465
"379","Akane YAMAGUCHI",NA,"Gregoria Mariska TUNJUNG",NA,4,2020,"Women","Singles",3,3,0,145,119,26,1,264,0.549242424242424
"380","Akane YAMAGUCHI",NA,"Se Young AN",NA,5,2020,"Women","Singles",2,2,0,106,96,10,1,202,0.524752475247525
"381","Busanan ONGBAMRUNGPHAN",NA,"Pornpawee CHOCHUWONG",NA,5,2020,"Women","Singles",2,1,1,106,105,1,0.5,211,0.502369668246445
"382","Kirsty GILMOUR",NA,"Yvonne LI",NA,7,2020,"Women","Singles",2,2,0,103,82,21,1,185,0.556756756756757
"383","SUNG Ji Hyun",NA,"Pornpawee CHOCHUWONG",NA,8,2020,"Women","Singles",2,1,1,102,93,9,0.5,195,0.523076923076923
"384","Ruselli HARTAWAN",NA,"PAI Yu Po",NA,9,2020,"Women","Singles",2,2,0,99,91,8,1,190,0.521052631578947
"385","Gregoria Mariska TUNJUNG",NA,"Busanan ONGBAMRUNGPHAN",NA,10,2020,"Women","Singles",2,2,0,98,70,28,1,168,0.583333333333333
"386","PUSARLA V. Sindhu",NA,"Aya OHORI",NA,10,2020,"Women","Singles",2,2,0,98,72,26,1,170,0.576470588235294
"387","Yvonne LI",NA,"Kristin KUUBA",NA,13,2020,"Women","Singles",2,2,0,97,74,23,1,171,0.567251461988304
"388","Akane YAMAGUCHI",NA,"Soniia CHEAH",NA,13,2020,"Women","Singles",2,1,1,97,90,7,0.5,187,0.518716577540107
"389","Carolina MARIN",NA,"Pornpawee CHOCHUWONG",NA,13,2020,"Women","Singles",2,1,1,97,73,24,0.5,170,0.570588235294118
"390","HE Bingjiao",NA,"KIM Ga Eun",NA,13,2020,"Women","Singles",2,2,0,97,80,17,1,177,0.548022598870056
"391","Ratchanok INTANON",NA,"WANG Zhiyi",NA,16,2020,"Women","Singles",2,1,1,96,95,1,0.5,191,0.50261780104712
"392","CHEN Yufei",NA,"Line HÃ¸jmark KJAERSFELDT",NA,17,2020,"Women","Singles",2,1,1,94,88,6,0.5,182,0.516483516483517
"393","Ratchanok INTANON",NA,"Aya OHORI",NA,18,2020,"Women","Singles",2,1,1,91,80,11,0.5,171,0.532163742690059
"394","Se Young AN",NA,"Kirsty GILMOUR",NA,20,2020,"Women","Singles",2,2,0,84,57,27,1,141,0.595744680851064
"395","Neslihan YIGIT",NA,"Airi MIKKELA",NA,20,2020,"Women","Singles",2,2,0,84,42,42,1,126,0.666666666666667
"396","Carolina MARIN",NA,"Natalia PERMINOVA",NA,20,2020,"Women","Singles",2,2,0,84,41,43,1,125,0.672
"397","Nozomi OKUHARA",NA,"Michelle LI",NA,20,2020,"Women","Singles",2,2,0,84,41,43,1,125,0.672
"398","Carolina MARIN",NA,"Nozomi OKUHARA",NA,23,2020,"Women","Singles",2,1,1,78,70,8,0.5,148,0.527027027027027
"399","Carolina MARIN",NA,"Kirsty GILMOUR",NA,24,2020,"Women","Singles",2,1,1,76,70,6,0.5,146,0.520547945205479
"400","CHEN Yufei",NA,"TAI Tzu Ying",NA,24,2020,"Women","Singles",2,1,1,76,69,7,0.5,145,0.524137931034483
"401","CHEN Qingchen","JIA Yifan","Nami MATSUYAMA","Chiharu SHIDA",1,2020,"Women","Doubles",3,1,2,123,121,2,0.333333333333333,244,0.504098360655738
"402","Vivian HOO","YAP Cheng Wen","CHOW Mei Kuan","LEE Meng Yean",2,2020,"Women","Doubles",2,1,1,115,110,5,0.5,225,0.511111111111111
"403","HSU Ya Ching","HU Ling Fang","Alexandra BÃJE","Mette POULSEN",3,2020,"Women","Doubles",2,2,0,105,94,11,1,199,0.527638190954774
"404","Yuki FUKUSHIMA","Sayaka HIROTA","LI Wenmei","ZHENG Yu",4,2020,"Women","Doubles",2,1,1,102,95,7,0.5,197,0.517766497461929
"405","LI Wenmei","ZHENG Yu","KIM So Yeong","KONG Hee Yong",5,2020,"Women","Doubles",2,1,1,97,86,11,0.5,183,0.530054644808743
"406","LEE So Hee","SHIN Seung Chan","CHANG Ye Na","KIM Hye Rin",6,2020,"Women","Doubles",2,1,1,96,93,3,0.5,189,0.507936507936508
"407","KIM So Yeong","KONG Hee Yong","HSU Ya Ching","HU Ling Fang",7,2020,"Women","Doubles",2,2,0,86,64,22,1,150,0.573333333333333
"408","Gabriela STOEVA","Stefani STOEVA","Alexandra BÃJE","Mette POULSEN",9,2020,"Women","Doubles",2,2,0,84,44,40,1,128,0.65625
"409","CHEN Qingchen","JIA Yifan","Gabriela STOEVA","Stefani STOEVA",9,2020,"Women","Doubles",2,2,0,84,49,35,1,133,0.631578947368421
"410","Siti Fadia Silva RAMADHANTI","Ribka SUGIARTO","Pooja DANDU","SANJANA SANTOSH",9,2020,"Women","Doubles",2,2,0,84,47,37,1,131,0.641221374045801
"411","DU Yue","LI Yinhui","CHOW Mei Kuan","LEE Meng Yean",9,2020,"Women","Doubles",2,2,0,84,57,27,1,141,0.595744680851064
"412","CHANG Ye Na","KIM Hye Rin","Greysia POLII","Apriyani RAHAYU",12,2020,"Women","Doubles",2,1,1,80,74,6,0.5,154,0.519480519480519
"413","Puttita SUPAJIRAKUL","Sapsiree TAERATTANACHAI","DU Yue","LI Yinhui",13,2020,"Women","Doubles",2,1,1,74,71,3,0.5,145,0.510344827586207
"414","LEE So Hee","SHIN Seung Chan","BAEK Ha Na","JUNG Kyung Eun",14,2020,"Women","Doubles",1,1,0,71,64,7,1,135,0.525925925925926
"415","LEE So Hee","SHIN Seung Chan","Ekaterina BOLOTOVA","Alina DAVLETOVA",15,2020,"Women","Doubles",1,1,0,67,61,6,1,128,0.5234375
"416","Misaki MATSUTOMO","Ayaka TAKAHASHI","LEE So Hee","SHIN Seung Chan",15,2020,"Women","Doubles",1,1,0,67,52,15,1,119,0.563025210084034
"417","Maiken FRUERGAARD","Sara THYGESEN","Clara NISTAD","Moa SJOO",18,2020,"Women","Doubles",1,1,0,64,56,8,1,120,0.533333333333333
"418","Alexandra BÃJE","Mette POULSEN","Linda EFLER","Isabel HERTTRICH",18,2020,"Women","Doubles",1,1,0,64,59,5,1,123,0.520325203252033
"419","Greysia POLII","Apriyani RAHAYU","LIU Xuanxuan","XIA Yuting",18,2020,"Women","Doubles",1,1,0,64,56,8,1,120,0.533333333333333
"420","Greysia POLII","Apriyani RAHAYU","BAEK Ha Na","JUNG Kyung Eun",18,2020,"Women","Doubles",1,1,0,64,60,4,1,124,0.516129032258065
"421","KIM So Yeong","KONG Hee Yong","Chayanit CHALADCHALAM","Phataimas MUENWONG",22,2020,"Women","Doubles",1,1,0,63,55,8,1,118,0.533898305084746
"422","Martina REPISKA","Katarina VARGOVA","Liana LENCEVICA","Jekaterina ROMANOVA",22,2020,"Women","Doubles",1,1,0,63,60,3,1,123,0.51219512195122
"423","CHANG Ye Na","KIM Hye Rin","Vivian HOO","YAP Cheng Wen",22,2020,"Women","Doubles",1,1,0,63,54,9,1,117,0.538461538461538
"424","Greysia POLII","Apriyani RAHAYU","HSU Ya Ching","HU Ling Fang",24,2020,"Women","Doubles",1,1,0,62,52,10,1,114,0.543859649122807
"425","Greysia POLII","Apriyani RAHAYU","Chloe BIRCH","Lauren SMITH",24,2020,"Women","Doubles",1,1,0,62,48,14,1,110,0.563636363636364
"426","Shesar Hiren RHUSTAVITO",NA,"KIDAMBI Srikanth",NA,1,2020,"Men","Singles",2,2,0,114,93,21,1,207,0.550724637681159
"427","Kenta NISHIMOTO",NA,"CHEAM June Wei",NA,2,2020,"Men","Singles",2,1,1,111,97,14,0.5,208,0.533653846153846
"428","Hans-Kristian Solberg VITTINGHUS",NA,"Lakshya SEN",NA,3,2020,"Men","Singles",2,2,0,110,98,12,1,208,0.528846153846154
"429","SHI Yuqi",NA,"NG Ka Long Angus",NA,4,2020,"Men","Singles",2,1,1,106,99,7,0.5,205,0.517073170731707
"430","LIEW Daren",NA,"PRANNOY H. S.",NA,5,2020,"Men","Singles",2,2,0,104,91,13,1,195,0.533333333333333
"431","CHOU Tien Chen",NA,"KIDAMBI Srikanth",NA,5,2020,"Men","Singles",2,2,0,104,73,31,1,177,0.587570621468927
"432","Vladimir MALKOV",NA,"Nhat NGUYEN",NA,7,2020,"Men","Singles",2,2,0,102,92,10,1,194,0.525773195876289
"433","Anders ANTONSEN",NA,"Rasmus GEMKE",NA,7,2020,"Men","Singles",2,2,0,102,75,27,1,177,0.576271186440678
"434","Kanta TSUNEYAMA",NA,"CHOU Tien Chen",NA,9,2020,"Men","Singles",2,1,1,100,95,5,0.5,195,0.512820512820513
"435","LEE Zii Jia",NA,"HEO Kwang Hee",NA,10,2020,"Men","Singles",2,1,1,98,80,18,0.5,178,0.550561797752809
"436","HUANG Yuxiang",NA,"Jan O JORGENSEN",NA,10,2020,"Men","Singles",2,2,0,98,92,6,1,190,0.515789473684211
"437","WANG Tzu Wei",NA,"Kenta NISHIMOTO",NA,12,2020,"Men","Singles",2,1,1,97,88,9,0.5,185,0.524324324324324
"438","SUN Feixiang",NA,"Brice LEVERDEZ",NA,12,2020,"Men","Singles",2,1,1,97,84,13,0.5,181,0.535911602209945
"439","Rasmus GEMKE",NA,"Max WEISSKIRCHEN",NA,14,2020,"Men","Singles",2,1,1,96,88,8,0.5,184,0.521739130434783
"440","Toma Junior POPOV",NA,"Thomas ROUXEL",NA,15,2020,"Men","Singles",2,1,1,93,84,9,0.5,177,0.525423728813559
"441","NG Ka Long Angus",NA,"Kenta NISHIMOTO",NA,16,2020,"Men","Singles",2,1,1,91,88,3,0.5,179,0.508379888268156
"442","LEE Zii Jia",NA,"Sameer VERMA",NA,17,2020,"Men","Singles",2,2,0,85,70,15,1,155,0.548387096774194
"443","Anders ANTONSEN",NA,"SON Wan Ho",NA,17,2020,"Men","Singles",2,2,0,85,61,24,1,146,0.582191780821918
"444","Anthony Sinisuka GINTING",NA,"HUANG Yuxiang",NA,19,2020,"Men","Singles",2,1,1,78,68,10,0.5,146,0.534246575342466
"445","Rasmus GEMKE",NA,"Kenta NISHIMOTO",NA,20,2020,"Men","Singles",2,1,1,75,73,2,0.5,148,0.506756756756757
"446","Jonathan DOLAN",NA,"Martin BUNDGAARD",NA,21,2020,"Men","Singles",1,1,0,67,63,4,1,130,0.515384615384615
"447","Anthony Sinisuka GINTING",NA,"HEO Kwang Hee",NA,22,2020,"Men","Singles",1,1,0,64,59,5,1,123,0.520325203252033
"448","Brice LEVERDEZ",NA,"Jonathan DOLAN",NA,24,2020,"Men","Singles",1,1,0,63,54,9,1,117,0.538461538461538
"449","LIN Yu Hsien",NA,"Sergey SIRANT",NA,24,2020,"Men","Singles",1,1,0,63,55,8,1,118,0.533898305084746
"450","Giovanni TOTI",NA,"Luka BAN",NA,24,2020,"Men","Singles",1,1,0,63,55,8,1,118,0.533898305084746
"451","Marcus Fernaldi GIDEON","Kevin Sanjaya SUKAMULJO","Aaron CHIA","SOH Wooi Yik",1,2020,"Men","Doubles",4,4,0,169,136,33,1,305,0.554098360655738
"452","Akira KOGA","Taichi SAITO","HUANG Kaixiang","LIU Cheng",2,2020,"Men","Doubles",2,1,1,119,109,10,0.5,228,0.521929824561403
"453","LEE Yang","WANG Chi-Lin","Mohammad AHSAN","Hendra SETIAWAN",3,2020,"Men","Doubles",2,0,2,114,113,1,0,227,0.502202643171806
"454","Vladimir IVANOV","Ivan SOZONOV","Marcus ELLIS","Chris LANGRIDGE",4,2020,"Men","Doubles",2,1,1,110,109,1,0.5,219,0.502283105022831
"455","Jeppe BAY","Lasse MÃLHEDE","Ruben JILLE","Ties VAN DER LECQ",5,2020,"Men","Doubles",2,2,0,105,97,8,1,202,0.51980198019802
"456","Kim ASTRUP","Anders Skaarup RASMUSSEN","KIM Gi Jung","LEE Yong Dae",6,2020,"Men","Doubles",2,2,0,99,81,18,1,180,0.55
"457","GOH V Shem","TAN Wee Kiong","LIAO Min Chun","SU Ching Heng",9,2020,"Men","Doubles",2,2,0,84,66,18,1,150,0.56
"458","Kim ASTRUP","Anders Skaarup RASMUSSEN","Jelle MAAS","Robin TABELING",9,2020,"Men","Doubles",2,2,0,84,56,28,1,140,0.6
"459","LEE Yang","WANG Chi-Lin","Vladimir IVANOV","Ivan SOZONOV",9,2020,"Men","Doubles",2,2,0,84,61,23,1,145,0.579310344827586
"460","KIM Gi Jung","LEE Yong Dae","LI Junhui","LIU Yuchen",9,2020,"Men","Doubles",2,2,0,84,61,23,1,145,0.579310344827586
"461","ONG Yew Sin","TEO Ee Yi","HAN Chengkai","ZHOU Haodong",9,2020,"Men","Doubles",2,2,0,84,66,18,1,150,0.56
"462","Fajar ALFIAN","Muhammad Rian ARDIANTO","Mathias BOE","Mads CONRAD-PETERSEN",9,2020,"Men","Doubles",2,2,0,84,67,17,1,151,0.556291390728477
"463","Mathias BOE","Mads CONRAD-PETERSEN","LEE Jhe-Huei","YANG Po-Hsuan",13,2020,"Men","Doubles",2,1,1,82,77,5,0.5,159,0.515723270440252
"464","Akira KOGA","Taichi SAITO","LIAO Min Chun","SU Ching Heng",14,2020,"Men","Doubles",1,1,0,68,57,11,1,125,0.544
"465","Sturla Flaten JORGENSEN","Carl Christian MORK","Oskari LARKIMO","Joakim OLDORFF",15,2020,"Men","Doubles",1,1,0,67,59,8,1,126,0.531746031746032
"466","Ruben JILLE","Ties VAN DER LECQ","Eloi ADAM","Julien MAIO",16,2020,"Men","Doubles",1,1,0,66,59,7,1,125,0.528
"467","Marcus Fernaldi GIDEON","Kevin Sanjaya SUKAMULJO","Marcus ELLIS","Chris LANGRIDGE",16,2020,"Men","Doubles",1,1,0,66,57,9,1,123,0.536585365853659
"468","Rowan SCHEURKOGEL","Jona VAN NIEUWKERKE","Serdar KOCA","Serhat SALIM",18,2020,"Men","Doubles",1,1,0,65,58,7,1,123,0.528455284552846
"469","LI Junhui","LIU Yuchen","Mohammad AHSAN","Hendra SETIAWAN",18,2020,"Men","Doubles",1,1,0,65,63,2,1,128,0.5078125
"470","Leo Rolly CARNANDO","Daniel MARTHIN","Maneepong JONGJIT","Krit TANTIANANKUL",21,2020,"Men","Doubles",1,1,0,64,59,5,1,123,0.520325203252033
"471","Jones Ralfy JANSEN","Peter KAESBAUER","Muhammad Shohibul FIKRI","Bagas MAULANA",21,2020,"Men","Doubles",1,1,0,64,60,4,1,124,0.516129032258065
"472","Takuro HOKI","Yugo KOBAYASHI","CHOI SolGyu","SEO Seung Jae",21,2020,"Men","Doubles",1,1,0,64,62,2,1,126,0.507936507936508
"473","Zach RUSS","Steven STALLWOOD","Rasmus ESPERSEN","Emil HYBEL",24,2020,"Men","Doubles",1,1,0,63,57,6,1,120,0.525
"474","ONG Yew Sin","TEO Ee Yi","OU Xuanyi","ZHANG Nan",24,2020,"Men","Doubles",1,1,0,63,61,2,1,124,0.508064516129032
"475","Gianmarco BAILETTI","David SALUTT","Ariel SHAINSKI","Misha ZILBERMAN",24,2020,"Men","Doubles",1,1,0,63,52,11,1,115,0.547826086956522
"476","Robin TABELING","Selena PIEK","Mathias CHRISTIANSEN","Alexandra BÃJE",1,2020,"Mixed","Doubles",3,2,1,131,121,10,0.666666666666667,252,0.51984126984127
"477","Mathias CHRISTIANSEN","Alexandra BÃJE","Mark LAMSFUSS","Isabel HERTTRICH",2,2020,"Mixed","Doubles",2,1,1,112,108,4,0.5,220,0.509090909090909
"478","Mathias CHRISTIANSEN","Alexandra BÃJE","Niclas NOHR","Amalie MAGELUND",3,2020,"Mixed","Doubles",2,2,0,107,85,22,1,192,0.557291666666667
"479","KO Sung Hyun","EOM Hye Won","YANG Po-Hsuan","HU Ling Fang",4,2020,"Mixed","Doubles",2,2,0,104,78,26,1,182,0.571428571428571
"480","ZHENG Siwei","HUANG Yaqiong","Pranaav Jerry CHOPRA","REDDY N. Sikki",5,2020,"Mixed","Doubles",2,2,0,95,71,24,1,166,0.572289156626506
"481","WANG Yilyu","HUANG Dongping","Ricky KARANDASUWARDI","Pia Zebadiah BERNADET",6,2020,"Mixed","Doubles",2,2,0,88,60,28,1,148,0.594594594594595
"482","Dechapol PUAVARANUKROH","Sapsiree TAERATTANACHAI","LEE Jhe-Huei","HSU Ya Ching",7,2020,"Mixed","Doubles",2,2,0,85,55,30,1,140,0.607142857142857
"483","Marcus ELLIS","Lauren SMITH","Rodion ALIMOV","Alina DAVLETOVA",9,2020,"Mixed","Doubles",2,2,0,84,53,31,1,137,0.613138686131387
"484","ZHENG Siwei","HUANG Yaqiong","Hafiz FAIZAL","Gloria Emanuelle WIDJAJA",9,2020,"Mixed","Doubles",2,2,0,84,52,32,1,136,0.617647058823529
"485","ZHENG Siwei","HUANG Yaqiong","WANG Yilyu","HUANG Dongping",9,2020,"Mixed","Doubles",2,2,0,84,49,35,1,133,0.631578947368421
"486","Kyohei YAMASHITA","Naru SHINOYA","Mathias CHRISTIANSEN","Alexandra BÃJE",11,2020,"Mixed","Doubles",1,1,0,72,59,13,1,131,0.549618320610687
"487","Marcus ELLIS","Lauren SMITH","Gregory MAIRS","Victoria WILLIAMS",12,2020,"Mixed","Doubles",1,1,0,69,54,15,1,123,0.560975609756098
"488","Mathias BAY-SMIDT","Rikke SÃBY","Vladimir IVANOV","Ekaterina BOLOTOVA",13,2020,"Mixed","Doubles",1,1,0,68,59,9,1,127,0.535433070866142
"489","Marcus ELLIS","Lauren SMITH","TANG Chun Man","TSE Ying Suet",14,2020,"Mixed","Doubles",1,1,0,67,57,10,1,124,0.540322580645161
"490","CHOI SolGyu","SHIN Seung Chan","WANG Chi-Lin","CHENG Chi Ya",15,2020,"Mixed","Doubles",1,1,0,65,47,18,1,112,0.580357142857143
"491","Marcus ELLIS","Lauren SMITH","GOH Soon Huat","LAI Shevon Jemie",16,2020,"Mixed","Doubles",1,1,0,64,62,2,1,126,0.507936507936508
"492","Gregory MAIRS","Victoria WILLIAMS","Eloi ADAM","Margot LAMBERT",16,2020,"Mixed","Doubles",1,1,0,64,61,3,1,125,0.512
"493","Philip BIRKER","Katharina HOCHMEIR","Alexander DUNN","Ciara TORRANCE",20,2020,"Mixed","Doubles",1,1,0,63,63,0,1,126,0.5
"494","Niclas NOHR","Amalie MAGELUND","Adam HALL","Julie MACPHERSON",20,2020,"Mixed","Doubles",1,1,0,63,53,10,1,116,0.543103448275862
"495","Hafiz FAIZAL","Gloria Emanuelle WIDJAJA","TAN Kian Meng","LAI Pei Jing",20,2020,"Mixed","Doubles",1,1,0,63,59,4,1,122,0.516393442622951
"496","Praveen JORDAN","Melati Daeva OKTAVIANTI","Marcus ELLIS","Lauren SMITH",20,2020,"Mixed","Doubles",1,1,0,63,49,14,1,112,0.5625
"497","Alexander DUNN","Ciara TORRANCE","Philip BIRKER","Katharina HOCHMEIR",20,2020,"Mixed","Doubles",1,0,1,63,63,0,0,126,0.5
"498","Adnan MAULANA","Mychelle Crhystine BANDASO","FENG Yanzhe","ZHANG Shuxian",24,2020,"Mixed","Doubles",1,1,0,62,54,8,1,116,0.53448275862069
"499","Thom GICQUEL","Delphine DELRUE","Mathias THYRRI","Mai SURROW",24,2020,"Mixed","Doubles",1,1,0,62,51,11,1,113,0.548672566371681
"500","Chris ADCOCK","Gabrielle ADCOCK","Takuro HOKI","Wakana NAGAHARA",24,2020,"Mixed","Doubles",1,1,0,62,57,5,1,119,0.521008403361345
"501","CHEN Yufei",NA,"Sayaka TAKAHASHI",NA,1,2019,"Women","Singles",5,5,0,242,163,79,1,405,0.597530864197531
"502","CHEN Yufei",NA,"Akane YAMAGUCHI",NA,2,2019,"Women","Singles",5,3,2,227,204,23,0.6,431,0.526682134570766
"503","TAI Tzu Ying",NA,"Nozomi OKUHARA",NA,3,2019,"Women","Singles",5,3,2,223,206,17,0.6,429,0.51981351981352
"504","Ratchanok INTANON",NA,"TAI Tzu Ying",NA,4,2019,"Women","Singles",5,2,3,222,210,12,0.4,432,0.513888888888889
"505","TAI Tzu Ying",NA,"Busanan ONGBAMRUNGPHAN",NA,5,2019,"Women","Singles",5,5,0,210,139,71,1,349,0.601719197707736
"506","TAI Tzu Ying",NA,"CHEN Yufei",NA,5,2019,"Women","Singles",5,3,2,210,208,2,0.6,418,0.502392344497608
"507","Ratchanok INTANON",NA,"CHEN Xiaoxin",NA,7,2019,"Women","Singles",5,4,1,207,172,35,0.8,379,0.546174142480211
"508","Nozomi OKUHARA",NA,"Ratchanok INTANON",NA,8,2019,"Women","Singles",5,3,2,203,196,7,0.6,399,0.508771929824561
"509","Ratchanok INTANON",NA,"Gregoria Mariska TUNJUNG",NA,9,2019,"Women","Singles",4,4,0,201,166,35,1,367,0.547683923705722
"510","Busanan ONGBAMRUNGPHAN",NA,"CAI Yanyan",NA,10,2019,"Women","Singles",4,4,0,200,158,42,1,358,0.558659217877095
"511","CHEN Yufei",NA,"Ratchanok INTANON",NA,11,2019,"Women","Singles",4,4,0,196,163,33,1,359,0.545961002785515
"512","Akane YAMAGUCHI",NA,"HE Bingjiao",NA,12,2019,"Women","Singles",4,4,0,191,140,51,1,331,0.577039274924471
"513","Ratchanok INTANON",NA,"Nitchaon JINDAPOL",NA,13,2019,"Women","Singles",4,4,0,186,132,54,1,318,0.584905660377358
"514","Akane YAMAGUCHI",NA,"TAI Tzu Ying",NA,14,2019,"Women","Singles",4,1,3,181,178,3,0.25,359,0.504178272980501
"515","Akane YAMAGUCHI",NA,"Pornpawee CHOCHUWONG",NA,15,2019,"Women","Singles",4,2,2,176,171,5,0.5,347,0.507204610951009
"516","HE Bingjiao",NA,"Nitchaon JINDAPOL",NA,16,2019,"Women","Singles",4,3,1,175,154,21,0.75,329,0.531914893617021
"517","TAI Tzu Ying",NA,"Gregoria Mariska TUNJUNG",NA,17,2019,"Women","Singles",4,4,0,172,141,31,1,313,0.549520766773163
"518","CHEN Yufei",NA,"SUNG Ji Hyun",NA,18,2019,"Women","Singles",4,4,0,168,127,41,1,295,0.569491525423729
"519","Ruselli HARTAWAN",NA,"CHIANG Ying Li",NA,19,2019,"Women","Singles",3,3,0,167,139,28,1,306,0.545751633986928
"520","Nozomi OKUHARA",NA,"HE Bingjiao",NA,20,2019,"Women","Singles",4,3,1,165,132,33,0.75,297,0.555555555555556
"521","LI Xuerui",NA,"Sayaka TAKAHASHI",NA,21,2019,"Women","Singles",4,3,1,163,148,15,0.75,311,0.52411575562701
"522","CHEN Yufei",NA,"Michelle LI",NA,21,2019,"Women","Singles",3,3,0,163,133,30,1,296,0.550675675675676
"523","HE Bingjiao",NA,"Fitriani FITRIANI",NA,23,2019,"Women","Singles",3,3,0,162,122,40,1,284,0.570422535211268
"524","Nozomi OKUHARA",NA,"Busanan ONGBAMRUNGPHAN",NA,23,2019,"Women","Singles",3,3,0,162,117,45,1,279,0.580645161290323
"525","Akane YAMAGUCHI",NA,"LI Xuerui",NA,25,2019,"Women","Singles",3,2,1,157,134,23,0.666666666666667,291,0.539518900343643
"526","Yuki FUKUSHIMA","Sayaka HIROTA","CHEN Qingchen","JIA Yifan",1,2019,"Women","Doubles",7,5,2,322,262,60,0.714285714285714,584,0.551369863013699
"527","KIM So Yeong","KONG Hee Yong","Mayu MATSUMOTO","Wakana NAGAHARA",2,2019,"Women","Doubles",6,4,2,280,268,12,0.666666666666667,548,0.510948905109489
"528","CHEN Qingchen","JIA Yifan","Mayu MATSUMOTO","Wakana NAGAHARA",3,2019,"Women","Doubles",5,4,1,249,220,29,0.8,469,0.53091684434968
"529","Yuki FUKUSHIMA","Sayaka HIROTA","DU Yue","LI Yinhui",4,2019,"Women","Doubles",5,4,1,239,196,43,0.8,435,0.549425287356322
"530","Mayu MATSUMOTO","Wakana NAGAHARA","Yuki FUKUSHIMA","Sayaka HIROTA",5,2019,"Women","Doubles",5,4,1,235,218,17,0.8,453,0.518763796909492
"531","LEE So Hee","SHIN Seung Chan","Jongkolphan KITITHARAKUL","Rawinda PRAJONGJAI",6,2019,"Women","Doubles",5,5,0,231,162,69,1,393,0.587786259541985
"532","KIM So Yeong","KONG Hee Yong","CHEN Qingchen","JIA Yifan",7,2019,"Women","Doubles",5,3,2,230,221,9,0.6,451,0.509977827050998
"533","Misaki MATSUTOMO","Ayaka TAKAHASHI","KIM So Yeong","KONG Hee Yong",8,2019,"Women","Doubles",5,4,1,220,180,40,0.8,400,0.55
"534","Jongkolphan KITITHARAKUL","Rawinda PRAJONGJAI","CHOW Mei Kuan","LEE Meng Yean",9,2019,"Women","Doubles",4,3,1,218,193,25,0.75,411,0.530413625304136
"535","Yuki FUKUSHIMA","Sayaka HIROTA","Ekaterina BOLOTOVA","Alina DAVLETOVA",10,2019,"Women","Doubles",5,5,0,210,101,109,1,311,0.67524115755627
"536","Mayu MATSUMOTO","Wakana NAGAHARA","LI Wenmei","ZHENG Yu",11,2019,"Women","Doubles",4,4,0,209,185,24,1,394,0.530456852791878
"537","CHANG Ye Na","JUNG Kyung Eun","Yuki FUKUSHIMA","Sayaka HIROTA",12,2019,"Women","Doubles",4,2,2,206,196,10,0.5,402,0.512437810945274
"538","LI Wenmei","ZHENG Yu","LEE So Hee","SHIN Seung Chan",13,2019,"Women","Doubles",4,2,2,205,199,6,0.5,404,0.507425742574257
"539","LEE So Hee","SHIN Seung Chan","Mayu MATSUMOTO","Wakana NAGAHARA",13,2019,"Women","Doubles",4,3,1,205,181,24,0.75,386,0.531088082901554
"540","CHEN Qingchen","JIA Yifan","Greysia POLII","Apriyani RAHAYU",15,2019,"Women","Doubles",4,3,1,201,183,18,0.75,384,0.5234375
"541","KIM So Yeong","KONG Hee Yong","LI Wenmei","ZHENG Yu",16,2019,"Women","Doubles",4,3,1,194,182,12,0.75,376,0.515957446808511
"542","Misaki MATSUTOMO","Ayaka TAKAHASHI","Puttita SUPAJIRAKUL","Sapsiree TAERATTANACHAI",17,2019,"Women","Doubles",4,3,1,187,159,28,0.75,346,0.540462427745665
"543","Misaki MATSUTOMO","Ayaka TAKAHASHI","DU Yue","LI Yinhui",18,2019,"Women","Doubles",4,2,2,185,174,11,0.5,359,0.515320334261838
"544","Mayu MATSUMOTO","Wakana NAGAHARA","LIU Xuanxuan","XIA Yuting",19,2019,"Women","Doubles",4,4,0,184,142,42,1,326,0.56441717791411
"545","CHEN Qingchen","JIA Yifan","DU Yue","LI Yinhui",19,2019,"Women","Doubles",4,4,0,184,139,45,1,323,0.569659442724458
"546","Yuki FUKUSHIMA","Sayaka HIROTA","Ayako SAKURAMOTO","Yukiko TAKAHATA",21,2019,"Women","Doubles",4,4,0,180,130,50,1,310,0.580645161290323
"547","Misaki MATSUTOMO","Ayaka TAKAHASHI","Greysia POLII","Apriyani RAHAYU",22,2019,"Women","Doubles",3,2,1,178,172,6,0.666666666666667,350,0.508571428571429
"548","Greysia POLII","Apriyani RAHAYU","Ayako SAKURAMOTO","Yukiko TAKAHATA",23,2019,"Women","Doubles",4,3,1,175,156,19,0.75,331,0.528700906344411
"549","LEE So Hee","SHIN Seung Chan","KIM So Yeong","KONG Hee Yong",23,2019,"Women","Doubles",3,2,1,175,163,12,0.666666666666667,338,0.517751479289941
"550","Yuki FUKUSHIMA","Sayaka HIROTA","LEE So Hee","SHIN Seung Chan",25,2019,"Women","Doubles",4,3,1,170,152,18,0.75,322,0.527950310559006
"551","Kento MOMOTA",NA,"Anthony Sinisuka GINTING",NA,1,2019,"Men","Singles",7,6,1,347,309,38,0.857142857142857,656,0.528963414634146
"552","CHOU Tien Chen",NA,"Kenta NISHIMOTO",NA,2,2019,"Men","Singles",5,4,1,261,229,32,0.8,490,0.53265306122449
"553","Jonatan CHRISTIE",NA,"Anders ANTONSEN",NA,3,2019,"Men","Singles",6,4,2,248,231,17,0.666666666666667,479,0.517745302713987
"554","Jonatan CHRISTIE",NA,"Jan O JORGENSEN",NA,4,2019,"Men","Singles",5,5,0,230,163,67,1,393,0.585241730279898
"555","Viktor AXELSEN",NA,"CHEN Long",NA,5,2019,"Men","Singles",5,2,3,224,209,15,0.4,433,0.517321016166282
"556","Kento MOMOTA",NA,"Hans-Kristian Solberg VITTINGHUS",NA,6,2019,"Men","Singles",4,4,0,211,176,35,1,387,0.545219638242894
"557","NG Ka Long Angus",NA,"Anthony Sinisuka GINTING",NA,7,2019,"Men","Singles",4,3,1,209,198,11,0.75,407,0.513513513513513
"558","Kanta TSUNEYAMA",NA,"Sitthikom THAMMASIN",NA,8,2019,"Men","Singles",4,3,1,204,175,29,0.75,379,0.538258575197889
"559","Kento MOMOTA",NA,"Viktor AXELSEN",NA,9,2019,"Men","Singles",4,4,0,195,154,41,1,349,0.558739255014327
"560","Anthony Sinisuka GINTING",NA,"CHEN Long",NA,10,2019,"Men","Singles",5,3,2,194,165,29,0.6,359,0.540389972144847
"561","Viktor AXELSEN",NA,"Kanta TSUNEYAMA",NA,11,2019,"Men","Singles",4,3,1,188,151,37,0.75,339,0.554572271386431
"562","Kento MOMOTA",NA,"SAI PRANEETH B.",NA,11,2019,"Men","Singles",4,4,0,188,126,62,1,314,0.598726114649682
"563","Kento MOMOTA",NA,"WANG Tzu Wei",NA,13,2019,"Men","Singles",4,4,0,183,133,50,1,316,0.579113924050633
"564","Kantaphon WANGCHAROEN",NA,"HUANG Yuxiang",NA,14,2019,"Men","Singles",4,3,1,181,158,23,0.75,339,0.533923303834808
"565","LEE Zii Jia",NA,"CHEN Long",NA,15,2019,"Men","Singles",3,1,2,175,170,5,0.333333333333333,345,0.507246376811594
"566","CHOU Tien Chen",NA,"Kantaphon WANGCHAROEN",NA,16,2019,"Men","Singles",3,2,1,172,167,5,0.666666666666667,339,0.507374631268437
"567","Tommy SUGIARTO",NA,"LU Guangzu",NA,17,2019,"Men","Singles",4,1,3,169,165,4,0.25,334,0.505988023952096
"568","Anthony Sinisuka GINTING",NA,"CHOU Tien Chen",NA,17,2019,"Men","Singles",3,2,1,169,162,7,0.666666666666667,331,0.510574018126888
"569","Viktor AXELSEN",NA,"Jonatan CHRISTIE",NA,19,2019,"Men","Singles",3,1,2,164,156,8,0.333333333333333,320,0.5125
"570","CHOU Tien Chen",NA,"LIN Dan",NA,20,2019,"Men","Singles",3,2,1,163,131,32,0.666666666666667,294,0.554421768707483
"571","Kento MOMOTA",NA,"LEE Zii Jia",NA,22,2019,"Men","Singles",4,4,0,158,100,58,1,258,0.612403100775194
"572","Sourabh VERMA",NA,"SUN Feixiang",NA,22,2019,"Men","Singles",3,3,0,158,123,35,1,281,0.562277580071174
"573","Anthony Sinisuka GINTING",NA,"Kenta NISHIMOTO",NA,22,2019,"Men","Singles",3,2,1,158,136,22,0.666666666666667,294,0.537414965986395
"574","CHOU Tien Chen",NA,"Jonatan CHRISTIE",NA,24,2019,"Men","Singles",3,2,1,157,133,24,0.666666666666667,290,0.541379310344828
"575","Kento MOMOTA",NA,"Anders ANTONSEN",NA,25,2019,"Men","Singles",3,2,1,156,119,37,0.666666666666667,275,0.567272727272727
"576","Mohammad AHSAN","Hendra SETIAWAN","LEE Yang","WANG Chi-Lin",1,2019,"Men","Doubles",6,4,2,295,271,24,0.666666666666667,566,0.521201413427562
"577","Takeshi KAMURA","Keigo SONODA","Takuro HOKI","Yugo KOBAYASHI",2,2019,"Men","Doubles",6,4,2,287,272,15,0.666666666666667,559,0.513416815742397
"578","Takeshi KAMURA","Keigo SONODA","CHOI SolGyu","SEO Seung Jae",3,2019,"Men","Doubles",6,4,2,286,247,39,0.666666666666667,533,0.536585365853659
"579","Hiroyuki ENDO","Yuta WATANABE","Marcus Fernaldi GIDEON","Kevin Sanjaya SUKAMULJO",4,2019,"Men","Doubles",5,5,0,275,213,62,1,488,0.563524590163934
"580","Hiroyuki ENDO","Yuta WATANABE","LI Junhui","LIU Yuchen",5,2019,"Men","Doubles",6,3,3,253,251,2,0.5,504,0.501984126984127
"581","LI Junhui","LIU Yuchen","LU Ching Yao","YANG Po Han",6,2019,"Men","Doubles",5,4,1,247,232,15,0.8,479,0.515657620041754
"582","Mohammad AHSAN","Hendra SETIAWAN","Hiroyuki ENDO","Yuta WATANABE",7,2019,"Men","Doubles",5,5,0,243,207,36,1,450,0.54
"583","Marcus Fernaldi GIDEON","Kevin Sanjaya SUKAMULJO","Fajar ALFIAN","Muhammad Rian ARDIANTO",8,2019,"Men","Doubles",5,3,2,241,215,26,0.6,456,0.528508771929825
"584","Mohammad AHSAN","Hendra SETIAWAN","LI Junhui","LIU Yuchen",9,2019,"Men","Doubles",5,4,1,236,192,44,0.8,428,0.551401869158878
"585","Marcus Fernaldi GIDEON","Kevin Sanjaya SUKAMULJO","Takeshi KAMURA","Keigo SONODA",10,2019,"Men","Doubles",5,4,1,233,199,34,0.8,432,0.539351851851852
"586","Marcus Fernaldi GIDEON","Kevin Sanjaya SUKAMULJO","Mohammad AHSAN","Hendra SETIAWAN",11,2019,"Men","Doubles",5,5,0,229,183,46,1,412,0.555825242718447
"587","LI Junhui","LIU Yuchen","Aaron CHIA","SOH Wooi Yik",11,2019,"Men","Doubles",4,4,0,229,191,38,1,420,0.545238095238095
"588","Mohammad AHSAN","Hendra SETIAWAN","Aaron CHIA","SOH Wooi Yik",13,2019,"Men","Doubles",6,4,2,213,187,26,0.666666666666667,400,0.5325
"589","Takeshi KAMURA","Keigo SONODA","HE Jiting","TAN Qiang",14,2019,"Men","Doubles",4,4,0,207,159,48,1,366,0.565573770491803
"590","Takeshi KAMURA","Keigo SONODA","GOH V Shem","TAN Wee Kiong",15,2019,"Men","Doubles",4,4,0,206,176,30,1,382,0.539267015706806
"591","LEE Yang","WANG Chi-Lin","CHOI SolGyu","SEO Seung Jae",16,2019,"Men","Doubles",4,1,3,204,201,3,0.25,405,0.503703703703704
"592","Mohammad AHSAN","Hendra SETIAWAN","GOH V Shem","TAN Wee Kiong",17,2019,"Men","Doubles",4,3,1,203,183,20,0.75,386,0.525906735751295
"593","Hiroyuki ENDO","Yuta WATANABE","ONG Yew Sin","TEO Ee Yi",18,2019,"Men","Doubles",4,4,0,202,159,43,1,361,0.559556786703601
"594","Mohammad AHSAN","Hendra SETIAWAN","Takeshi KAMURA","Keigo SONODA",19,2019,"Men","Doubles",4,3,1,197,181,16,0.75,378,0.521164021164021
"595","Aaron CHIA","SOH Wooi Yik","Kim ASTRUP","Anders Skaarup RASMUSSEN",20,2019,"Men","Doubles",4,3,1,187,156,31,0.75,343,0.545189504373178
"596","GOH V Shem","TAN Wee Kiong","ONG Yew Sin","TEO Ee Yi",21,2019,"Men","Doubles",4,4,0,184,142,42,1,326,0.56441717791411
"597","Mohammad AHSAN","Hendra SETIAWAN","Mark LAMSFUSS","Marvin SEIDEL",21,2019,"Men","Doubles",4,4,0,184,148,36,1,332,0.55421686746988
"598","Mathias BOE","Mads CONRAD-PETERSEN","HAN Chengkai","ZHOU Haodong",23,2019,"Men","Doubles",4,3,1,176,154,22,0.75,330,0.533333333333333
"599","Marcus Fernaldi GIDEON","Kevin Sanjaya SUKAMULJO","GOH V Shem","TAN Wee Kiong",24,2019,"Men","Doubles",4,4,0,172,132,40,1,304,0.565789473684211
"600","LEE Yang","WANG Chi-Lin","Vladimir IVANOV","Ivan SOZONOV",25,2019,"Men","Doubles",3,3,0,169,150,19,1,319,0.529780564263323
"601","ZHENG Siwei","HUANG Yaqiong","Praveen JORDAN","Melati Daeva OKTAVIANTI",1,2019,"Mixed","Doubles",7,5,2,349,313,36,0.714285714285714,662,0.527190332326284
"602","ZHENG Siwei","HUANG Yaqiong","Yuta WATANABE","Arisa HIGASHINO",2,2019,"Mixed","Doubles",6,5,1,276,244,32,0.833333333333333,520,0.530769230769231
"603","WANG Yilyu","HUANG Dongping","Dechapol PUAVARANUKROH","Sapsiree TAERATTANACHAI",3,2019,"Mixed","Doubles",6,5,1,265,213,52,0.833333333333333,478,0.554393305439331
"604","WANG Yilyu","HUANG Dongping","CHAN Peng Soon","GOH Liu Ying",4,2019,"Mixed","Doubles",5,5,0,254,195,59,1,449,0.565701559020045
"605","Praveen JORDAN","Melati Daeva OKTAVIANTI","Hafiz FAIZAL","Gloria Emanuelle WIDJAJA",5,2019,"Mixed","Doubles",5,4,1,218,196,22,0.8,414,0.526570048309179
"606","Rinov RIVALDY","Pitha Haningtyas MENTARI","TAN Kian Meng","LAI Pei Jing",6,2019,"Mixed","Doubles",4,2,2,211,200,11,0.5,411,0.51338199513382
"607","ZHENG Siwei","HUANG Yaqiong","WANG Yilyu","HUANG Dongping",7,2019,"Mixed","Doubles",5,4,1,208,185,23,0.8,393,0.529262086513995
"608","ZHENG Siwei","HUANG Yaqiong","TAN Kian Meng","LAI Pei Jing",8,2019,"Mixed","Doubles",4,4,0,202,152,50,1,354,0.570621468926554
"609","Praveen JORDAN","Melati Daeva OKTAVIANTI","Dechapol PUAVARANUKROH","Sapsiree TAERATTANACHAI",9,2019,"Mixed","Doubles",4,3,1,195,161,34,0.75,356,0.547752808988764
"610","ZHENG Siwei","HUANG Yaqiong","Dechapol PUAVARANUKROH","Sapsiree TAERATTANACHAI",10,2019,"Mixed","Doubles",5,3,2,194,155,39,0.6,349,0.555873925501433
"611","Yuta WATANABE","Arisa HIGASHINO","SEO Seung Jae","CHAE YuJung",11,2019,"Mixed","Doubles",5,3,2,186,169,17,0.6,355,0.523943661971831
"612","WANG Yilyu","HUANG Dongping","Praveen JORDAN","Melati Daeva OKTAVIANTI",12,2019,"Mixed","Doubles",4,3,1,184,140,44,0.75,324,0.567901234567901
"613","CHAN Peng Soon","GOH Liu Ying","Tontowi AHMAD","Winny Oktavina KANDOW",13,2019,"Mixed","Doubles",3,1,2,173,167,6,0.333333333333333,340,0.508823529411765
"614","WANG Yilyu","HUANG Dongping","HE Jiting","DU Yue",14,2019,"Mixed","Doubles",4,3,1,171,144,27,0.75,315,0.542857142857143
"615","ZHENG Siwei","HUANG Yaqiong","SEO Seung Jae","CHAE YuJung",15,2019,"Mixed","Doubles",4,4,0,170,111,59,1,281,0.604982206405694
"616","Dechapol PUAVARANUKROH","Sapsiree TAERATTANACHAI","Mark LAMSFUSS","Isabel HERTTRICH",16,2019,"Mixed","Doubles",3,3,0,165,121,44,1,286,0.576923076923077
"617","Marcus ELLIS","Lauren SMITH","Mark LAMSFUSS","Isabel HERTTRICH",17,2019,"Mixed","Doubles",4,3,1,163,145,18,0.75,308,0.529220779220779
"618","ZHENG Siwei","HUANG Yaqiong","Hafiz FAIZAL","Gloria Emanuelle WIDJAJA",18,2019,"Mixed","Doubles",3,2,1,161,140,21,0.666666666666667,301,0.534883720930233
"619","Rodion ALIMOV","Alina DAVLETOVA","Thom GICQUEL","Delphine DELRUE",19,2019,"Mixed","Doubles",3,3,0,160,122,38,1,282,0.567375886524823
"620","Dechapol PUAVARANUKROH","Sapsiree TAERATTANACHAI","LU Kai","CHEN Lu",20,2019,"Mixed","Doubles",3,2,1,157,141,16,0.666666666666667,298,0.526845637583893
"621","WANG Yilyu","HUANG Dongping","SEO Seung Jae","CHAE YuJung",20,2019,"Mixed","Doubles",3,3,0,157,131,26,1,288,0.545138888888889
"622","Yuta WATANABE","Arisa HIGASHINO","Praveen JORDAN","Melati Daeva OKTAVIANTI",22,2019,"Mixed","Doubles",3,2,1,153,138,15,0.666666666666667,291,0.525773195876289
"623","GOH Soon Huat","LAI Shevon Jemie","Marcus ELLIS","Lauren SMITH",23,2019,"Mixed","Doubles",3,3,0,150,134,16,1,284,0.528169014084507
"624","Hafiz FAIZAL","Gloria Emanuelle WIDJAJA","Tontowi AHMAD","Winny Oktavina KANDOW",24,2019,"Mixed","Doubles",3,2,1,149,131,18,0.666666666666667,280,0.532142857142857
"625","Praveen JORDAN","Melati Daeva OKTAVIANTI","Yuki KANEKO","Misaki MATSUTOMO",24,2019,"Mixed","Doubles",3,1,2,149,143,6,0.333333333333333,292,0.51027397260274
"626","CHEN Yufei",NA,"Akane YAMAGUCHI",NA,1,2018,"Women","Singles",8,4,4,383,357,26,0.5,740,0.517567567567568
"627","TAI Tzu Ying",NA,"CHEN Yufei",NA,2,2018,"Women","Singles",6,6,0,324,259,65,1,583,0.555746140651801
"628","PUSARLA V. Sindhu",NA,"Akane YAMAGUCHI",NA,3,2018,"Women","Singles",6,5,1,289,255,34,0.833333333333333,544,0.53125
"629","TAI Tzu Ying",NA,"HE Bingjiao",NA,4,2018,"Women","Singles",6,5,1,282,211,71,0.833333333333333,493,0.572008113590264
"630","CHEN Yufei",NA,"Ratchanok INTANON",NA,5,2018,"Women","Singles",5,3,2,275,262,13,0.6,537,0.512104283054004
"631","TAI Tzu Ying",NA,"Saina NEHWAL",NA,6,2018,"Women","Singles",6,6,0,272,200,72,1,472,0.576271186440678
"632","CHEN Yufei",NA,"SUNG Ji Hyun",NA,7,2018,"Women","Singles",5,5,0,251,191,60,1,442,0.567873303167421
"633","Nozomi OKUHARA",NA,"Saina NEHWAL",NA,8,2018,"Women","Singles",4,2,2,224,219,5,0.5,443,0.505643340857788
"634","CHEN Yufei",NA,"Nitchaon JINDAPOL",NA,9,2018,"Women","Singles",4,4,0,220,180,40,1,400,0.55
"635","Nozomi OKUHARA",NA,"HE Bingjiao",NA,10,2018,"Women","Singles",4,4,0,206,147,59,1,353,0.58356940509915
"636","PUSARLA V. Sindhu",NA,"Beiwen ZHANG",NA,11,2018,"Women","Singles",4,2,2,199,161,38,0.5,360,0.552777777777778
"637","Nozomi OKUHARA",NA,"Pornpawee CHOCHUWONG",NA,12,2018,"Women","Singles",4,3,1,191,156,35,0.75,347,0.550432276657061
"638","CAI Yanyan",NA,"GAO Fangjie",NA,13,2018,"Women","Singles",4,2,2,190,182,8,0.5,372,0.510752688172043
"639","Akane YAMAGUCHI",NA,"Nozomi OKUHARA",NA,14,2018,"Women","Singles",4,2,2,186,185,1,0.5,371,0.501347708894879
"640","TAI Tzu Ying",NA,"Soniia CHEAH",NA,14,2018,"Women","Singles",4,4,0,186,135,51,1,321,0.579439252336449
"641","Nozomi OKUHARA",NA,"CHEUNG Ngan Yi",NA,16,2018,"Women","Singles",4,4,0,182,133,49,1,315,0.577777777777778
"642","Akane YAMAGUCHI",NA,"HE Bingjiao",NA,16,2018,"Women","Singles",4,3,1,182,166,16,0.75,348,0.522988505747126
"643","Saina NEHWAL",NA,"Akane YAMAGUCHI",NA,18,2018,"Women","Singles",4,1,3,180,178,2,0.25,358,0.502793296089385
"644","Akane YAMAGUCHI",NA,"Beiwen ZHANG",NA,19,2018,"Women","Singles",4,2,2,179,148,31,0.5,327,0.547400611620795
"645","PUSARLA V. Sindhu",NA,"Nozomi OKUHARA",NA,19,2018,"Women","Singles",4,3,1,179,172,7,0.75,351,0.50997150997151
"646","Mia BLICHFELDT",NA,"Evgeniya KOSETSKAYA",NA,21,2018,"Women","Singles",3,2,1,171,160,11,0.666666666666667,331,0.516616314199396
"647","KISONA Selvaduray",NA,"Ruselli HARTAWAN",NA,21,2018,"Women","Singles",3,2,1,171,163,8,0.666666666666667,334,0.511976047904192
"648","Ratchanok INTANON",NA,"Fitriani FITRIANI",NA,24,2018,"Women","Singles",4,4,0,168,98,70,1,266,0.631578947368421
"649","TAI Tzu Ying",NA,"Akane YAMAGUCHI",NA,24,2018,"Women","Singles",4,2,2,168,160,8,0.5,328,0.51219512195122
"650","PUSARLA V. Sindhu",NA,"Nitchaon JINDAPOL",NA,24,2018,"Women","Singles",3,3,0,168,151,17,1,319,0.526645768025078
"651","Misaki MATSUTOMO","Ayaka TAKAHASHI","Greysia POLII","Apriyani RAHAYU",1,2018,"Women","Doubles",7,6,1,307,276,31,0.857142857142857,583,0.526586620926244
"652","Nami MATSUYAMA","Chiharu SHIDA","Ayako SAKURAMOTO","Yukiko TAKAHATA",2,2018,"Women","Doubles",5,1,4,247,246,1,0.2,493,0.501014198782961
"653","Yuki FUKUSHIMA","Sayaka HIROTA","Greysia POLII","Apriyani RAHAYU",3,2018,"Women","Doubles",5,5,0,231,161,70,1,392,0.589285714285714
"654","Misaki MATSUTOMO","Ayaka TAKAHASHI","Mayu MATSUMOTO","Wakana NAGAHARA",4,2018,"Women","Doubles",5,3,2,213,202,11,0.6,415,0.513253012048193
"655","Yuki FUKUSHIMA","Sayaka HIROTA","Mayu MATSUMOTO","Wakana NAGAHARA",4,2018,"Women","Doubles",4,2,2,213,200,13,0.5,413,0.515738498789346
"656","LEE So Hee","SHIN Seung Chan","Gabriela STOEVA","Stefani STOEVA",6,2018,"Women","Doubles",5,3,2,207,191,16,0.6,398,0.520100502512563
"657","Yuki FUKUSHIMA","Sayaka HIROTA","Della Destiara HARIS","Rizki Amelia PRADIPTA",7,2018,"Women","Doubles",4,4,0,195,155,40,1,350,0.557142857142857
"658","Misaki MATSUTOMO","Ayaka TAKAHASHI","Della Destiara HARIS","Rizki Amelia PRADIPTA",8,2018,"Women","Doubles",4,4,0,187,114,73,1,301,0.621262458471761
"659","CHEN Qingchen","JIA Yifan","Jongkolphan KITITHARAKUL","Rawinda PRAJONGJAI",9,2018,"Women","Doubles",4,4,0,186,149,37,1,335,0.555223880597015
"660","Jongkolphan KITITHARAKUL","Rawinda PRAJONGJAI","Maiken FRUERGAARD","Sara THYGESEN",10,2018,"Women","Doubles",4,3,1,182,150,32,0.75,332,0.548192771084337
"661","Misaki MATSUTOMO","Ayaka TAKAHASHI","DU Yue","LI Yinhui",11,2018,"Women","Doubles",4,3,1,174,140,34,0.75,314,0.554140127388535
"662","Yuki FUKUSHIMA","Sayaka HIROTA","Jongkolphan KITITHARAKUL","Rawinda PRAJONGJAI",12,2018,"Women","Doubles",4,3,1,172,141,31,0.75,313,0.549520766773163
"663","Gabriela STOEVA","Stefani STOEVA","Emilie LEFEL","Anne TRAN",14,2018,"Women","Doubles",4,4,0,168,96,72,1,264,0.636363636363636
"664","Mayu MATSUMOTO","Wakana NAGAHARA","Gabriela STOEVA","Stefani STOEVA",14,2018,"Women","Doubles",4,4,0,168,109,59,1,277,0.606498194945848
"665","CHEN Qingchen","JIA Yifan","CHANG Ye Na","JUNG Kyung Eun",14,2018,"Women","Doubles",3,3,0,168,167,1,1,335,0.501492537313433
"666","Yuki FUKUSHIMA","Sayaka HIROTA","CHEN Qingchen","JIA Yifan",16,2018,"Women","Doubles",4,2,2,159,155,4,0.5,314,0.506369426751592
"667","Greysia POLII","Apriyani RAHAYU","LEE So Hee","SHIN Seung Chan",17,2018,"Women","Doubles",3,2,1,157,143,14,0.666666666666667,300,0.523333333333333
"668","Misaki MATSUTOMO","Ayaka TAKAHASHI","Yuki FUKUSHIMA","Sayaka HIROTA",18,2018,"Women","Doubles",3,1,2,153,147,6,0.333333333333333,300,0.51
"669","CHEN Qingchen","JIA Yifan","DU Yue","LI Yinhui",19,2018,"Women","Doubles",4,2,2,148,143,5,0.5,291,0.508591065292096
"670","CHANG Ye Na","JUNG Kyung Eun","Yuki FUKUSHIMA","Sayaka HIROTA",19,2018,"Women","Doubles",3,2,1,148,131,17,0.666666666666667,279,0.530465949820789
"671","Yuki FUKUSHIMA","Sayaka HIROTA","Anggia Shitta AWANDA","Ni Ketut Mahadewi ISTARANI",21,2018,"Women","Doubles",3,3,0,146,128,18,1,274,0.532846715328467
"672","DU Yue","LI Yinhui","Mayu MATSUMOTO","Wakana NAGAHARA",22,2018,"Women","Doubles",3,2,1,145,131,14,0.666666666666667,276,0.52536231884058
"673","Misaki MATSUTOMO","Ayaka TAKAHASHI","Ashwini PONNAPPA","REDDY N. Sikki",23,2018,"Women","Doubles",3,3,0,144,102,42,1,246,0.585365853658537
"674","LEE So Hee","SHIN Seung Chan","Mayu MATSUMOTO","Wakana NAGAHARA",24,2018,"Women","Doubles",3,2,1,143,127,16,0.666666666666667,270,0.52962962962963
"675","Misaki MATSUTOMO","Ayaka TAKAHASHI","CHEN Qingchen","JIA Yifan",24,2018,"Women","Doubles",3,2,1,143,122,21,0.666666666666667,265,0.539622641509434
"676","SON Wan Ho",NA,"Kenta NISHIMOTO",NA,1,2018,"Men","Singles",7,5,2,335,320,15,0.714285714285714,655,0.511450381679389
"677","Kento MOMOTA",NA,"CHOU Tien Chen",NA,2,2018,"Men","Singles",6,5,1,302,259,43,0.833333333333333,561,0.538324420677362
"678","Kento MOMOTA",NA,"Anthony Sinisuka GINTING",NA,3,2018,"Men","Singles",6,4,2,291,274,17,0.666666666666667,565,0.515044247787611
"679","CHOU Tien Chen",NA,"Anthony Sinisuka GINTING",NA,4,2018,"Men","Singles",5,3,2,263,249,14,0.6,512,0.513671875
"680","Anthony Sinisuka GINTING",NA,"CHEN Long",NA,5,2018,"Men","Singles",5,4,1,239,212,27,0.8,451,0.529933481152993
"681","SHI Yuqi",NA,"NG Ka Long Angus",NA,6,2018,"Men","Singles",5,4,1,224,162,62,0.8,386,0.580310880829015
"682","Kento MOMOTA",NA,"KIDAMBI Srikanth",NA,7,2018,"Men","Singles",5,5,0,222,159,63,1,381,0.582677165354331
"683","SHI Yuqi",NA,"Anthony Sinisuka GINTING",NA,8,2018,"Men","Singles",4,4,0,218,194,24,1,412,0.529126213592233
"684","CHOU Tien Chen",NA,"SHI Yuqi",NA,9,2018,"Men","Singles",5,2,3,206,195,11,0.4,401,0.513715710723192
"685","Kento MOMOTA",NA,"SON Wan Ho",NA,10,2018,"Men","Singles",5,4,1,203,159,44,0.8,362,0.560773480662983
"686","CHOU Tien Chen",NA,"NG Ka Long Angus",NA,11,2018,"Men","Singles",4,3,1,201,186,15,0.75,387,0.51937984496124
"687","Jonatan CHRISTIE",NA,"Kenta NISHIMOTO",NA,12,2018,"Men","Singles",4,3,1,191,178,13,0.75,369,0.517615176151762
"688","Khosit PHETPRADAB",NA,"LEE Dong Keun",NA,13,2018,"Men","Singles",4,2,2,188,164,24,0.5,352,0.534090909090909
"689","Jan O JORGENSEN",NA,"Riichi TAKESHITA",NA,14,2018,"Men","Singles",3,2,1,182,170,12,0.666666666666667,352,0.517045454545455
"690","CHOU Tien Chen",NA,"LEE Dong Keun",NA,14,2018,"Men","Singles",3,2,1,182,150,32,0.666666666666667,332,0.548192771084337
"691","KIDAMBI Srikanth",NA,"WONG Wing Ki Vincent",NA,16,2018,"Men","Singles",5,4,1,173,133,40,0.8,306,0.565359477124183
"692","SHI Yuqi",NA,"Jonatan CHRISTIE",NA,16,2018,"Men","Singles",3,1,2,173,167,6,0.333333333333333,340,0.508823529411765
"693","Kento MOMOTA",NA,"CHEN Long",NA,18,2018,"Men","Singles",4,3,1,171,154,17,0.75,325,0.526153846153846
"694","CHOU Tien Chen",NA,"Rasmus GEMKE",NA,19,2018,"Men","Singles",4,3,1,170,152,18,0.75,322,0.527950310559006
"695","Kento MOMOTA",NA,"SHI Yuqi",NA,20,2018,"Men","Singles",4,3,1,161,141,20,0.75,302,0.533112582781457
"696","Sameer VERMA",NA,"Lucas CORVEE",NA,21,2018,"Men","Singles",3,2,1,159,140,19,0.666666666666667,299,0.531772575250836
"697","Kento MOMOTA",NA,"Anders ANTONSEN",NA,21,2018,"Men","Singles",3,3,0,159,121,38,1,280,0.567857142857143
"698","Sitthikom THAMMASIN",NA,"Firman Abdul KHOLIK",NA,23,2018,"Men","Singles",3,3,0,156,134,22,1,290,0.537931034482759
"699","LEE Hyun Il",NA,"Anders ANTONSEN",NA,23,2018,"Men","Singles",3,2,1,156,144,12,0.666666666666667,300,0.52
"700","Tommy SUGIARTO",NA,"Kantaphon WANGCHAROEN",NA,25,2018,"Men","Singles",3,3,0,155,127,28,1,282,0.549645390070922
"701","LIU Cheng","ZHANG Nan","GOH V Shem","TAN Wee Kiong",1,2018,"Men","Doubles",5,2,3,289,278,11,0.4,567,0.509700176366843
"702","Takeshi KAMURA","Keigo SONODA","Fajar ALFIAN","Muhammad Rian ARDIANTO",2,2018,"Men","Doubles",5,2,3,230,230,0,0.4,460,0.5
"703","Fajar ALFIAN","Muhammad Rian ARDIANTO","Takeshi KAMURA","Keigo SONODA",2,2018,"Men","Doubles",5,3,2,230,230,0,0.6,460,0.5
"704","Marcus Fernaldi GIDEON","Kevin Sanjaya SUKAMULJO","Mohammad AHSAN","Hendra SETIAWAN",4,2018,"Men","Doubles",4,4,0,207,158,49,1,365,0.567123287671233
"705","LIU Cheng","ZHANG Nan","LEE Jhe-Huei","LEE Yang",5,2018,"Men","Doubles",4,3,1,199,178,21,0.75,377,0.527851458885942
"706","Marcus Fernaldi GIDEON","Kevin Sanjaya SUKAMULJO","HE Jiting","TAN Qiang",6,2018,"Men","Doubles",4,3,1,194,190,4,0.75,384,0.505208333333333
"707","Hiroyuki ENDO","Yuta WATANABE","LIAO Min Chun","SU Ching Heng",7,2018,"Men","Doubles",4,1,3,193,183,10,0.25,376,0.513297872340426
"708","LI Junhui","LIU Yuchen","Kim ASTRUP","Anders Skaarup RASMUSSEN",8,2018,"Men","Doubles",4,3,1,189,182,7,0.75,371,0.509433962264151
"709","Kim ASTRUP","Anders Skaarup RASMUSSEN","HAN Chengkai","ZHOU Haodong",9,2018,"Men","Doubles",4,4,0,185,153,32,1,338,0.547337278106509
"710","Marcus Fernaldi GIDEON","Kevin Sanjaya SUKAMULJO","LI Junhui","LIU Yuchen",10,2018,"Men","Doubles",4,3,1,177,151,26,0.75,328,0.539634146341463
"711","Marcus Fernaldi GIDEON","Kevin Sanjaya SUKAMULJO","HAN Chengkai","ZHOU Haodong",11,2018,"Men","Doubles",4,1,3,176,158,18,0.25,334,0.526946107784431
"712","CHEN Hung Ling","WANG Chi-Lin","HE Jiting","TAN Qiang",12,2018,"Men","Doubles",4,2,2,171,165,6,0.5,336,0.508928571428571
"713","Marcus Fernaldi GIDEON","Kevin Sanjaya SUKAMULJO","Takeshi KAMURA","Keigo SONODA",14,2018,"Men","Doubles",4,3,1,163,128,35,0.75,291,0.560137457044674
"714","LI Junhui","LIU Yuchen","CHEN Hung Ling","WANG Chi-Lin",14,2018,"Men","Doubles",3,3,0,163,120,43,1,283,0.575971731448763
"715","OU Xuanyi","REN Xiangyu","Min Hyuk KANG","KIM Won Ho",14,2018,"Men","Doubles",3,2,1,163,149,14,0.666666666666667,312,0.522435897435897
"716","HE Jiting","TAN Qiang","Takuro HOKI","Yugo KOBAYASHI",14,2018,"Men","Doubles",3,3,0,163,145,18,1,308,0.529220779220779
"717","Mohammad AHSAN","Hendra SETIAWAN","LEE Jhe-Huei","LEE Yang",17,2018,"Men","Doubles",3,2,1,159,145,14,0.666666666666667,304,0.523026315789474
"718","LI Junhui","LIU Yuchen","LU Ching Yao","YANG Po Han",17,2018,"Men","Doubles",3,3,0,159,136,23,1,295,0.538983050847458
"719","LI Junhui","LIU Yuchen","Fajar ALFIAN","Muhammad Rian ARDIANTO",19,2018,"Men","Doubles",3,2,1,151,143,8,0.666666666666667,294,0.513605442176871
"720","Marcus Fernaldi GIDEON","Kevin Sanjaya SUKAMULJO","Satwiksairaj RANKIREDDY","Chirag SHETTY",20,2018,"Men","Doubles",3,3,0,150,117,33,1,267,0.561797752808989
"721","Marcus Fernaldi GIDEON","Kevin Sanjaya SUKAMULJO","Kim ASTRUP","Anders Skaarup RASMUSSEN",21,2018,"Men","Doubles",3,3,0,147,119,28,1,266,0.552631578947368
"722","Mathias BOE","Carsten MOGENSEN","Satwiksairaj RANKIREDDY","Chirag SHETTY",21,2018,"Men","Doubles",3,2,1,147,145,2,0.666666666666667,292,0.503424657534247
"723","Marcus Fernaldi GIDEON","Kevin Sanjaya SUKAMULJO","CHEN Hung Ling","WANG Chi-Lin",23,2018,"Men","Doubles",3,3,0,146,106,40,1,252,0.579365079365079
"724","Fajar ALFIAN","Muhammad Rian ARDIANTO","ONG Yew Sin","TEO Ee Yi",24,2018,"Men","Doubles",3,2,1,142,125,17,0.666666666666667,267,0.531835205992509
"725","Takeshi KAMURA","Keigo SONODA","CHEN Hung Ling","WANG Chi-Lin",24,2018,"Men","Doubles",3,3,0,142,114,28,1,256,0.5546875
"726","WANG Yilyu","HUANG Dongping","Yuta WATANABE","Arisa HIGASHINO",1,2018,"Mixed","Doubles",8,7,1,376,297,79,0.875,673,0.558692421991085
"727","ZHENG Siwei","HUANG Yaqiong","WANG Yilyu","HUANG Dongping",2,2018,"Mixed","Doubles",7,6,1,339,294,45,0.857142857142857,633,0.535545023696682
"728","ZHENG Siwei","HUANG Yaqiong","Dechapol PUAVARANUKROH","Sapsiree TAERATTANACHAI",3,2018,"Mixed","Doubles",5,5,0,265,199,66,1,464,0.571120689655172
"729","Dechapol PUAVARANUKROH","Sapsiree TAERATTANACHAI","GOH Soon Huat","LAI Shevon Jemie",4,2018,"Mixed","Doubles",5,3,2,232,208,24,0.6,440,0.527272727272727
"730","ZHENG Siwei","HUANG Yaqiong","TANG Chun Man","TSE Ying Suet",5,2018,"Mixed","Doubles",5,4,1,227,163,64,0.8,390,0.582051282051282
"731","Marcus ELLIS","Lauren SMITH","Marvin SEIDEL","Linda EFLER",6,2018,"Mixed","Doubles",5,5,0,213,145,68,1,358,0.594972067039106
"732","Praveen JORDAN","Melati Daeva OKTAVIANTI","Chris ADCOCK","Gabrielle ADCOCK",7,2018,"Mixed","Doubles",4,2,2,199,177,22,0.5,376,0.529255319148936
"733","ZHENG Siwei","HUANG Yaqiong","Yuta WATANABE","Arisa HIGASHINO",7,2018,"Mixed","Doubles",4,3,1,199,152,47,0.75,351,0.566951566951567
"734","Praveen JORDAN","Melati Daeva OKTAVIANTI","CHAN Peng Soon","GOH Liu Ying",9,2018,"Mixed","Doubles",4,3,1,196,182,14,0.75,378,0.518518518518518
"735","WANG Yilyu","HUANG Dongping","Dechapol PUAVARANUKROH","Sapsiree TAERATTANACHAI",10,2018,"Mixed","Doubles",4,2,2,181,178,3,0.5,359,0.504178272980501
"736","Yuta WATANABE","Arisa HIGASHINO","TANG Chun Man","TSE Ying Suet",11,2018,"Mixed","Doubles",3,3,0,177,163,14,1,340,0.520588235294118
"737","Dechapol PUAVARANUKROH","Sapsiree TAERATTANACHAI","Chris ADCOCK","Gabrielle ADCOCK",12,2018,"Mixed","Doubles",3,3,0,174,157,17,1,331,0.525679758308157
"738","ZHENG Siwei","HUANG Yaqiong","Tontowi AHMAD","Liliyana NATSIR",13,2018,"Mixed","Doubles",4,3,1,169,147,22,0.75,316,0.534810126582278
"739","SEO Seung Jae","CHAE YuJung","CHAN Peng Soon","GOH Liu Ying",14,2018,"Mixed","Doubles",3,2,1,164,141,23,0.666666666666667,305,0.537704918032787
"740","ZHENG Siwei","HUANG Yaqiong","Niclas NOHR","Sara THYGESEN",14,2018,"Mixed","Doubles",3,3,0,164,140,24,1,304,0.539473684210526
"741","Dechapol PUAVARANUKROH","Sapsiree TAERATTANACHAI","CHANG Tak Ching","NG Wing Yung",16,2018,"Mixed","Doubles",3,3,0,162,119,43,1,281,0.576512455516014
"742","WANG Yilyu","HUANG Dongping","Praveen JORDAN","Melati Daeva OKTAVIANTI",17,2018,"Mixed","Doubles",3,3,0,158,126,32,1,284,0.556338028169014
"743","Yuta WATANABE","Arisa HIGASHINO","Hafiz FAIZAL","Gloria Emanuelle WIDJAJA",17,2018,"Mixed","Doubles",3,2,1,158,149,9,0.666666666666667,307,0.514657980456026
"744","Mark LAMSFUSS","Isabel HERTTRICH","LU Kai","CHEN Lu",19,2018,"Mixed","Doubles",4,2,2,156,149,7,0.5,305,0.511475409836066
"745","SEO Seung Jae","CHAE YuJung","Dechapol PUAVARANUKROH","Sapsiree TAERATTANACHAI",20,2018,"Mixed","Doubles",3,2,1,153,133,20,0.666666666666667,286,0.534965034965035
"746","Mark LAMSFUSS","Isabel HERTTRICH","Jacco ARENDS","Selena PIEK",21,2018,"Mixed","Doubles",4,3,1,145,112,33,0.75,257,0.56420233463035
"747","ZHENG Siwei","HUANG Yaqiong","ZHANG Nan","LI Yinhui",21,2018,"Mixed","Doubles",3,3,0,145,91,54,1,236,0.614406779661017
"748","ZHENG Siwei","HUANG Yaqiong","Chris ADCOCK","Gabrielle ADCOCK",23,2018,"Mixed","Doubles",3,3,0,143,100,43,1,243,0.588477366255144
"749","ZHANG Nan","LI Yinhui","Yuta WATANABE","Arisa HIGASHINO",24,2018,"Mixed","Doubles",3,2,1,136,122,14,0.666666666666667,258,0.527131782945736
"750","ZHENG Siwei","HUANG Yaqiong","CHAN Peng Soon","GOH Liu Ying",25,2018,"Mixed","Doubles",3,2,1,135,128,7,0.666666666666667,263,0.513307984790874
