Season,Player,Pos,Age,Tm,G,GS,MP,FG,FGA,FG%,3P,3PA,3P%,2P,2PA,2P%,eFG%,FT,FTA,FT%,ORB,DRB,TRB,AST,STL,BLK,TOV,PF,PTS
1990,Mark Acres,C,27,ORL,80,50,1691,138,285,0.484,3,4,0.75,135,281,0.48,0.489,83,120,0.692,154,277,431,67,36,25,70,248,362
1990,Greg Anderson,PF,25,MIL,60,28,1291,219,432,0.507,0,0,NA,219,432,0.507,0.507,91,170,0.535,112,261,373,24,32,54,80,176,529
1990,Ron Anderson,SF,31,PHI,78,3,2089,379,841,0.451,3,21,0.143,376,820,0.459,0.452,165,197,0.838,81,214,295,143,72,13,78,143,926
1990,Willie Anderson,SG,23,SAS,82,81,2788,532,1082,0.492,7,26,0.269,525,1056,0.497,0.495,217,290,0.748,115,257,372,364,111,58,198,252,1288
1990,Michael Ansley,SF,22,ORL,72,5,1221,231,465,0.497,0,0,NA,231,465,0.497,0.497,164,227,0.722,187,175,362,40,24,17,50,152,626
1990,B.J. Armstrong,PG,22,CHI,81,0,1291,190,392,0.485,3,6,0.5,187,386,0.484,0.489,69,78,0.885,19,83,102,199,46,6,83,105,452
1990,Thurl Bailey,SF,28,UTA,82,33,2583,470,977,0.481,0,8,0,470,969,0.485,0.481,222,285,0.779,116,294,410,137,32,100,139,175,1162
1990,Kenny Battle,SG,25,PHO,59,8,729,93,170,0.547,1,4,0.25,92,166,0.554,0.55,55,82,0.671,44,80,124,38,35,11,32,94,242
1990,Benoit Benjamin,C,25,LAC,71,58,2313,362,688,0.526,0,1,0,362,687,0.527,0.526,235,321,0.732,156,501,657,159,59,187,187,217,959
1990,Winston Bennett,SF,24,CLE,55,34,990,137,286,0.479,0,0,NA,137,286,0.479,0.479,64,96,0.667,84,104,188,54,23,10,62,133,338
1990,Uwe Blab,C,27,GSW,40,33,481,33,87,0.379,0,0,NA,33,87,0.379,0.379,17,31,0.548,28,71,99,24,1,22,30,93,83
1990,Uwe Blab,C,27,SAS,7,0,50,6,11,0.545,0,0,NA,6,11,0.545,0.545,3,6,0.5,1,8,9,1,0,0,5,9,15
1990,Muggsy Bogues,PG,25,CHH,81,65,2743,326,664,0.491,5,26,0.192,321,638,0.503,0.495,106,134,0.791,48,159,207,867,166,3,146,168,763
1990,Manute Bol,C,27,GSW,75,20,1310,56,169,0.331,9,48,0.188,47,121,0.388,0.358,25,49,0.51,33,243,276,36,13,238,51,194,146
1990,Randy Breuer,C,29,MIL,30,8,554,86,186,0.462,0,0,NA,86,186,0.462,0.462,32,51,0.627,43,84,127,13,9,33,28,63,204
1990,Randy Breuer,C,29,MIN,51,47,1325,212,510,0.416,0,1,0,212,509,0.417,0.416,94,142,0.662,111,179,290,84,33,75,68,133,518
1990,Frank Brickowski,C,30,SAS,78,12,1438,211,387,0.545,0,2,0,211,385,0.548,0.545,95,141,0.674,89,238,327,105,66,37,93,226,517
1990,Scott Brooks,PG,24,PHI,72,1,975,119,276,0.431,31,79,0.392,88,197,0.447,0.487,50,57,0.877,15,49,64,207,47,0,38,105,319
1990,Chucky Brown,SF,21,CLE,75,35,1339,210,447,0.47,0,7,0,210,440,0.477,0.47,125,164,0.762,83,148,231,50,33,26,69,148,545
1990,Tony Brown,SF,29,MIL,61,10,635,88,206,0.427,5,20,0.25,83,186,0.446,0.439,38,56,0.679,39,33,72,41,32,4,51,79,219
1990,Mark Bryant,PF,24,POR,58,0,562,70,153,0.458,0,0,NA,70,153,0.458,0.458,28,50,0.56,54,92,146,13,18,9,25,93,168
1990,Adrian Caldwell,PF,23,HOU,51,0,331,42,76,0.553,0,0,NA,42,76,0.553,0.553,13,28,0.464,36,73,109,7,11,18,32,69,97
1990,Tony Campbell,SG,27,MIN,82,81,3164,723,1581,0.457,9,54,0.167,714,1527,0.468,0.46,448,569,0.787,209,242,451,213,111,31,251,260,1903
1990,Antoine Carr,PF,28,ATL,44,0,803,128,248,0.516,0,4,0,128,244,0.525,0.516,79,102,0.775,50,99,149,53,15,34,54,128,335
1990,Antoine Carr,PF,28,SAC,33,4,924,228,473,0.482,0,3,0,228,470,0.485,0.482,158,196,0.806,65,108,173,66,15,34,71,119,614
1990,Joe Barry Carroll,C,31,NJN,46,20,1002,159,405,0.393,0,2,0,159,403,0.395,0.393,85,107,0.794,82,168,250,43,19,56,64,122,403
1990,Joe Barry Carroll,C,31,DEN,30,27,719,153,354,0.432,0,0,NA,153,354,0.432,0.432,52,70,0.743,51,142,193,54,28,59,78,70,358
1990,Rex Chapman,SG,22,CHH,54,52,1762,377,924,0.408,47,142,0.331,330,782,0.422,0.433,144,192,0.75,52,127,179,132,46,6,100,113,945
1990,Maurice Cheeks,PG,33,SAS,50,49,1766,215,450,0.478,1,9,0.111,214,441,0.485,0.479,114,137,0.832,39,128,167,302,82,5,85,46,545
1990,Maurice Cheeks,PG,33,NYK,31,13,753,92,159,0.579,3,7,0.429,89,152,0.586,0.588,57,65,0.877,11,62,73,151,42,5,36,32,244
1990,Derrick Chievous,SF,22,HOU,41,0,492,90,178,0.506,3,8,0.375,87,170,0.512,0.514,61,87,0.701,28,47,75,27,23,4,40,59,244
1990,Derrick Chievous,SF,22,CLE,14,0,99,15,42,0.357,0,1,0,15,41,0.366,0.357,19,24,0.792,7,8,15,4,3,1,5,11,49
1990,Lester Conner,PG,30,NJN,82,61,2355,237,573,0.414,2,13,0.154,235,560,0.42,0.415,172,214,0.804,90,175,265,385,172,8,138,182,648
1990,Tyrone Corbin,SF,27,MIN,82,80,3011,521,1083,0.481,0,11,0,521,1072,0.486,0.481,161,209,0.77,219,385,604,216,175,41,143,288,1203
1990,Terry Cummings,PF,28,SAS,81,78,2821,728,1532,0.475,19,59,0.322,709,1473,0.481,0.481,343,440,0.78,226,451,677,219,110,52,202,286,1818
1990,Walter Davis,SG,35,DEN,69,0,1635,497,1033,0.481,6,46,0.13,491,987,0.497,0.484,207,227,0.912,46,133,179,155,59,9,102,160,1207
1990,Vinny Del Negro,SG,23,SAC,76,29,1858,297,643,0.462,10,32,0.313,287,611,0.47,0.47,135,155,0.871,39,159,198,250,64,10,111,182,739
1990,Byron Dinkins,PG,22,HOU,33,0,362,44,109,0.404,1,9,0.111,43,100,0.43,0.408,26,30,0.867,13,27,40,75,19,2,37,30,115
1990,James Donaldson,C,32,DAL,73,73,2265,258,479,0.539,0,0,NA,258,479,0.539,0.539,149,213,0.7,155,475,630,57,22,47,119,129,665
1990,Sherman Douglas,PG,23,MIA,81,66,2470,463,938,0.494,5,31,0.161,458,907,0.505,0.496,224,326,0.687,70,136,206,619,145,10,246,187,1155
1990,Clyde Drexler,SG,27,POR,73,73,2683,670,1357,0.494,30,106,0.283,640,1251,0.512,0.505,333,430,0.774,208,299,507,432,145,51,191,222,1703
1990,Chris Dudley,PF,24,CLE,37,22,684,79,203,0.389,0,0,NA,79,203,0.389,0.389,26,77,0.338,88,115,203,20,19,41,48,83,184
1990,Chris Dudley,PF,24,NJN,27,8,672,67,152,0.441,0,0,NA,67,152,0.441,0.441,32,105,0.305,86,134,220,19,22,31,36,81,166
1990,Mike Dunleavy,PG,35,MIL,5,0,43,4,14,0.286,2,9,0.222,2,5,0.4,0.357,7,8,0.875,0,2,2,10,1,0,8,7,17
1990,Blue Edwards,SF,24,UTA,82,49,1889,286,564,0.507,9,30,0.3,277,534,0.519,0.515,146,203,0.719,69,182,251,145,76,36,152,280,727
1990,Kevin Edwards,SG,24,MIA,78,54,2211,395,959,0.412,9,30,0.3,386,929,0.416,0.417,139,183,0.76,77,205,282,252,125,33,180,149,938
1990,Dale Ellis,SG,29,SEA,55,49,2033,502,1011,0.497,96,256,0.375,406,755,0.538,0.544,193,236,0.818,90,148,238,110,59,7,119,124,1293
1990,Jim Farmer,SG,25,SEA,38,0,400,89,203,0.438,8,27,0.296,81,176,0.46,0.458,57,80,0.713,17,26,43,25,17,1,27,44,243
1990,Kevin Gamble,SF,24,BOS,71,10,990,137,301,0.455,3,18,0.167,134,283,0.473,0.46,85,107,0.794,42,70,112,119,28,8,44,77,362
1990,Winston Garland,PG,25,GSW,51,4,891,108,288,0.375,1,10,0.1,107,278,0.385,0.377,53,63,0.841,31,80,111,157,48,5,81,77,270
1990,Winston Garland,PG,25,LAC,28,15,871,122,285,0.428,11,26,0.423,111,259,0.429,0.447,49,59,0.831,20,83,103,146,30,5,77,75,304
1990,Tom Garrick,SG,23,LAC,73,22,1721,208,421,0.494,4,21,0.19,204,400,0.51,0.499,88,114,0.772,34,128,162,289,90,7,117,151,508
1990,Armen Gilliam,PF,25,PHO,16,7,267,52,121,0.43,0,0,NA,52,121,0.43,0.43,39,56,0.696,26,44,70,8,6,5,17,28,143
1990,Armen Gilliam,PF,25,CHH,60,59,2159,432,819,0.527,0,2,0,432,817,0.529,0.527,264,363,0.727,185,344,529,91,63,46,166,184,1128
1990,Mike Gminski,C,30,PHI,81,81,2659,458,1002,0.457,3,17,0.176,455,985,0.462,0.459,193,235,0.821,196,491,687,128,43,102,98,136,1112
1990,Greg Grant,PG,23,PHO,67,3,678,83,216,0.384,3,16,0.188,80,200,0.4,0.391,39,59,0.661,16,43,59,168,36,1,77,58,208
1990,Stuart Gray,C,26,CHH,39,1,466,38,82,0.463,0,2,0,38,80,0.475,0.463,25,39,0.641,38,93,131,17,12,24,19,64,101
1990,Stuart Gray,C,26,NYK,19,0,94,4,17,0.235,0,3,0,4,14,0.286,0.235,7,8,0.875,2,12,14,2,3,2,5,26,15
1990,Jeff Grayer,SF,24,MIL,71,40,1427,224,487,0.46,1,8,0.125,223,479,0.466,0.461,99,152,0.651,94,123,217,107,48,10,82,125,548
1990,A.C. Green,PF,26,LAL,82,82,2709,385,806,0.478,13,46,0.283,372,760,0.489,0.486,278,370,0.751,262,450,712,90,66,50,116,207,1061
1990,Sidney Green,C,29,ORL,73,31,1860,312,667,0.468,1,3,0.333,311,664,0.468,0.469,136,209,0.651,166,422,588,99,50,26,119,231,761
1990,Jack Haley,PF,26,CHI,11,0,58,9,20,0.45,0,0,NA,9,20,0.45,0.45,7,7,1,7,11,18,4,0,1,7,7,25
1990,Jack Haley,PF,26,NJN,56,26,1026,129,327,0.394,0,1,0,129,326,0.396,0.394,78,118,0.661,108,174,282,22,18,11,65,163,336
1990,Tom Hammonds,PF,22,WSB,61,8,805,129,295,0.437,0,1,0,129,294,0.439,0.437,63,98,0.643,61,107,168,51,11,14,46,98,321
1990,Bob Hansen,SG,29,UTA,81,81,2174,265,568,0.467,54,154,0.351,211,414,0.51,0.514,33,64,0.516,66,163,229,149,52,11,79,194,617
1990,Tim Hardaway,PG,23,GSW,79,78,2663,464,985,0.471,23,84,0.274,441,901,0.489,0.483,211,276,0.764,57,253,310,689,165,12,260,232,1162
1990,Derek Harper,PG,28,DAL,82,82,3007,567,1161,0.488,89,240,0.371,478,921,0.519,0.527,250,315,0.794,54,190,244,609,187,26,207,224,1473
1990,Ron Harper,SG,26,CLE,7,7,262,61,138,0.442,1,5,0.2,60,133,0.451,0.446,31,41,0.756,19,29,48,49,14,9,18,25,154
1990,Ron Harper,SG,26,LAC,28,28,1105,240,499,0.481,13,46,0.283,227,453,0.501,0.494,151,190,0.795,55,103,158,133,67,32,82,80,644
1990,Gerald Henderson,PG,34,MIL,11,0,129,11,26,0.423,3,7,0.429,8,19,0.421,0.481,2,2,1,3,9,12,13,8,0,8,14,27
1990,Gerald Henderson,PG,34,DET,46,0,335,42,83,0.506,14,31,0.452,28,52,0.538,0.59,10,13,0.769,8,23,31,61,8,2,16,36,108
1990,Mike Higgins,SF,22,LAL,6,0,18,0,0,NA,0,0,NA,0,0,NA,NA,1,2,0.5,1,0,1,1,1,2,0,4,1
1990,Mike Higgins,SF,22,DEN,5,0,32,3,8,0.375,0,0,NA,3,8,0.375,0.375,7,8,0.875,1,2,3,2,1,0,1,1,13
1990,Dave Hoppen,C,25,CHH,10,2,135,16,41,0.39,0,0,NA,16,41,0.39,0.39,8,10,0.8,19,17,36,6,2,1,8,26,40
1990,Dennis Hopson,SG,24,NJN,79,64,2551,474,1093,0.434,32,101,0.317,442,992,0.446,0.448,271,342,0.792,113,166,279,151,100,51,168,183,1251
1990,Jeff Hornacek,SG,26,PHO,67,60,2278,483,901,0.536,40,98,0.408,443,803,0.552,0.558,173,202,0.856,86,227,313,337,117,14,125,144,1179
1990,Jay Humphries,PG,27,MIL,81,81,2818,496,1005,0.494,21,70,0.3,475,935,0.508,0.504,224,285,0.786,80,189,269,472,156,11,151,253,1237
1990,Mark Jackson,PG,24,NYK,82,69,2428,327,749,0.437,35,131,0.267,292,618,0.472,0.46,120,165,0.727,106,212,318,604,109,4,211,121,809
1990,Avery Johnson,PG,24,SEA,53,10,575,55,142,0.387,1,4,0.25,54,138,0.391,0.391,29,40,0.725,21,22,43,162,26,1,48,55,140
1990,Eddie Johnson,SF,30,PHO,64,4,1811,411,907,0.453,70,184,0.38,341,723,0.472,0.492,188,205,0.917,69,177,246,107,32,10,108,174,1080
1990,Steve Johnson,C,32,MIN,4,0,17,0,2,0,0,0,NA,0,2,0,0,0,0,NA,0,3,3,1,0,0,6,4,0
1990,Steve Johnson,C,32,SEA,21,0,242,48,90,0.533,0,0,NA,48,90,0.533,0.533,21,35,0.6,19,31,50,16,3,5,25,52,117
1990,Nate Johnston,SF,23,UTA,6,0,13,4,11,0.364,1,1,1,3,10,0.3,0.409,2,2,1,2,0,2,0,0,1,1,0,11
1990,Nate Johnston,PF,23,POR,15,0,74,14,37,0.378,0,3,0,14,34,0.412,0.378,7,11,0.636,11,10,21,1,3,7,5,11,35
1990,Tim Kempton,PF,26,DEN,71,14,1061,153,312,0.49,0,1,0,153,311,0.492,0.49,77,114,0.675,51,167,218,118,30,9,80,144,383
1990,Steve Kerr,PG,24,CLE,78,5,1664,192,432,0.444,73,144,0.507,119,288,0.413,0.529,63,73,0.863,12,86,98,248,45,7,74,59,520
1990,Randolph Keys,SF,23,CLE,48,13,892,151,359,0.421,2,10,0.2,149,349,0.427,0.423,61,82,0.744,52,85,137,39,38,2,47,117,365
1990,Randolph Keys,SF,23,CHH,32,5,723,142,319,0.445,12,33,0.364,130,286,0.455,0.464,40,58,0.69,48,68,116,49,30,6,37,107,336
1990,Stacey King,PF,23,CHI,82,2,1777,267,530,0.504,0,1,0,267,529,0.505,0.504,194,267,0.727,169,215,384,87,38,58,119,215,728
1990,Greg Kite,C,28,SAC,71,47,1515,101,234,0.432,1,1,1,100,233,0.429,0.434,27,54,0.5,131,246,377,76,31,51,76,201,230
1990,Joe Kleine,C,28,BOS,81,4,1365,176,367,0.48,0,4,0,176,363,0.485,0.48,83,100,0.83,117,238,355,46,15,27,64,170,435
1990,Jerome Lane,PF,23,DEN,67,46,956,145,309,0.469,0,5,0,145,304,0.477,0.469,44,120,0.367,144,217,361,105,53,17,85,189,334
1990,Andrew Lang,C,23,PHO,74,0,1011,97,174,0.557,0,0,NA,97,174,0.557,0.557,64,98,0.653,83,188,271,21,22,133,41,171,258
1990,Eric Leckner,C,23,UTA,77,0,764,125,222,0.563,0,0,NA,125,222,0.563,0.563,81,109,0.743,48,144,192,19,15,23,63,157,331
1990,Tim Legler,SG,23,PHO,11,0,83,11,29,0.379,0,1,0,11,28,0.393,0.379,6,6,1,4,4,8,6,2,0,4,12,28
1990,Jim Les,PG,26,UTA,1,0,6,0,0,NA,0,0,NA,0,0,NA,NA,2,4,0.5,0,0,0,1,0,0,3,3,2
1990,Jim Les,PG,26,LAC,6,0,86,5,14,0.357,0,1,0,5,13,0.385,0.357,11,13,0.846,3,4,7,20,3,0,7,6,21
1990,Ralph Lewis,SG,26,DET,4,0,6,0,1,0,0,0,NA,0,1,0,0,0,0,NA,0,0,0,0,0,0,1,1,0
1990,Ralph Lewis,SF,26,CHH,3,0,20,4,6,0.667,0,0,NA,4,6,0.667,0.667,2,2,1,4,2,6,0,1,0,1,2,10
1990,Todd Lichti,SG,23,DEN,79,4,1326,250,514,0.486,0,14,0,250,500,0.5,0.486,130,174,0.747,49,102,151,116,55,13,95,145,630
1990,Alton Lister,C,31,GSW,3,0,40,4,8,0.5,0,1,0,4,7,0.571,0.5,4,7,0.571,5,3,8,2,1,0,0,8,12
1990,Lewis Lloyd,SG,30,PHI,2,0,10,1,2,0.5,0,0,NA,1,2,0.5,0.5,0,0,NA,0,0,0,0,0,0,4,3,2
1990,Lewis Lloyd,SG,30,HOU,19,0,113,29,51,0.569,0,0,NA,29,51,0.569,0.569,9,16,0.563,8,10,18,11,3,0,16,9,67
1990,Brad Lohaus,PF,25,MIN,28,24,590,94,202,0.465,1,16,0.063,93,186,0.5,0.468,21,26,0.808,21,89,110,62,14,22,45,66,210
1990,Brad Lohaus,PF,25,MIL,52,17,1353,211,461,0.458,46,121,0.38,165,340,0.485,0.508,54,77,0.701,77,211,288,106,44,66,64,145,522
1990,Grant Long,PF,23,MIA,81,31,1856,257,532,0.483,0,3,0,257,529,0.486,0.483,172,241,0.714,156,246,402,96,91,38,139,300,686
1990,Jeff Malone,SG,28,WSB,75,74,2567,781,1592,0.491,1,6,0.167,780,1586,0.492,0.491,257,293,0.877,54,152,206,243,48,6,125,116,1820
1990,Danny Manning,PF,23,LAC,71,42,2269,440,826,0.533,0,5,0,440,821,0.536,0.533,274,370,0.741,142,280,422,187,91,39,188,261,1154
1990,Vernon Maxwell,SG,24,SAS,49,2,1118,133,306,0.435,15,52,0.288,118,254,0.465,0.459,59,95,0.621,35,106,141,146,42,5,71,79,340
1990,Vernon Maxwell,SG,24,HOU,30,10,869,142,321,0.442,13,53,0.245,129,268,0.481,0.463,77,116,0.664,15,72,87,150,42,5,72,69,374
1990,George McCloud,SF,22,IND,44,0,413,45,144,0.313,13,40,0.325,32,104,0.308,0.358,15,19,0.789,12,30,42,45,19,3,36,56,118
1990,Xavier McDaniel,SF,26,SEA,69,67,2432,611,1233,0.496,5,17,0.294,606,1216,0.498,0.498,244,333,0.733,165,282,447,171,73,36,187,231,1471
1990,John Morton,SG,22,CLE,37,3,402,48,161,0.298,7,30,0.233,41,131,0.313,0.32,43,62,0.694,7,25,32,67,18,4,51,30,146
1990,Tod Murphy,C,26,MIN,82,59,2493,260,552,0.471,16,43,0.372,244,509,0.479,0.486,144,203,0.709,207,357,564,106,76,60,61,229,680
1990,Pete Myers,SG,26,NYK,24,0,208,15,45,0.333,0,1,0,15,44,0.341,0.333,16,31,0.516,10,18,28,35,15,2,18,39,46
1990,Pete Myers,SG,26,NJN,28,2,543,74,180,0.411,0,6,0,74,174,0.425,0.411,50,69,0.725,23,45,68,100,20,9,58,70,198
1990,Ed Nealy,PF,29,CHI,46,0,503,37,70,0.529,0,2,0,37,68,0.544,0.529,30,41,0.732,46,92,138,28,16,4,17,67,104
1990,Johnny Newman,SF,26,NYK,80,69,2277,374,786,0.476,45,142,0.317,329,644,0.511,0.504,239,299,0.799,60,131,191,180,95,22,143,254,1032
1990,Jawann Oldham,C,32,ORL,3,0,36,1,3,0.333,0,0,NA,1,3,0.333,0.333,2,5,0.4,4,11,15,0,2,3,3,6,4
1990,Jawann Oldham,C,32,LAL,3,0,9,2,3,0.667,0,0,NA,2,3,0.667,0.667,1,2,0.5,0,1,1,1,0,0,1,3,5
1990,Sam Perkins,SF,28,DAL,76,70,2668,435,883,0.493,6,28,0.214,429,855,0.502,0.496,330,424,0.778,209,363,572,175,88,64,148,225,1206
1990,Tim Perry,C,24,PHO,60,18,612,100,195,0.513,1,1,1,99,194,0.51,0.515,53,90,0.589,79,73,152,17,21,22,47,76,254
1990,Dražen Petrović,SG,25,POR,77,0,967,207,427,0.485,34,74,0.459,173,353,0.49,0.525,135,160,0.844,50,61,111,116,23,2,96,134,583
1990,Ricky Pierce,SG,30,MIL,59,0,1709,503,987,0.51,46,133,0.346,457,854,0.535,0.533,307,366,0.839,64,103,167,133,50,7,129,158,1359
1990,Ed Pinckney,PF,26,BOS,77,50,1082,135,249,0.542,0,1,0,135,248,0.544,0.542,92,119,0.773,93,132,225,68,34,42,56,126,362
1990,Olden Polynice,C,25,SEA,79,7,1085,156,289,0.54,1,2,0.5,155,287,0.54,0.542,47,99,0.475,128,172,300,15,25,21,35,187,360
1990,Brian Quinnett,SG,23,NYK,31,0,193,19,58,0.328,0,2,0,19,56,0.339,0.328,2,3,0.667,9,19,28,11,3,4,4,27,40
1990,Kurt Rambis,PF,31,CHH,16,16,448,58,116,0.5,0,1,0,58,115,0.504,0.5,30,55,0.545,48,72,120,28,32,10,29,45,146
1990,Kurt Rambis,PF,31,PHO,58,45,1456,132,257,0.514,0,2,0,132,255,0.518,0.514,52,72,0.722,108,297,405,107,68,27,75,163,316
1990,J.R. Reid,C,21,CHH,82,82,2757,358,814,0.44,0,5,0,358,809,0.443,0.44,192,289,0.664,199,492,691,101,92,54,172,292,908
1990,Robert Reid,SF,34,POR,12,1,85,13,33,0.394,1,3,0.333,12,30,0.4,0.409,4,8,0.5,1,7,8,8,2,2,1,17,31
1990,Robert Reid,SF,34,CHH,60,27,1117,162,414,0.391,9,29,0.31,153,385,0.397,0.402,50,78,0.641,33,110,143,82,36,14,44,136,383
1990,Doc Rivers,PG,28,ATL,48,44,1526,218,480,0.454,24,66,0.364,194,414,0.469,0.479,138,170,0.812,47,153,200,264,116,22,98,151,598
1990,Alvin Robertson,SG,27,MIL,81,81,2599,476,946,0.503,4,26,0.154,472,920,0.513,0.505,197,266,0.741,230,329,559,445,207,17,217,280,1153
1990,Clifford Robinson,PF,23,POR,82,0,1565,298,751,0.397,12,44,0.273,286,707,0.405,0.405,138,251,0.55,110,198,308,72,53,53,129,226,746
1990,Donald Royal,SF,23,MIN,66,0,746,117,255,0.459,0,1,0,117,254,0.461,0.459,153,197,0.777,69,68,137,43,32,8,81,107,387
1990,John Salley,PF,25,DET,82,12,1914,209,408,0.512,1,4,0.25,208,404,0.515,0.513,174,244,0.713,154,285,439,67,51,153,97,282,593
1990,Mike Sanders,SF,29,IND,82,13,1531,225,479,0.47,5,14,0.357,220,465,0.473,0.475,55,75,0.733,78,152,230,89,43,23,79,220,510
1990,Danny Schayes,C,30,DEN,53,22,1194,163,330,0.494,0,4,0,163,326,0.5,0.494,225,264,0.852,117,225,342,61,41,45,72,200,551
1990,Rony Seikaly,C,24,MIA,74,72,2409,486,968,0.502,0,1,0,486,967,0.503,0.502,256,431,0.594,253,513,766,78,78,124,236,258,1228
1990,Brad Sellers,PF,27,SEA,45,0,587,84,198,0.424,0,3,0,84,195,0.431,0.424,49,61,0.803,31,39,70,32,11,19,34,63,217
1990,Brad Sellers,PF,27,MIN,14,0,113,19,56,0.339,0,2,0,19,54,0.352,0.339,9,12,0.75,8,11,19,1,6,3,12,11,47
1990,Jerry Sichting,PG,33,CHH,34,8,469,50,119,0.42,3,12,0.25,47,107,0.439,0.433,15,18,0.833,3,16,19,92,16,2,22,39,118
1990,Jerry Sichting,PG,33,MIL,1,0,27,0,6,0,0,0,NA,0,6,0,0,3,4,0.75,0,0,0,2,0,0,0,1,3
1990,Charles Smith,PF,24,LAC,78,76,2732,595,1145,0.52,1,12,0.083,594,1133,0.524,0.52,454,572,0.794,177,347,524,114,86,119,162,294,1645
1990,Charles Smith,PG,22,BOS,60,0,519,59,133,0.444,0,7,0,59,126,0.468,0.444,53,76,0.697,14,55,69,103,35,3,36,75,171
1990,Kenny Smith,PG,24,SAC,46,46,1747,280,607,0.461,22,59,0.373,258,548,0.471,0.479,106,131,0.809,11,109,120,303,57,7,122,98,688
1990,Kenny Smith,PG,24,ATL,33,5,674,98,204,0.48,4,24,0.167,94,180,0.522,0.49,55,65,0.846,7,30,37,142,22,1,47,45,255
1990,Michael Smith,PF,24,BOS,65,7,620,136,286,0.476,2,28,0.071,134,258,0.519,0.479,53,64,0.828,40,60,100,79,9,1,54,51,327
1990,Mike Smrek,C,27,GSW,13,3,107,10,24,0.417,0,0,NA,10,24,0.417,0.417,1,6,0.167,11,23,34,1,4,11,9,18,21
1990,Rory Sparrow,PG,31,MIA,82,25,1756,210,510,0.412,8,40,0.2,202,470,0.43,0.42,59,77,0.766,37,101,138,298,49,4,99,140,487
1990,Rod Strickland,PG,23,NYK,51,0,1019,170,386,0.44,6,21,0.286,164,365,0.449,0.448,83,130,0.638,43,83,126,219,70,8,85,71,429
1990,Rod Strickland,PG,23,SAS,31,24,1121,173,370,0.468,2,9,0.222,171,361,0.474,0.47,91,148,0.615,47,86,133,249,57,6,85,89,439
1990,LaSalle Thompson,C,28,IND,82,60,2126,223,471,0.473,1,5,0.2,222,466,0.476,0.475,107,134,0.799,175,455,630,106,65,71,150,313,554
1990,Otis Thorpe,PF,27,HOU,82,82,2947,547,998,0.548,0,10,0,547,988,0.554,0.548,307,446,0.688,258,476,734,261,66,24,229,270,1401
1990,Sedric Toney,PG,27,ATL,32,0,286,30,72,0.417,7,13,0.538,23,59,0.39,0.465,21,25,0.84,3,11,14,52,10,0,21,35,88
1990,Sedric Toney,PG,27,SAC,32,9,682,57,178,0.32,16,50,0.32,41,128,0.32,0.365,46,58,0.793,11,35,46,122,23,0,52,71,176
1990,Andre Turner,PG,25,LAC,3,0,31,2,13,0.154,0,1,0,2,12,0.167,0.154,0,0,NA,3,2,5,3,1,0,4,1,4
1990,Andre Turner,PG,25,CHH,8,0,84,9,25,0.36,0,1,0,9,24,0.375,0.36,4,4,1,1,2,3,20,7,0,8,5,22
1990,Kelvin Upshaw,SG,27,BOS,14,0,131,12,39,0.308,2,5,0.4,10,34,0.294,0.333,4,6,0.667,3,10,13,28,2,1,12,19,30
1990,Kelvin Upshaw,SG,27,DAL,3,0,4,1,3,0.333,0,1,0,1,2,0.5,0.333,0,0,NA,0,0,0,0,0,0,0,0,2
1990,Kelvin Upshaw,SG,27,GSW,23,0,252,51,104,0.49,2,9,0.222,49,95,0.516,0.5,24,31,0.774,6,22,28,26,25,0,15,34,128
1990,Jay Vincent,SF,30,PHI,17,5,259,45,105,0.429,1,1,1,44,104,0.423,0.433,33,37,0.892,13,23,36,8,10,2,14,23,124
1990,Jay Vincent,SF,30,LAL,24,1,200,41,78,0.526,0,1,0,41,77,0.532,0.526,8,12,0.667,7,19,26,10,8,3,19,29,90
1990,Darrell Walker,PG,28,WSB,81,81,2883,316,696,0.454,2,21,0.095,314,675,0.465,0.455,138,201,0.687,173,541,714,652,139,30,173,220,772
1990,Spud Webb,PG,26,ATL,82,46,2184,294,616,0.477,1,19,0.053,293,597,0.491,0.478,162,186,0.871,38,163,201,477,105,12,141,185,751
1990,Chris Welp,C,26,SAS,13,1,56,7,23,0.304,0,0,NA,7,23,0.304,0.304,1,2,0.5,7,5,12,5,1,0,6,21,15
1990,Chris Welp,C,26,GSW,14,2,142,16,38,0.421,0,0,NA,16,38,0.421,0.421,18,23,0.783,11,25,36,4,5,8,9,37,50
1990,Morlon Wiley,PG,23,ORL,40,2,638,92,208,0.442,17,46,0.37,75,162,0.463,0.483,28,38,0.737,13,39,52,114,45,3,63,65,229
1990,Dominique Wilkins,SF,30,ATL,80,79,2888,810,1672,0.484,59,183,0.322,751,1489,0.504,0.502,459,569,0.807,217,304,521,200,126,47,174,141,2138
1990,Herb Williams,C,31,DAL,81,19,2199,295,665,0.444,2,9,0.222,293,656,0.447,0.445,108,159,0.679,76,315,391,119,51,106,106,243,700
1990,Micheal Williams,PG,23,PHO,6,0,26,2,10,0.2,0,0,NA,2,10,0.2,0.2,1,2,0.5,1,0,1,4,0,0,5,0,5
1990,Micheal Williams,PG,23,CHH,22,1,303,58,109,0.532,0,3,0,58,106,0.547,0.532,35,44,0.795,11,20,31,77,22,1,28,39,151
1990,Mike Williams,PF,26,SAC,16,0,88,6,14,0.429,0,1,0,6,13,0.462,0.429,3,6,0.5,5,17,22,2,3,7,3,28,15
1990,Mike Williams,SF,26,ATL,5,0,14,0,4,0,0,0,NA,0,4,0,0,0,0,NA,0,1,1,0,0,0,0,2,0
1990,Reggie Williams,SF,25,LAC,5,5,133,21,57,0.368,0,5,0,21,52,0.404,0.368,18,21,0.857,8,7,15,10,9,1,9,7,60
1990,Reggie Williams,SF,25,CLE,32,12,542,91,239,0.381,6,27,0.222,85,212,0.401,0.393,30,41,0.732,17,43,60,38,22,10,32,79,218
1990,Reggie Williams,SF,25,SAS,10,0,68,19,42,0.452,0,5,0,19,37,0.514,0.452,4,6,0.667,3,5,8,5,1,3,4,16,42
1990,Kevin Willis,PF,27,ATL,81,51,2273,418,805,0.519,2,7,0.286,416,798,0.521,0.52,168,246,0.683,253,392,645,57,63,47,144,259,1006
1990,Joe Wolf,C,25,LAC,77,19,1325,155,392,0.395,5,25,0.2,150,367,0.409,0.402,55,71,0.775,63,169,232,62,30,24,77,129,370
1990,Mike Woodson,SG,31,HOU,61,11,972,160,405,0.395,12,41,0.293,148,364,0.407,0.41,62,86,0.721,25,63,88,66,42,11,49,100,394
1990,Orlando Woolridge,SF,30,LAL,62,2,1421,306,550,0.556,0,5,0,306,545,0.561,0.556,176,240,0.733,49,136,185,96,39,46,73,160,788
1990,Haywoode Workman,PG,24,ATL,6,0,16,2,3,0.667,0,0,NA,2,3,0.667,0.667,2,2,1,0,3,3,2,3,0,0,3,6
1990,Danny Young,PG,27,POR,82,8,1393,138,328,0.421,16,59,0.271,122,269,0.454,0.445,91,112,0.813,29,93,122,231,82,4,80,84,383
1991,Alaa Abdelnaby,PF,22,POR,43,0,290,55,116,0.474,0,0,NA,55,116,0.474,0.474,25,44,0.568,27,62,89,12,4,12,22,39,135
1991,Mark Acres,C,28,ORL,68,0,1313,109,214,0.509,1,3,0.333,108,211,0.512,0.512,66,101,0.653,140,219,359,25,25,25,42,218,285
1991,Greg Anderson,PF,26,MIL,26,0,247,27,73,0.37,0,1,0,27,72,0.375,0.37,16,28,0.571,26,49,75,3,8,9,22,29,70
1991,Greg Anderson,PF,26,NJN,1,0,18,4,4,1,0,0,NA,4,4,1,1,0,0,NA,4,2,6,1,2,0,1,4,8
1991,Greg Anderson,PF,26,DEN,41,2,659,85,193,0.44,0,0,NA,85,193,0.44,0.44,44,87,0.506,67,170,237,12,25,36,61,107,214
1991,Ron Anderson,SF,32,PHI,82,13,2340,512,1055,0.485,9,43,0.209,503,1012,0.497,0.49,165,198,0.833,103,264,367,115,65,13,100,163,1198
1991,Willie Anderson,SG,24,SAS,75,75,2592,453,991,0.457,7,35,0.2,446,956,0.467,0.461,170,213,0.798,68,283,351,358,79,46,167,226,1083
1991,Michael Ansley,SF,23,ORL,67,1,877,144,263,0.548,0,0,NA,144,263,0.548,0.548,91,127,0.717,122,131,253,25,27,7,32,125,379
1991,B.J. Armstrong,PG,23,CHI,82,0,1731,304,632,0.481,15,30,0.5,289,602,0.48,0.493,97,111,0.874,25,124,149,301,70,4,107,118,720
1991,Vincent Askew,SG,24,GSW,7,0,85,12,25,0.48,0,0,NA,12,25,0.48,0.48,9,11,0.818,7,4,11,13,2,0,6,21,33
1991,Thurl Bailey,PF,29,UTA,82,22,2486,399,872,0.458,0,3,0,399,869,0.459,0.458,219,271,0.808,101,306,407,124,53,91,130,160,1017
1991,Kenny Battle,SG,26,PHO,16,4,263,38,86,0.442,0,2,0,38,84,0.452,0.442,20,29,0.69,21,32,53,15,19,6,17,25,96
1991,Kenny Battle,SG,26,DEN,40,4,682,95,196,0.485,3,22,0.136,92,174,0.529,0.492,50,64,0.781,62,61,123,47,41,12,36,83,243
1991,Benoit Benjamin,C,26,LAC,39,38,1337,229,465,0.492,0,0,NA,229,465,0.492,0.492,123,169,0.728,95,374,469,74,26,91,138,110,581
1991,Benoit Benjamin,C,26,SEA,31,27,899,157,313,0.502,0,0,NA,157,313,0.502,0.502,87,126,0.69,62,192,254,45,28,54,97,74,401
1991,Winston Bennett,SF,25,CLE,27,13,334,40,107,0.374,0,0,NA,40,107,0.374,0.374,35,47,0.745,30,34,64,28,8,2,20,50,115
1991,Muggsy Bogues,PG,26,CHH,81,46,2299,241,524,0.46,0,12,0,241,512,0.471,0.46,86,108,0.796,58,158,216,669,137,3,120,160,568
1991,Manute Bol,C,28,PHI,82,6,1522,65,164,0.396,1,14,0.071,64,150,0.427,0.399,24,41,0.585,66,284,350,20,16,247,63,184,155
1991,Randy Breuer,C,30,MIN,73,44,1505,197,435,0.453,0,0,NA,197,435,0.453,0.453,35,79,0.443,114,231,345,73,35,80,69,132,429
1991,Frank Brickowski,PF,31,MIL,75,73,1912,372,706,0.527,0,2,0,372,704,0.528,0.527,198,248,0.798,129,297,426,131,86,43,160,255,942
1991,Scott Brooks,PG,25,MIN,80,0,980,159,370,0.43,45,135,0.333,114,235,0.485,0.491,61,72,0.847,28,44,72,204,53,5,51,122,424
1991,Chucky Brown,SF,22,CLE,74,51,1485,263,502,0.524,0,4,0,263,498,0.528,0.524,101,144,0.701,78,135,213,80,26,24,94,130,627
1991,Dee Brown,PG,22,BOS,82,5,1945,284,612,0.464,7,34,0.206,277,578,0.479,0.47,137,157,0.873,41,141,182,344,83,14,137,161,712
1991,Tony Brown,SF,30,LAL,7,0,27,2,3,0.667,1,1,1,1,2,0.5,0.833,0,0,NA,0,4,4,3,0,0,4,8,5
1991,Tony Brown,SG,30,UTA,23,0,267,28,77,0.364,2,11,0.182,26,66,0.394,0.377,20,23,0.87,24,15,39,13,4,0,12,39,78
1991,Mark Bryant,PF,25,POR,53,0,781,99,203,0.488,0,1,0,99,202,0.49,0.488,74,101,0.733,65,125,190,27,15,12,33,120,272
1991,Jud Buechler,SF,22,NJN,74,10,859,94,226,0.416,1,4,0.25,93,222,0.419,0.418,43,66,0.652,61,80,141,51,33,15,26,79,232
1991,Adrian Caldwell,PF,24,HOU,42,0,343,35,83,0.422,0,1,0,35,82,0.427,0.422,7,17,0.412,43,57,100,8,19,10,30,35,77
1991,Elden Campbell,PF,22,LAL,52,0,380,56,123,0.455,0,0,NA,56,123,0.455,0.455,32,49,0.653,40,56,96,10,11,38,16,71,144
1991,Tony Campbell,SG,28,MIN,77,71,2893,652,1502,0.434,16,61,0.262,636,1441,0.441,0.439,358,446,0.803,161,185,346,214,121,48,190,204,1678
1991,Antoine Carr,PF,29,SAC,77,48,2527,628,1228,0.511,0,3,0,628,1225,0.513,0.511,295,389,0.758,163,257,420,191,45,101,171,315,1551
1991,Joe Barry Carroll,C,32,PHO,11,0,96,13,36,0.361,0,0,NA,13,36,0.361,0.361,11,12,0.917,3,21,24,11,1,8,12,18,37
1991,Cedric Ceballos,SF,21,PHO,63,0,730,204,419,0.487,1,6,0.167,203,413,0.492,0.488,110,166,0.663,77,73,150,35,22,5,69,70,519
1991,Rex Chapman,PG,23,CHH,70,68,2100,410,922,0.445,48,148,0.324,362,774,0.468,0.471,234,282,0.83,45,146,191,250,73,16,131,167,1102
1991,Maurice Cheeks,PG,34,NYK,76,64,2147,241,483,0.499,5,20,0.25,236,463,0.51,0.504,105,129,0.814,22,151,173,435,128,10,108,138,592
1991,Derrick Chievous,SF,23,CLE,18,0,110,17,46,0.37,0,0,NA,17,46,0.37,0.37,9,16,0.563,11,7,18,2,3,1,6,16,43
1991,Bimbo Coles,PG,22,MIA,82,9,1355,162,393,0.412,6,34,0.176,156,359,0.435,0.42,71,95,0.747,56,97,153,232,65,12,98,149,401
1991,Lester Conner,PG,31,NJN,35,2,489,58,111,0.523,0,2,0,58,109,0.532,0.523,29,42,0.69,11,46,57,58,37,1,27,38,145
1991,Lester Conner,PG,31,MIL,39,2,519,38,96,0.396,0,3,0,38,93,0.409,0.396,39,52,0.75,10,45,55,107,48,1,31,37,115
1991,Anthony Cook,PF,23,DEN,58,25,1121,118,283,0.417,0,3,0,118,280,0.421,0.417,71,129,0.55,134,192,326,26,35,72,50,100,307
1991,Tyrone Corbin,SF,28,MIN,82,82,3196,587,1311,0.448,2,10,0.2,585,1301,0.45,0.449,296,371,0.798,185,404,589,347,162,53,209,257,1472
1991,Terry Cummings,PF,29,SAS,67,62,2195,503,1039,0.484,7,33,0.212,496,1006,0.493,0.487,164,240,0.683,194,327,521,157,61,30,131,225,1177
1991,Walter Davis,SG,36,DEN,39,13,1044,316,667,0.474,10,33,0.303,306,634,0.483,0.481,86,94,0.915,52,71,123,84,62,3,63,108,728
1991,Walter Davis,SG,36,POR,32,1,439,87,195,0.446,1,3,0.333,86,192,0.448,0.449,21,23,0.913,19,39,58,41,18,0,25,42,196
1991,Byron Dinkins,PG,23,SAS,10,0,144,13,33,0.394,0,0,NA,13,33,0.394,0.394,8,9,0.889,0,11,11,19,2,0,13,12,34
1991,Byron Dinkins,PG,23,IND,2,0,5,1,1,1,0,0,NA,1,1,1,1,0,0,NA,0,1,1,0,0,0,0,3,2
1991,James Donaldson,C,33,DAL,82,82,2800,327,615,0.532,0,0,NA,327,615,0.532,0.532,165,229,0.721,201,526,727,69,34,93,146,181,819
1991,Sherman Douglas,PG,24,MIA,73,73,2562,532,1055,0.504,4,31,0.129,528,1024,0.516,0.506,284,414,0.686,78,131,209,624,121,5,270,178,1352
1991,Clyde Drexler,SG,28,POR,82,82,2852,645,1338,0.482,61,191,0.319,584,1147,0.509,0.505,416,524,0.794,212,334,546,493,144,60,232,226,1767
1991,Chris Dudley,C,25,NJN,61,25,1560,170,417,0.408,0,0,NA,170,417,0.408,0.408,94,176,0.534,229,282,511,37,39,153,80,217,434
1991,Blue Edwards,SF,25,UTA,62,56,1611,244,464,0.526,6,24,0.25,238,440,0.541,0.532,82,117,0.701,51,150,201,108,57,29,105,203,576
1991,Kevin Edwards,SG,25,MIA,79,16,2000,380,927,0.41,24,84,0.286,356,843,0.422,0.423,171,213,0.803,80,125,205,240,129,46,163,151,955
1991,Mario Elie,SG,27,PHI,3,0,20,2,7,0.286,1,2,0.5,1,5,0.2,0.357,1,2,0.5,0,1,1,1,0,0,3,2,6
1991,Mario Elie,SF,27,GSW,30,0,624,77,152,0.507,3,8,0.375,74,144,0.514,0.516,74,87,0.851,46,63,109,44,19,10,27,83,231
1991,Dale Ellis,SG,30,SEA,30,24,800,181,391,0.463,27,89,0.303,154,302,0.51,0.497,62,84,0.738,28,64,92,64,33,3,49,59,451
1991,Dale Ellis,SG,30,MIL,21,0,624,159,327,0.486,30,68,0.441,129,259,0.498,0.532,58,82,0.707,38,43,81,31,16,5,32,53,406
1991,Jim Farmer,SG,26,PHI,2,0,13,2,7,0.286,0,1,0,2,6,0.333,0.286,2,2,1,2,3,5,0,0,0,1,0,6
1991,Jim Farmer,SG,26,DEN,25,1,443,99,216,0.458,5,22,0.227,94,194,0.485,0.47,46,63,0.73,27,36,63,38,13,2,37,58,249
1991,Greg Foster,PF,22,WSB,54,3,606,97,211,0.46,0,5,0,97,206,0.471,0.46,42,61,0.689,52,99,151,37,12,22,45,112,236
1991,Kevin Gamble,SF,25,BOS,82,76,2706,548,933,0.587,0,7,0,548,926,0.592,0.587,185,227,0.815,85,182,267,256,100,34,148,237,1281
1991,Winston Garland,PG,26,LAC,69,26,1702,221,519,0.426,4,26,0.154,217,493,0.44,0.43,118,157,0.752,46,152,198,317,97,10,116,189,564
1991,Tom Garrick,SG,24,LAC,67,0,949,100,236,0.424,0,22,0,100,214,0.467,0.424,60,79,0.759,40,87,127,223,62,2,66,101,260
1991,Kendall Gill,SG,22,CHH,82,36,1944,376,836,0.45,2,14,0.143,374,822,0.455,0.451,152,182,0.835,105,158,263,303,104,39,163,186,906
1991,Armen Gilliam,PF,26,CHH,25,25,949,195,380,0.513,0,0,NA,195,380,0.513,0.513,104,128,0.813,86,148,234,27,34,21,64,65,494
1991,Armen Gilliam,PF,26,PHI,50,50,1695,292,621,0.47,0,2,0,292,619,0.472,0.47,164,201,0.816,134,230,364,78,35,32,110,120,748
1991,Gerald Glass,SF,23,MIN,51,3,606,149,340,0.438,2,17,0.118,147,323,0.455,0.441,52,76,0.684,54,48,102,42,28,9,41,76,352
1991,Mike Gminski,C,31,PHI,30,29,791,109,284,0.384,1,8,0.125,108,276,0.391,0.386,53,63,0.841,71,130,201,33,16,34,31,41,272
1991,Mike Gminski,C,31,CHH,50,50,1405,248,524,0.473,1,6,0.167,247,518,0.477,0.474,75,95,0.789,115,266,381,60,24,22,54,58,572
1991,Greg Grant,PG,24,NYK,22,0,107,10,27,0.37,1,3,0.333,9,24,0.375,0.389,5,6,0.833,1,9,10,20,9,0,10,12,26
1991,Stuart Gray,C,27,NYK,8,0,37,4,12,0.333,0,0,NA,4,12,0.333,0.333,3,3,1,2,8,10,0,0,1,2,6,11
1991,Jeff Grayer,SG,25,MIL,82,7,1422,210,485,0.433,0,3,0,210,482,0.436,0.433,101,147,0.687,111,135,246,123,48,9,86,98,521
1991,A.C. Green,PF,27,LAL,82,21,2164,258,542,0.476,11,55,0.2,247,487,0.507,0.486,223,302,0.738,201,315,516,71,59,23,99,117,750
1991,Sidney Green,PF,30,SAS,66,7,1099,177,384,0.461,0,3,0,177,381,0.465,0.461,89,105,0.848,98,215,313,52,32,13,89,172,443
1991,Jack Haley,PF,27,NJN,78,18,1178,161,343,0.469,0,0,NA,161,343,0.469,0.469,112,181,0.619,140,216,356,31,20,21,63,199,434
1991,Tom Hammonds,PF,23,WSB,70,7,1023,155,336,0.461,0,4,0,155,332,0.467,0.461,57,79,0.722,58,148,206,43,15,7,54,108,367
1991,Bob Hansen,SG,30,SAC,36,24,811,96,256,0.375,19,69,0.275,77,187,0.412,0.412,18,36,0.5,33,63,96,90,20,5,34,72,229
1991,Tim Hardaway,PG,24,GSW,82,82,3215,739,1551,0.476,97,252,0.385,642,1299,0.494,0.508,306,381,0.803,87,245,332,793,214,12,270,228,1881
1991,Derek Harper,PG,29,DAL,77,77,2879,572,1226,0.467,89,246,0.362,483,980,0.493,0.503,286,391,0.731,59,174,233,548,147,14,177,222,1519
1991,Ron Harper,SG,27,LAC,39,34,1383,285,729,0.391,48,148,0.324,237,581,0.408,0.424,145,217,0.668,58,130,188,209,66,35,129,111,763
1991,Gerald Henderson,PG,35,DET,23,10,392,50,117,0.427,7,21,0.333,43,96,0.448,0.457,16,21,0.762,8,29,37,62,12,2,28,43,123
1991,Mike Higgins,SF,23,SAC,7,0,61,6,10,0.6,0,0,NA,6,10,0.6,0.6,4,7,0.571,4,1,5,2,0,2,4,16,16
1991,Sean Higgins,SF,22,SAS,50,0,464,97,212,0.458,3,19,0.158,94,193,0.487,0.465,28,33,0.848,18,45,63,35,8,1,49,53,225
1991,Tyrone Hill,PF,22,GSW,74,22,1192,147,299,0.492,0,0,NA,147,299,0.492,0.492,96,152,0.632,157,226,383,19,33,30,72,264,390
1991,Dave Hoppen,C,26,CHH,19,0,112,18,32,0.563,0,1,0,18,31,0.581,0.563,8,10,0.8,14,16,30,3,2,1,12,18,44
1991,Dave Hoppen,C,26,PHI,11,0,43,6,12,0.5,0,1,0,6,11,0.545,0.5,8,12,0.667,4,5,9,0,1,0,1,11,20
1991,Dennis Hopson,SF,25,CHI,61,0,728,104,244,0.426,1,5,0.2,103,239,0.431,0.428,55,83,0.663,49,60,109,65,25,14,59,79,264
1991,Jeff Hornacek,SG,27,PHO,80,77,2733,544,1051,0.518,61,146,0.418,483,905,0.534,0.547,201,224,0.897,74,247,321,409,111,16,130,185,1350
1991,Jay Humphries,PG,28,MIL,80,80,2726,482,960,0.502,60,161,0.373,422,799,0.528,0.533,191,239,0.799,57,163,220,538,129,7,151,237,1215
1991,Mark Jackson,PG,25,NYK,72,21,1595,250,508,0.492,13,51,0.255,237,457,0.519,0.505,117,160,0.731,62,135,197,452,60,9,135,81,630
1991,Dave Jamerson,SG,23,HOU,37,0,202,43,113,0.381,5,19,0.263,38,94,0.404,0.403,22,27,0.815,9,21,30,27,6,1,20,24,113
1991,Henry James,PF,25,CLE,37,4,505,112,254,0.441,24,60,0.4,88,194,0.454,0.488,52,72,0.722,26,53,79,32,15,5,37,59,300
1991,Avery Johnson,PG,25,DEN,21,4,217,29,68,0.426,0,4,0,29,64,0.453,0.426,21,32,0.656,9,12,21,77,14,2,27,22,79
1991,Avery Johnson,PG,25,SAS,47,10,742,101,209,0.483,1,5,0.2,100,204,0.49,0.486,38,55,0.691,13,43,56,153,33,2,47,40,241
1991,Eddie Johnson,SG,31,PHO,15,0,312,88,186,0.473,6,21,0.286,82,165,0.497,0.489,21,29,0.724,16,30,46,17,9,2,24,37,203
1991,Eddie Johnson,SG,31,SEA,66,27,1773,455,936,0.486,33,99,0.333,422,837,0.504,0.504,208,228,0.912,91,134,225,94,49,7,98,144,1151
1991,Steve Johnson,C,33,GSW,24,8,228,34,63,0.54,0,0,NA,34,63,0.54,0.54,22,37,0.595,18,39,57,17,4,4,25,50,90
1991,Steve Kerr,PG,25,CLE,57,4,905,99,223,0.444,28,62,0.452,71,161,0.441,0.507,45,53,0.849,5,32,37,131,29,4,40,52,271
1991,Randolph Keys,SF,24,CHH,44,0,473,59,145,0.407,3,14,0.214,56,131,0.427,0.417,19,33,0.576,40,60,100,18,22,15,35,93,140
1991,Stacey King,PF,24,CHI,76,6,1198,156,334,0.467,0,2,0,156,332,0.47,0.467,107,152,0.704,72,136,208,65,24,42,91,134,419
1991,Greg Kite,C,29,ORL,82,82,2225,166,338,0.491,0,0,NA,166,338,0.491,0.491,63,123,0.512,189,399,588,59,25,81,102,298,395
1991,Joe Kleine,C,29,BOS,72,1,850,102,218,0.468,0,2,0,102,216,0.472,0.468,54,69,0.783,71,173,244,21,15,14,53,108,258
1991,Negele Knight,PG,23,PHO,64,6,792,131,308,0.425,6,25,0.24,125,283,0.442,0.435,71,118,0.602,20,51,71,191,20,7,76,83,339
1991,Jerome Lane,PF,24,DEN,62,25,1383,202,461,0.438,1,4,0.25,201,457,0.44,0.439,58,141,0.411,280,298,578,123,51,14,105,192,463
1991,Andrew Lang,C,24,PHO,63,18,1152,109,189,0.577,0,1,0,109,188,0.58,0.577,93,130,0.715,113,190,303,27,17,127,45,168,311
1991,Eric Leckner,C,24,SAC,32,0,378,39,96,0.406,0,0,NA,39,96,0.406,0.406,16,27,0.593,27,60,87,18,4,11,25,69,94
1991,Eric Leckner,C,24,CHH,40,2,744,92,198,0.465,0,0,NA,92,198,0.465,0.465,46,84,0.548,55,153,208,21,10,11,44,123,230
1991,Tim Legler,SG,24,DEN,10,0,148,25,72,0.347,3,12,0.25,22,60,0.367,0.368,5,6,0.833,8,10,18,12,2,0,4,20,58
1991,Jim Les,PG,27,SAC,55,8,1399,119,268,0.444,71,154,0.461,48,114,0.421,0.576,86,103,0.835,18,93,111,299,57,4,75,141,395
1991,Marcus Liberty,SF,22,DEN,76,18,1171,216,513,0.421,17,57,0.298,199,456,0.436,0.438,58,92,0.63,117,104,221,64,48,19,71,153,507
1991,Todd Lichti,SG,24,DEN,29,25,860,166,378,0.439,14,47,0.298,152,331,0.459,0.458,59,69,0.855,49,63,112,72,46,8,33,65,405
1991,Alton Lister,C,32,GSW,77,65,1552,188,393,0.478,0,1,0,188,392,0.48,0.478,115,202,0.569,121,362,483,93,20,90,106,282,491
1991,Brad Lohaus,PF,26,MIL,81,3,1219,179,415,0.431,33,119,0.277,146,296,0.493,0.471,37,54,0.685,59,158,217,75,50,74,60,170,428
1991,Grant Long,PF,24,MIA,80,66,2514,276,561,0.492,1,6,0.167,275,555,0.495,0.493,181,230,0.787,225,343,568,176,119,43,156,295,734
1991,Jeff Malone,SG,29,UTA,69,69,2466,525,1034,0.508,1,6,0.167,524,1028,0.51,0.508,231,252,0.917,36,170,206,143,50,6,108,128,1282
1991,Danny Manning,PF,24,LAC,73,47,2197,470,905,0.519,0,3,0,470,902,0.521,0.519,219,306,0.716,169,257,426,196,117,62,188,281,1159
1991,Tony Massenburg,PF,23,SAS,35,0,161,27,60,0.45,0,0,NA,27,60,0.45,0.45,28,45,0.622,23,35,58,4,4,9,13,26,82
1991,Vernon Maxwell,SG,25,HOU,82,79,2870,504,1247,0.404,172,510,0.337,332,737,0.45,0.473,217,296,0.733,41,197,238,303,127,15,171,179,1397
1991,George McCloud,SF,23,IND,74,0,1070,131,351,0.373,43,124,0.347,88,227,0.388,0.434,38,49,0.776,35,83,118,150,40,11,91,141,343
1991,Xavier McDaniel,SF,27,SEA,15,15,529,139,290,0.479,0,3,0,139,287,0.484,0.479,49,69,0.71,36,45,81,38,26,4,40,50,327
1991,Xavier McDaniel,SF,27,PHO,66,64,2105,451,896,0.503,0,5,0,451,891,0.506,0.503,144,198,0.727,137,339,476,149,50,42,144,214,1046
1991,Terry Mills,PF,23,DEN,17,0,279,56,120,0.467,0,2,0,56,118,0.475,0.467,16,22,0.727,31,57,88,16,16,9,18,44,128
1991,Terry Mills,PF,23,NJN,38,2,540,78,168,0.464,0,2,0,78,166,0.47,0.464,31,44,0.705,51,90,141,17,19,20,25,56,187
1991,John Morton,SF,23,CLE,66,2,1207,120,274,0.438,4,12,0.333,116,262,0.443,0.445,113,139,0.813,41,62,103,243,61,18,107,112,357
1991,Tod Murphy,PF,27,MIN,52,19,1063,90,227,0.396,1,17,0.059,89,210,0.424,0.399,70,105,0.667,92,163,255,60,25,20,32,101,251
1991,Pete Myers,SG,27,SAS,8,1,103,10,23,0.435,0,1,0,10,22,0.455,0.435,9,11,0.818,2,16,18,14,3,3,14,14,29
1991,Ed Nealy,PF,30,PHO,55,0,573,45,97,0.464,5,16,0.313,40,81,0.494,0.49,28,38,0.737,44,107,151,36,24,4,19,46,123
1991,Johnny Newman,SF,27,CHH,81,81,2477,478,1017,0.47,30,84,0.357,448,933,0.48,0.485,385,476,0.809,94,160,254,188,100,17,189,278,1371
1991,Dan O'Sullivan,C,22,UTA,21,0,85,7,16,0.438,0,0,NA,7,16,0.438,0.438,7,11,0.636,5,12,17,4,1,1,4,18,21
1991,Alan Ogg,C,23,MIA,31,1,261,24,55,0.436,0,2,0,24,53,0.453,0.436,6,10,0.6,15,34,49,2,6,27,8,53,54
1991,Jawann Oldham,C,33,IND,4,0,19,3,6,0.5,0,0,NA,3,6,0.5,0.5,0,0,NA,0,3,3,0,0,0,0,1,6
1991,Gerald Paddio,SF,25,CLE,70,22,1181,212,506,0.419,6,24,0.25,206,482,0.427,0.425,74,93,0.796,38,80,118,90,20,6,71,71,504
1991,Gary Payton,PG,22,SEA,82,82,2244,259,575,0.45,1,13,0.077,258,562,0.459,0.451,69,97,0.711,108,135,243,528,165,15,180,249,588
1991,Sam Perkins,PF,29,LAL,73,66,2504,368,744,0.495,18,64,0.281,350,680,0.515,0.507,229,279,0.821,167,371,538,108,64,78,103,247,983
1991,Tim Perry,C,25,PHO,46,2,587,75,144,0.521,0,5,0,75,139,0.54,0.521,43,70,0.614,53,73,126,27,23,43,32,60,193
1991,Dražen Petrović,SG,26,POR,18,0,133,32,71,0.451,1,6,0.167,31,65,0.477,0.458,15,22,0.682,10,8,18,20,6,0,12,21,80
1991,Dražen Petrović,SG,26,NJN,43,0,882,211,422,0.5,22,59,0.373,189,363,0.521,0.526,99,115,0.861,41,51,92,66,37,1,69,111,543
1991,Ricky Pierce,SG,31,MIL,46,0,1327,359,720,0.499,37,93,0.398,322,627,0.514,0.524,282,311,0.907,37,80,117,96,38,11,93,90,1037
1991,Ricky Pierce,SG,31,SEA,32,2,840,202,436,0.463,9,23,0.391,193,413,0.467,0.474,148,160,0.925,30,44,74,72,22,2,54,80,561
1991,Ed Pinckney,PF,27,BOS,70,16,1165,131,243,0.539,0,1,0,131,242,0.541,0.539,104,116,0.897,155,186,341,45,61,43,45,147,366
1991,Olden Polynice,C,26,SEA,48,0,960,165,303,0.545,0,0,NA,165,303,0.545,0.545,67,114,0.588,114,156,270,16,26,19,53,94,397
1991,Olden Polynice,C,26,LAC,31,30,1132,151,261,0.579,0,1,0,151,260,0.581,0.579,79,138,0.572,106,177,283,26,17,13,35,98,381
1991,Kevin Pritchard,PG,23,GSW,62,1,773,88,229,0.384,5,31,0.161,83,198,0.419,0.395,62,77,0.805,16,49,65,81,30,8,59,104,243
1991,Brian Quinnett,SG,24,NYK,68,5,1011,139,303,0.459,15,43,0.349,124,260,0.477,0.483,26,36,0.722,65,80,145,53,22,13,52,100,319
1991,Kurt Rambis,PF,32,PHO,62,17,900,83,167,0.497,0,2,0,83,165,0.503,0.497,60,85,0.706,77,189,266,64,25,11,45,107,226
1991,J.R. Reid,C,22,CHH,80,80,2467,360,773,0.466,0,2,0,360,771,0.467,0.466,182,259,0.703,154,348,502,89,87,47,153,286,902
1991,Robert Reid,SF,35,PHI,3,0,37,2,14,0.143,0,0,NA,2,14,0.143,0.143,0,0,NA,2,7,9,4,1,3,3,3,4
1991,Doc Rivers,PG,29,ATL,79,79,2586,444,1020,0.435,88,262,0.336,356,758,0.47,0.478,221,262,0.844,47,206,253,340,148,47,125,216,1197
1991,Alvin Robertson,SG,28,MIL,81,81,2598,438,904,0.485,23,63,0.365,415,841,0.493,0.497,199,263,0.757,191,268,459,444,246,16,212,273,1098
1991,Clifford Robinson,PF,24,POR,82,11,1940,373,806,0.463,6,19,0.316,367,787,0.466,0.467,205,314,0.653,123,226,349,151,78,76,133,263,957
1991,Larry Robinson,SG,23,GSW,24,0,170,24,59,0.407,0,0,NA,24,59,0.407,0.407,8,15,0.533,15,8,23,11,9,1,16,23,56
1991,Larry Robinson,SG,23,WSB,12,10,255,38,91,0.418,0,1,0,38,90,0.422,0.418,7,12,0.583,14,14,28,24,7,0,11,26,83
1991,Rumeal Robinson,PG,24,ATL,47,16,674,108,242,0.446,2,11,0.182,106,231,0.459,0.45,47,80,0.588,20,51,71,132,32,8,76,65,265
1991,John Salley,PF,26,DET,74,1,1649,179,377,0.475,0,1,0,179,376,0.476,0.475,186,256,0.727,137,190,327,70,52,112,91,240,544
1991,Mike Sanders,SF,30,IND,80,7,1357,206,494,0.417,4,20,0.2,202,474,0.426,0.421,47,57,0.825,73,112,185,106,37,26,65,198,463
1991,Danny Schayes,C,31,MIL,82,38,2228,298,597,0.499,0,5,0,298,592,0.503,0.499,274,328,0.835,174,361,535,98,55,61,106,264,870
1991,Steve Scheffler,C,23,CHH,39,0,227,20,39,0.513,0,0,NA,20,39,0.513,0.513,19,21,0.905,21,24,45,9,6,2,4,20,59
1991,Dennis Scott,SG,22,ORL,82,73,2336,503,1183,0.425,125,334,0.374,378,849,0.445,0.478,153,204,0.75,62,173,235,134,62,25,127,203,1284
1991,Rony Seikaly,C,25,MIA,64,59,2171,395,822,0.481,2,6,0.333,393,816,0.482,0.482,258,417,0.619,207,502,709,95,51,86,205,213,1050
1991,Brian Shaw,PG,24,BOS,79,79,2772,442,942,0.469,3,27,0.111,439,915,0.48,0.471,204,249,0.819,104,266,370,602,105,34,223,206,1091
1991,Charles Smith,SF,25,LAC,74,74,2703,548,1168,0.469,0,7,0,548,1161,0.472,0.469,384,484,0.793,216,392,608,134,81,145,165,267,1480
1991,Charles Smith,PG,23,BOS,5,0,30,3,7,0.429,0,0,NA,3,7,0.429,0.429,3,5,0.6,0,2,2,6,1,0,3,7,9
1991,Kenny Smith,PG,25,HOU,78,78,2699,522,1003,0.52,49,135,0.363,473,868,0.545,0.545,287,340,0.844,36,127,163,554,106,11,237,131,1380
1991,Michael Smith,PF,25,BOS,47,3,389,95,200,0.475,6,24,0.25,89,176,0.506,0.49,22,27,0.815,21,35,56,43,6,2,37,27,218
1991,Tony Smith,SG,22,LAL,64,1,695,97,220,0.441,0,7,0,97,213,0.455,0.441,40,57,0.702,24,47,71,135,28,12,69,80,234
1991,Mike Smrek,C,28,GSW,5,0,25,6,11,0.545,0,0,NA,6,11,0.545,0.545,2,4,0.5,3,4,7,1,2,0,2,9,14
1991,Mike Smrek,C,28,LAC,10,0,70,3,16,0.188,0,0,NA,3,16,0.188,0.188,4,8,0.5,4,15,19,3,1,3,1,18,10
1991,Rory Sparrow,PG,32,SAC,80,74,2375,371,756,0.491,31,78,0.397,340,678,0.501,0.511,58,83,0.699,45,141,186,362,83,16,126,189,831
1991,Felton Spencer,C,23,MIN,81,46,2099,195,381,0.512,0,1,0,195,380,0.513,0.512,182,252,0.722,272,369,641,25,48,121,77,337,572
1991,John Starks,SG,25,NYK,61,10,1173,180,410,0.439,27,93,0.29,153,317,0.483,0.472,79,105,0.752,30,101,131,204,59,17,74,137,466
1991,Rod Strickland,PG,24,SAS,58,56,2076,314,651,0.482,11,33,0.333,303,618,0.49,0.491,161,211,0.763,57,162,219,463,117,11,156,125,800
1991,LaSalle Thompson,C,29,IND,82,77,1946,276,565,0.488,1,5,0.2,275,560,0.491,0.489,72,104,0.692,154,409,563,147,63,63,168,265,625
1991,Otis Thorpe,PF,28,HOU,82,82,3039,549,988,0.556,3,7,0.429,546,981,0.557,0.557,334,480,0.696,287,559,846,197,73,20,217,278,1435
1991,Andre Turner,PG,26,PHI,70,1,1407,168,383,0.439,12,33,0.364,156,350,0.446,0.454,64,87,0.736,36,116,152,311,63,0,95,124,412
1991,Kelvin Upshaw,SG,28,DAL,48,1,514,104,231,0.45,7,29,0.241,97,202,0.48,0.465,55,64,0.859,20,35,55,86,28,5,39,77,270
1991,Loy Vaught,PF,22,LAC,73,0,1178,175,359,0.487,0,2,0,175,357,0.49,0.487,49,74,0.662,124,225,349,40,20,23,49,135,399
1991,Darrell Walker,PG,29,WSB,71,65,2305,230,535,0.43,0,9,0,230,526,0.437,0.43,93,154,0.604,140,358,498,459,78,33,154,199,553
1991,Spud Webb,PG,27,ATL,75,64,2197,359,803,0.447,54,168,0.321,305,635,0.48,0.481,231,266,0.868,41,133,174,417,118,6,146,180,1003
1991,Morlon Wiley,PG,24,ORL,34,0,350,45,108,0.417,6,12,0.5,39,96,0.406,0.444,17,25,0.68,4,13,17,73,24,0,34,37,113
1991,Dominique Wilkins,SF,31,ATL,81,81,3078,770,1640,0.47,85,249,0.341,685,1391,0.492,0.495,476,574,0.829,261,471,732,265,123,65,201,156,2101
1991,Herb Williams,C,32,DAL,60,36,1832,332,655,0.507,0,4,0,332,651,0.51,0.507,83,130,0.638,86,271,357,95,30,88,113,197,747
1991,Micheal Williams,PG,24,IND,73,37,1706,261,523,0.499,1,7,0.143,260,516,0.504,0.5,290,330,0.879,49,127,176,348,150,17,150,202,813
1991,Reggie Williams,SF,26,SAS,22,0,354,61,127,0.48,14,26,0.538,47,101,0.465,0.535,35,41,0.854,17,42,59,46,20,11,36,64,171
1991,Reggie Williams,SF,26,DEN,51,46,1542,323,728,0.444,43,131,0.328,280,597,0.469,0.473,131,156,0.84,116,131,247,87,93,30,76,189,820
1991,Scott Williams,PF,22,CHI,51,0,337,53,104,0.51,1,2,0.5,52,102,0.51,0.514,20,28,0.714,42,56,98,16,12,13,23,51,127
1991,Kevin Willis,PF,28,ATL,80,80,2373,444,881,0.504,4,10,0.4,440,871,0.505,0.506,159,238,0.668,259,445,704,99,60,40,153,235,1051
1991,Trevor Wilson,PF,22,ATL,25,0,162,21,70,0.3,0,2,0,21,68,0.309,0.3,13,26,0.5,16,24,40,11,5,1,17,13,55
1991,Kennard Winchester,SF,24,HOU,64,1,607,98,245,0.4,8,20,0.4,90,225,0.4,0.416,35,45,0.778,34,33,67,25,16,13,30,70,239
1991,Joe Wolf,C,26,DEN,74,38,1593,234,519,0.451,2,15,0.133,232,504,0.46,0.453,69,83,0.831,136,264,400,107,60,31,95,244,539
1991,David Wood,SF,26,HOU,82,13,1421,148,349,0.424,28,90,0.311,120,259,0.463,0.464,108,133,0.812,107,139,246,94,58,16,89,236,432
1991,Mike Woodson,SG,32,HOU,11,3,125,21,54,0.389,1,6,0.167,20,48,0.417,0.398,10,12,0.833,2,9,11,10,5,4,7,11,53
1991,Mike Woodson,SG,32,CLE,4,0,46,5,23,0.217,0,1,0,5,22,0.227,0.217,1,1,1,1,1,2,5,0,1,5,7,11
1991,Orlando Woolridge,SF,31,DEN,53,50,1823,490,983,0.498,0,4,0,490,979,0.501,0.498,350,439,0.797,141,220,361,119,69,23,152,145,1330
1991,Haywoode Workman,PG,25,WSB,73,56,2034,234,515,0.454,12,50,0.24,222,465,0.477,0.466,101,133,0.759,51,191,242,353,87,7,135,162,581
1991,Howard Wright,PF,23,ATL,4,0,20,2,3,0.667,0,0,NA,2,3,0.667,0.667,1,1,1,1,5,6,0,0,0,2,3,5
1991,Howard Wright,PF,23,ORL,8,0,136,15,41,0.366,0,0,NA,15,41,0.366,0.366,13,21,0.619,10,27,37,3,3,5,9,23,43
1991,Howard Wright,PF,23,DAL,3,0,8,2,3,0.667,0,1,0,2,2,1,0.667,2,2,1,1,1,2,0,1,0,0,2,6
1991,Danny Young,PG,28,POR,75,1,897,103,271,0.38,36,104,0.346,67,167,0.401,0.446,41,45,0.911,22,53,75,141,50,7,50,49,283
1992,Alaa Abdelnaby,PF,23,POR,71,1,934,178,361,0.493,0,0,NA,178,361,0.493,0.493,76,101,0.752,81,179,260,30,25,16,66,132,432
1992,Mark Acres,C,29,ORL,68,6,926,78,151,0.517,1,3,0.333,77,148,0.52,0.52,51,67,0.761,97,155,252,22,25,15,33,140,208
1992,Greg Anderson,PF,27,DEN,82,82,2793,389,854,0.456,0,4,0,389,850,0.458,0.456,167,268,0.623,337,604,941,78,88,65,201,263,945
1992,Kenny Anderson,PG,21,NJN,64,13,1086,187,480,0.39,3,13,0.231,184,467,0.394,0.393,73,98,0.745,38,89,127,203,67,9,97,68,450
1992,Ron Anderson,SF,33,PHI,82,11,2432,469,1008,0.465,42,127,0.331,427,881,0.485,0.486,143,163,0.877,96,182,278,135,86,11,109,128,1123
1992,Willie Anderson,SG,25,SAS,57,55,1889,312,685,0.455,13,56,0.232,299,629,0.475,0.465,107,138,0.775,62,238,300,302,54,51,140,151,744
1992,Michael Ansley,SF,24,PHI,8,0,32,5,11,0.455,0,0,NA,5,11,0.455,0.455,5,6,0.833,2,2,4,2,0,0,3,6,15
1992,Michael Ansley,SF,24,CHH,2,0,13,3,7,0.429,0,0,NA,3,7,0.429,0.429,0,0,NA,0,2,2,0,0,0,0,1,6
1992,Greg Anthony,PG,24,NYK,82,1,1510,161,435,0.37,8,55,0.145,153,380,0.403,0.379,117,158,0.741,33,103,136,314,59,9,98,170,447
1992,B.J. Armstrong,PG,24,CHI,82,3,1875,335,697,0.481,35,87,0.402,300,610,0.492,0.506,104,129,0.806,19,126,145,266,46,5,94,88,809
1992,Vincent Askew,SG,25,GSW,80,10,1496,193,379,0.509,1,10,0.1,192,369,0.52,0.511,111,160,0.694,89,144,233,188,47,23,84,128,498
1992,Stacey Augmon,SG,23,ATL,82,82,2505,440,899,0.489,1,6,0.167,439,893,0.492,0.49,213,320,0.666,191,229,420,201,124,27,181,161,1094
1992,Isaac Austin,C,22,UTA,31,0,112,21,46,0.457,0,0,NA,21,46,0.457,0.457,19,30,0.633,11,24,35,5,2,2,8,20,61
1992,Thurl Bailey,PF,30,UTA,13,0,327,39,101,0.386,0,1,0,39,100,0.39,0.386,44,55,0.8,23,55,78,19,5,15,21,31,122
1992,Thurl Bailey,PF,30,MIN,71,18,1777,329,735,0.448,0,1,0,329,734,0.448,0.448,171,215,0.795,99,308,407,59,30,102,87,129,829
1992,Kenny Battle,SG,27,BOS,8,0,46,3,4,0.75,0,0,NA,3,4,0.75,0.75,8,8,1,3,6,9,0,1,0,2,4,14
1992,Kenny Battle,SG,27,GSW,8,0,46,8,13,0.615,0,1,0,8,12,0.667,0.615,2,4,0.5,1,6,7,4,1,2,2,6,18
1992,Benoit Benjamin,C,27,SEA,63,61,1941,354,740,0.478,0,2,0,354,738,0.48,0.478,171,249,0.687,130,383,513,76,39,118,175,185,879
1992,Winston Bennett,SF,26,CLE,52,45,831,79,209,0.378,0,1,0,79,208,0.38,0.378,35,50,0.7,62,99,161,38,19,9,33,121,193
1992,Winston Bennett,SF,26,MIA,2,0,2,1,2,0.5,0,0,NA,1,2,0.5,0.5,0,0,NA,1,0,1,0,0,0,0,1,2
1992,David Benoit,SF,23,UTA,77,2,1161,175,375,0.467,3,14,0.214,172,361,0.476,0.471,81,100,0.81,105,191,296,34,19,44,71,124,434
1992,Muggsy Bogues,PG,27,CHH,82,69,2790,317,671,0.472,2,27,0.074,315,644,0.489,0.474,94,120,0.783,58,177,235,743,170,6,156,156,730
1992,Manute Bol,C,29,PHI,71,2,1267,49,128,0.383,0,9,0,49,119,0.412,0.383,12,26,0.462,54,168,222,22,11,205,41,139,110
1992,Terrell Brandon,PG,21,CLE,82,9,1605,252,601,0.419,1,23,0.043,251,578,0.434,0.42,100,124,0.806,49,113,162,316,81,22,136,107,605
1992,Randy Breuer,C,31,MIN,67,25,1176,161,344,0.468,0,1,0,161,343,0.469,0.468,41,77,0.532,98,183,281,89,27,99,41,117,363
1992,Frank Brickowski,SF,32,MIL,65,60,1556,306,584,0.524,3,6,0.5,303,578,0.524,0.527,125,163,0.767,97,247,344,122,60,23,112,223,740
1992,Scott Brooks,PG,26,MIN,82,0,1082,167,374,0.447,32,90,0.356,135,284,0.475,0.489,51,63,0.81,27,72,99,205,66,7,51,82,417
1992,Chucky Brown,SF,23,CLE,6,0,50,5,10,0.5,0,0,NA,5,10,0.5,0.5,5,8,0.625,2,4,6,3,3,0,2,7,15
1992,Chucky Brown,SF,23,LAL,36,2,381,55,118,0.466,0,3,0,55,115,0.478,0.466,25,41,0.61,29,47,76,23,9,7,27,41,135
1992,Dee Brown,PG,23,BOS,31,20,883,149,350,0.426,5,22,0.227,144,328,0.439,0.433,60,78,0.769,15,64,79,164,33,7,59,74,363
1992,Tony Brown,SF,31,LAC,22,0,254,39,89,0.438,7,22,0.318,32,67,0.478,0.478,18,29,0.621,9,19,28,16,12,1,14,31,103
1992,Tony Brown,SF,31,SEA,35,2,401,63,160,0.394,12,41,0.293,51,119,0.429,0.431,30,37,0.811,23,33,56,32,18,4,21,51,168
1992,Mark Bryant,PF,26,POR,56,0,800,95,198,0.48,0,3,0,95,195,0.487,0.48,40,60,0.667,87,114,201,41,26,8,30,105,230
1992,Jud Buechler,SF,23,NJN,2,0,29,4,8,0.5,0,0,NA,4,8,0.5,0.5,0,0,NA,2,0,2,2,2,1,1,2,8
1992,Jud Buechler,SF,23,SAS,11,0,140,15,30,0.5,0,0,NA,15,30,0.5,0.5,3,9,0.333,6,16,22,11,8,3,5,18,33
1992,Jud Buechler,SF,23,GSW,15,0,121,10,33,0.303,0,1,0,10,32,0.313,0.303,9,12,0.75,10,18,28,10,9,3,7,11,29
1992,Elden Campbell,C,23,LAL,81,47,1876,220,491,0.448,0,2,0,220,489,0.45,0.448,138,223,0.619,155,268,423,59,53,159,73,203,578
1992,Tony Campbell,SF,29,MIN,78,41,2441,527,1137,0.464,13,37,0.351,514,1100,0.467,0.469,240,299,0.803,141,145,286,229,84,31,165,206,1307
1992,Antoine Carr,PF,30,SAS,81,27,1867,359,732,0.49,1,5,0.2,358,727,0.492,0.491,162,212,0.764,128,218,346,63,32,96,114,264,881
1992,Cedric Ceballos,SF,22,PHO,64,4,725,176,365,0.482,1,6,0.167,175,359,0.487,0.484,109,148,0.736,60,92,152,50,16,11,71,52,462
1992,Rex Chapman,PG,24,CHH,21,11,545,108,240,0.45,8,27,0.296,100,213,0.469,0.467,36,53,0.679,9,45,54,86,14,8,42,47,260
1992,Rex Chapman,SG,24,WSB,1,0,22,5,12,0.417,0,2,0,5,10,0.5,0.417,0,0,NA,1,3,4,3,1,0,3,4,10
1992,Maurice Cheeks,PG,35,ATL,56,0,1086,115,249,0.462,3,6,0.5,112,243,0.461,0.468,26,43,0.605,29,66,95,185,83,0,36,73,259
1992,Pete Chilcutt,PF,23,SAC,69,2,817,113,250,0.452,2,2,1,111,248,0.448,0.456,23,28,0.821,78,109,187,38,32,17,41,70,251
1992,Bimbo Coles,PG,23,MIA,81,28,1976,295,649,0.455,10,52,0.192,285,597,0.477,0.462,216,262,0.824,69,120,189,366,73,13,167,151,816
1992,Marty Conlon,C,24,SEA,45,1,381,48,101,0.475,0,0,NA,48,101,0.475,0.475,24,32,0.75,33,36,69,12,9,7,27,40,120
1992,Lester Conner,PG,32,MIL,81,9,1420,103,239,0.431,0,7,0,103,232,0.444,0.431,81,115,0.704,63,121,184,294,97,10,79,86,287
1992,Anthony Cook,PF,24,DEN,22,0,115,15,25,0.6,0,0,NA,15,25,0.6,0.6,4,6,0.667,13,21,34,2,5,4,3,10,34
1992,Tyrone Corbin,SF,29,MIN,11,8,344,57,142,0.401,0,1,0,57,141,0.404,0.401,44,53,0.83,24,45,69,33,12,6,26,31,158
1992,Tyrone Corbin,SF,29,UTA,69,1,1863,246,488,0.504,0,3,0,246,485,0.507,0.504,130,148,0.878,139,264,403,107,70,14,71,162,622
1992,Chris Corchiani,PG,23,ORL,51,1,741,77,193,0.399,10,37,0.27,67,156,0.429,0.425,91,104,0.875,18,60,78,141,45,2,74,94,255
1992,Terry Cummings,PF,30,SAS,70,67,2149,514,1053,0.488,5,13,0.385,509,1040,0.489,0.491,177,249,0.711,247,384,631,102,58,34,115,210,1210
1992,Dale Davis,PF,22,IND,64,23,1301,154,279,0.552,0,1,0,154,278,0.554,0.552,87,152,0.572,158,252,410,30,27,74,49,191,395
1992,Walter Davis,SF,37,DEN,46,0,741,185,403,0.459,5,16,0.313,180,387,0.465,0.465,82,94,0.872,20,50,70,68,29,1,45,69,457
1992,James Donaldson,C,34,DAL,44,32,994,107,227,0.471,0,0,NA,107,227,0.471,0.471,59,84,0.702,97,173,270,31,8,44,41,86,273
1992,James Donaldson,C,34,NYK,14,0,81,5,18,0.278,0,0,NA,5,18,0.278,0.278,2,2,1,2,17,19,2,0,5,7,17,12
1992,Sherman Douglas,PG,25,MIA,5,2,98,16,31,0.516,0,1,0,16,30,0.533,0.516,5,7,0.714,1,5,6,19,4,0,8,10,37
1992,Sherman Douglas,PG,25,BOS,37,0,654,101,222,0.455,1,9,0.111,100,213,0.469,0.457,68,100,0.68,12,45,57,153,21,9,60,68,271
1992,Clyde Drexler,SG,29,POR,76,76,2751,694,1476,0.47,114,338,0.337,580,1138,0.51,0.509,401,505,0.794,166,334,500,512,138,70,240,229,1903
1992,Chris Dudley,C,26,NJN,82,21,1902,190,472,0.403,0,0,NA,190,472,0.403,0.403,80,171,0.468,343,396,739,58,38,179,79,275,460
1992,Blue Edwards,SF,26,UTA,81,81,2283,433,830,0.522,39,103,0.379,394,727,0.542,0.545,113,146,0.774,86,212,298,137,81,46,122,236,1018
1992,Kevin Edwards,PG,26,MIA,81,1,1840,325,716,0.454,7,32,0.219,318,684,0.465,0.459,162,191,0.848,56,155,211,170,99,20,120,138,819
1992,Mario Elie,SG,28,GSW,79,32,1677,221,424,0.521,23,70,0.329,198,354,0.559,0.548,155,182,0.852,69,158,227,174,68,15,83,159,620
1992,Dale Ellis,SF,31,MIL,81,11,2191,485,1034,0.469,138,329,0.419,347,705,0.492,0.536,164,212,0.774,92,161,253,104,57,18,119,151,1272
1992,Greg Foster,PF,23,WSB,49,3,548,89,193,0.461,0,1,0,89,192,0.464,0.461,35,49,0.714,43,102,145,35,6,12,36,83,213
1992,Kevin Gamble,SF,26,BOS,82,77,2496,480,908,0.529,9,31,0.29,471,877,0.537,0.534,139,157,0.885,80,206,286,219,75,37,97,200,1108
1992,Winston Garland,PG,27,DEN,78,67,2209,333,750,0.444,9,28,0.321,324,722,0.449,0.45,171,199,0.859,67,123,190,411,98,22,175,206,846
1992,Tom Garrick,SG,25,SAS,19,5,374,44,93,0.473,0,1,0,44,92,0.478,0.473,10,16,0.625,8,33,41,63,21,1,30,33,98
1992,Tom Garrick,SG,25,MIN,15,0,112,11,33,0.333,1,2,0.5,10,31,0.323,0.348,6,8,0.75,2,7,9,18,7,3,10,14,29
1992,Tom Garrick,SG,25,DAL,6,0,63,4,17,0.235,0,1,0,4,16,0.25,0.235,2,2,1,2,4,6,17,8,0,4,7,10
1992,Chris Gatling,PF,24,GSW,54,1,612,117,206,0.568,0,4,0,117,202,0.579,0.568,72,109,0.661,75,107,182,16,31,36,44,101,306
1992,Kendall Gill,SG,23,CHH,79,79,2906,666,1427,0.467,6,25,0.24,660,1402,0.471,0.469,284,381,0.745,165,237,402,329,154,46,180,237,1622
1992,Armen Gilliam,PF,27,PHI,81,81,2771,512,1001,0.511,0,2,0,512,999,0.513,0.511,343,425,0.807,234,426,660,118,51,85,166,176,1367
1992,Gerald Glass,SF,24,MIN,75,41,1822,383,871,0.44,16,54,0.296,367,817,0.449,0.449,77,125,0.616,107,153,260,175,66,30,103,171,859
1992,Mike Gminski,C,32,CHH,35,10,499,90,199,0.452,1,3,0.333,89,196,0.454,0.455,21,28,0.75,37,81,118,31,11,16,20,37,202
1992,Ron Grandison,PF,27,CHH,3,0,25,2,4,0.5,0,0,NA,2,4,0.5,0.5,6,10,0.6,3,8,11,1,1,1,3,4,10
1992,Greg Grant,PG,25,CHH,13,0,57,0,8,0,0,0,NA,0,8,0,0,1,2,0.5,1,3,4,18,8,0,5,3,1
1992,Greg Grant,PG,25,PHI,55,0,834,99,217,0.456,7,18,0.389,92,199,0.462,0.472,19,22,0.864,13,52,65,199,37,2,41,73,224
1992,Jeff Grayer,SG,26,MIL,82,11,1659,309,689,0.448,19,66,0.288,290,623,0.465,0.462,102,153,0.667,129,128,257,150,64,13,105,142,739
1992,A.C. Green,PF,28,LAL,82,53,2902,382,803,0.476,12,56,0.214,370,747,0.495,0.483,340,457,0.744,306,456,762,117,91,36,111,141,1116
1992,Sean Green,SG,21,IND,35,0,256,62,158,0.392,2,10,0.2,60,148,0.405,0.399,15,28,0.536,22,20,42,22,13,6,27,31,141
1992,Sidney Green,PF,31,SAS,80,1,1127,147,344,0.427,0,0,NA,147,344,0.427,0.427,73,89,0.82,92,250,342,36,29,11,62,148,367
1992,Jack Haley,C,28,LAL,49,9,394,31,84,0.369,0,0,NA,31,84,0.369,0.369,14,29,0.483,31,64,95,7,7,8,25,75,76
1992,Tom Hammonds,PF,24,WSB,37,19,984,195,400,0.488,0,1,0,195,399,0.489,0.488,50,82,0.61,49,136,185,36,22,13,58,118,440
1992,Bob Hansen,SG,31,SAC,2,2,40,4,9,0.444,0,2,0,4,7,0.571,0.444,0,0,NA,2,2,4,1,1,0,0,6,8
1992,Bob Hansen,SG,31,CHI,66,0,769,75,169,0.444,7,25,0.28,68,144,0.472,0.464,8,22,0.364,15,58,73,68,26,3,28,128,165
1992,Tim Hardaway,PG,25,GSW,81,81,3332,734,1592,0.461,127,376,0.338,607,1216,0.499,0.501,298,389,0.766,81,229,310,807,164,13,267,208,1893
1992,Derek Harper,PG,30,DAL,65,64,2252,448,1011,0.443,58,186,0.312,390,825,0.473,0.472,198,261,0.759,49,121,170,373,101,17,154,150,1152
1992,Ron Harper,SG,28,LAC,82,82,3144,569,1292,0.44,64,211,0.303,505,1081,0.467,0.465,293,398,0.736,120,327,447,417,152,72,252,199,1495
1992,Gerald Henderson,PG,36,HOU,8,0,34,4,11,0.364,0,3,0,4,8,0.5,0.364,4,6,0.667,1,1,2,5,0,0,4,4,12
1992,Gerald Henderson,PG,36,DET,8,0,62,8,21,0.381,3,5,0.6,5,16,0.313,0.452,5,5,1,0,6,6,5,3,0,4,8,24
1992,Carl Herrera,PF,25,HOU,43,7,566,83,161,0.516,0,1,0,83,160,0.519,0.516,25,44,0.568,33,66,99,27,16,25,37,60,191
1992,Sean Higgins,SF,23,SAS,6,0,36,4,15,0.267,0,1,0,4,14,0.286,0.267,7,7,1,2,6,8,4,2,0,4,6,15
1992,Sean Higgins,PF,23,ORL,32,12,580,123,262,0.469,6,24,0.25,117,238,0.492,0.481,24,29,0.828,27,67,94,37,14,6,37,52,276
1992,Tyrone Hill,C,23,GSW,82,75,1886,254,487,0.522,0,1,0,254,486,0.523,0.522,163,235,0.694,182,411,593,47,73,43,106,315,671
1992,Donald Hodge,PF,22,DAL,51,27,1058,163,328,0.497,0,0,NA,163,328,0.497,0.497,100,150,0.667,118,157,275,39,25,23,75,128,426
1992,Dave Hoppen,C,27,PHI,11,0,40,2,7,0.286,0,0,NA,2,7,0.286,0.286,5,10,0.5,1,9,10,2,0,0,3,6,9
1992,Dennis Hopson,SG,26,CHI,2,0,10,1,2,0.5,0,0,NA,1,2,0.5,0.5,0,0,NA,0,0,0,0,1,0,0,2,2
1992,Dennis Hopson,SG,26,SAC,69,0,1304,275,591,0.465,12,47,0.255,263,544,0.483,0.475,179,253,0.708,105,101,206,102,66,39,100,113,741
1992,Jeff Hornacek,SG,28,PHO,81,81,3078,635,1240,0.512,83,189,0.439,552,1051,0.525,0.546,279,315,0.886,106,301,407,411,158,31,170,218,1632
1992,Jay Humphries,PG,29,MIL,71,71,2261,377,803,0.469,42,144,0.292,335,659,0.508,0.496,195,249,0.783,44,140,184,466,119,13,148,210,991
1992,Mark Jackson,PG,26,NYK,81,81,2461,367,747,0.491,11,43,0.256,356,704,0.506,0.499,171,222,0.77,95,210,305,694,112,13,211,153,916
1992,Dave Jamerson,SG,24,HOU,48,0,378,79,191,0.414,8,28,0.286,71,163,0.436,0.435,25,27,0.926,22,21,43,33,17,0,24,39,191
1992,Henry James,SF,26,CLE,65,5,866,164,403,0.407,29,90,0.322,135,313,0.431,0.443,61,76,0.803,35,77,112,25,16,11,43,94,418
1992,Avery Johnson,PG,26,SAS,20,14,463,55,108,0.509,1,5,0.2,54,103,0.524,0.514,24,32,0.75,5,30,35,100,21,3,45,43,135
1992,Avery Johnson,PG,26,HOU,49,1,772,103,222,0.464,3,10,0.3,100,212,0.472,0.471,42,69,0.609,8,37,45,166,40,6,65,46,251
1992,Eddie Johnson,SF,32,SEA,81,19,2366,534,1164,0.459,27,107,0.252,507,1057,0.48,0.47,291,338,0.861,118,174,292,161,55,11,130,199,1386
1992,Steve Kerr,PG,26,CLE,48,20,847,121,237,0.511,32,74,0.432,89,163,0.546,0.578,45,54,0.833,14,64,78,110,27,10,31,29,319
1992,Stacey King,PF,25,CHI,79,12,1268,215,425,0.506,2,5,0.4,213,420,0.507,0.508,119,158,0.753,87,118,205,77,21,25,76,129,551
1992,Greg Kite,C,30,ORL,72,44,1479,94,215,0.437,0,1,0,94,214,0.439,0.437,40,68,0.588,156,246,402,44,30,57,61,212,228
1992,Joe Kleine,C,30,BOS,70,3,991,144,293,0.491,4,8,0.5,140,285,0.491,0.498,34,48,0.708,94,202,296,32,23,14,27,99,326
1992,Negele Knight,PG,24,PHO,42,1,631,103,217,0.475,4,13,0.308,99,204,0.485,0.484,33,48,0.688,16,30,46,112,24,3,58,58,243
1992,Jerome Lane,PF,25,DEN,9,5,141,10,40,0.25,0,0,NA,10,40,0.25,0.25,8,19,0.421,22,22,44,13,2,1,10,18,28
1992,Jerome Lane,PF,25,IND,3,0,30,3,5,0.6,0,0,NA,3,5,0.6,0.6,0,6,0,9,9,18,4,0,0,3,9,6
1992,Jerome Lane,PF,25,MIL,2,0,6,1,1,1,0,0,NA,1,1,1,1,1,2,0.5,1,3,4,0,0,0,1,1,3
1992,Andrew Lang,C,25,PHO,81,71,1965,248,475,0.522,0,1,0,248,474,0.523,0.522,126,164,0.768,170,376,546,43,48,201,87,306,622
1992,Eric Leckner,C,25,CHH,59,2,716,79,154,0.513,0,1,0,79,153,0.516,0.513,38,51,0.745,49,157,206,31,9,18,39,114,196
1992,Jim Les,PG,28,SAC,62,5,712,74,192,0.385,45,131,0.344,29,61,0.475,0.503,38,47,0.809,11,52,63,143,31,3,42,58,231
1992,Marcus Liberty,SF,23,DEN,75,13,1527,275,621,0.443,17,50,0.34,258,571,0.452,0.457,131,180,0.728,144,164,308,58,66,29,90,165,698
1992,Todd Lichti,SG,25,DEN,68,10,1176,173,376,0.46,1,9,0.111,172,367,0.469,0.461,99,118,0.839,36,82,118,74,43,12,72,131,446
1992,Alton Lister,C,33,GSW,26,12,293,44,79,0.557,0,0,NA,44,79,0.557,0.557,14,33,0.424,21,71,92,14,5,16,20,61,102
1992,Brad Lohaus,PF,27,MIL,70,8,1081,162,360,0.45,57,144,0.396,105,216,0.486,0.529,27,41,0.659,65,184,249,74,40,71,46,144,408
1992,Grant Long,PF,25,MIA,82,82,3063,440,890,0.494,6,22,0.273,434,868,0.5,0.498,326,404,0.807,259,432,691,225,139,40,185,248,1212
1992,Luc Longley,C,23,MIN,66,3,991,114,249,0.458,0,0,NA,114,249,0.458,0.458,53,80,0.663,67,190,257,53,35,64,83,157,281
1992,Mark Macon,SG,22,DEN,76,67,2304,333,889,0.375,4,30,0.133,329,859,0.383,0.377,135,185,0.73,80,140,220,168,154,14,155,242,805
1992,Jeff Malone,SG,30,UTA,81,81,2922,691,1353,0.511,1,12,0.083,690,1341,0.515,0.511,256,285,0.898,49,184,233,180,56,5,140,126,1639
1992,Danny Manning,PF,25,LAC,82,82,2904,650,1199,0.542,0,5,0,650,1194,0.544,0.542,279,385,0.725,229,335,564,285,135,122,210,293,1579
1992,Tony Massenburg,PF,24,SAS,1,0,9,1,5,0.2,0,0,NA,1,5,0.2,0.2,0,0,NA,0,0,0,0,0,0,0,2,2
1992,Tony Massenburg,PF,24,CHH,3,0,13,0,3,0,0,0,NA,0,3,0,0,1,2,0.5,1,3,4,0,1,0,4,2,1
1992,Tony Massenburg,PF,24,BOS,7,0,46,4,9,0.444,0,0,NA,4,9,0.444,0.444,2,4,0.5,2,7,9,0,0,1,2,7,10
1992,Tony Massenburg,PF,24,GSW,7,0,22,5,8,0.625,0,0,NA,5,8,0.625,0.625,6,9,0.667,4,8,12,0,0,0,3,10,16
1992,Vernon Maxwell,SG,26,HOU,80,80,2700,502,1216,0.413,162,473,0.342,340,743,0.458,0.479,206,267,0.772,37,206,243,326,104,28,178,200,1372
1992,Tharon Mayes,SG,23,PHI,21,0,215,28,94,0.298,14,39,0.359,14,55,0.255,0.372,20,30,0.667,3,12,15,32,14,1,28,32,90
1992,Tharon Mayes,SG,23,LAC,3,0,40,2,5,0.4,1,2,0.5,1,3,0.333,0.5,4,6,0.667,0,1,1,3,2,1,3,9,9
1992,George McCloud,SF,24,IND,51,5,892,128,313,0.409,32,94,0.34,96,219,0.438,0.46,50,64,0.781,45,87,132,116,26,11,62,95,338
1992,Xavier McDaniel,SF,28,NYK,82,82,2344,488,1021,0.478,12,39,0.308,476,982,0.485,0.484,137,192,0.714,176,284,460,149,57,24,147,241,1125
1992,Terry Mills,PF,24,NJN,82,24,1714,310,670,0.463,8,23,0.348,302,647,0.467,0.469,114,152,0.75,187,266,453,84,48,41,82,200,742
1992,John Morton,SG,24,CLE,4,0,54,3,12,0.25,0,1,0,3,11,0.273,0.25,8,9,0.889,3,4,7,5,1,0,4,3,14
1992,John Morton,SF,24,MIA,21,0,216,33,81,0.407,2,15,0.133,31,66,0.47,0.42,24,29,0.828,3,16,19,27,12,1,24,20,92
1992,Eric Murdock,PG,23,UTA,50,0,478,76,183,0.415,5,26,0.192,71,157,0.452,0.429,46,61,0.754,21,33,54,92,30,7,50,52,203
1992,Tod Murphy,PF,28,MIN,47,3,429,39,80,0.488,1,2,0.5,38,78,0.487,0.494,19,34,0.559,36,74,110,11,9,8,18,40,98
1992,Dikembe Mutombo,C,25,DEN,71,71,2716,428,869,0.493,0,0,NA,428,869,0.493,0.493,321,500,0.642,316,554,870,156,43,210,252,273,1177
1992,Ed Nealy,PF,31,PHO,52,4,505,62,121,0.512,20,50,0.4,42,71,0.592,0.595,16,24,0.667,25,86,111,37,16,2,17,45,160
1992,Johnny Newman,SF,28,CHH,55,55,1651,295,618,0.477,13,46,0.283,282,572,0.493,0.488,236,308,0.766,71,108,179,146,70,14,129,181,839
1992,Alan Ogg,C,24,MIA,43,0,367,46,84,0.548,0,0,NA,46,84,0.548,0.548,16,30,0.533,30,44,74,7,5,28,19,73,108
1992,Billy Owens,PF,22,GSW,80,77,2510,468,891,0.525,1,9,0.111,467,882,0.529,0.526,204,312,0.654,243,396,639,188,90,65,179,276,1141
1992,Robert Pack,PG,22,POR,72,0,894,115,272,0.423,0,10,0,115,262,0.439,0.423,102,127,0.803,32,65,97,140,40,4,92,101,332
1992,Gary Payton,PG,23,SEA,81,79,2549,331,734,0.451,3,23,0.13,328,711,0.461,0.453,99,148,0.669,123,172,295,506,147,21,174,248,764
1992,Sam Perkins,PF,30,LAL,63,63,2332,361,803,0.45,15,69,0.217,346,734,0.471,0.459,304,372,0.817,192,364,556,141,64,62,83,192,1041
1992,Elliot Perry,PG,22,LAC,10,0,66,6,15,0.4,0,2,0,6,13,0.462,0.4,1,2,0.5,2,5,7,14,9,1,13,10,13
1992,Elliot Perry,PG,22,CHH,40,0,371,43,114,0.377,1,5,0.2,42,109,0.385,0.382,26,39,0.667,12,20,32,64,25,2,37,26,113
1992,Tim Perry,PF,26,PHO,80,69,2483,413,789,0.523,3,8,0.375,410,781,0.525,0.525,153,215,0.712,204,347,551,134,44,116,141,237,982
1992,Dražen Petrović,SG,27,NJN,82,82,3027,668,1315,0.508,123,277,0.444,545,1038,0.525,0.555,232,287,0.808,97,161,258,252,105,11,215,248,1691
1992,Ricky Pierce,SG,32,SEA,78,78,2658,620,1306,0.475,33,123,0.268,587,1183,0.496,0.487,417,455,0.916,93,140,233,241,86,20,189,213,1690
1992,Ed Pinckney,PF,28,BOS,81,36,1917,203,378,0.537,0,1,0,203,377,0.538,0.537,207,255,0.812,252,312,564,62,70,56,73,158,613
1992,Olden Polynice,C,27,LAC,76,65,1834,244,470,0.519,0,1,0,244,469,0.52,0.519,125,201,0.622,195,341,536,46,45,20,83,165,613
1992,Kevin Pritchard,PG,24,BOS,11,0,136,16,34,0.471,0,3,0,16,31,0.516,0.471,14,18,0.778,1,10,11,30,3,4,11,17,46
1992,Brian Quinnett,SG,25,NYK,24,0,190,28,73,0.384,10,26,0.385,18,47,0.383,0.452,8,14,0.571,9,15,24,7,7,6,8,21,74
1992,Brian Quinnett,SG,25,DAL,15,0,136,15,51,0.294,3,15,0.2,12,36,0.333,0.324,8,12,0.667,7,20,27,5,9,2,8,11,41
1992,Kurt Rambis,PF,33,PHO,28,5,381,38,82,0.463,0,0,NA,38,82,0.463,0.463,14,18,0.778,23,83,106,37,12,14,25,46,90
1992,Mark Randall,PF,24,CHI,15,0,67,10,22,0.455,0,2,0,10,20,0.5,0.455,6,8,0.75,4,5,9,7,0,0,6,8,26
1992,Mark Randall,PF,24,MIN,39,0,374,58,127,0.457,3,14,0.214,55,113,0.487,0.469,26,35,0.743,35,27,62,26,12,3,19,31,145
1992,J.R. Reid,C,23,CHH,51,7,1257,213,435,0.49,0,3,0,213,432,0.493,0.49,134,190,0.705,96,221,317,81,49,23,84,159,560
1992,Doc Rivers,PG,30,LAC,59,25,1657,226,533,0.424,26,92,0.283,200,441,0.454,0.448,163,196,0.832,23,124,147,233,111,19,92,166,641
1992,Alvin Robertson,SG,29,MIL,82,79,2463,396,922,0.43,67,210,0.319,329,712,0.462,0.466,151,198,0.763,175,175,350,360,210,32,223,263,1010
1992,Clifford Robinson,SF,25,POR,82,7,2124,398,854,0.466,1,11,0.091,397,843,0.471,0.467,219,330,0.664,140,276,416,137,85,107,154,274,1016
1992,Larry Robinson,SG,24,BOS,1,0,6,1,5,0.2,0,0,NA,1,5,0.2,0.2,0,0,NA,2,0,2,1,0,0,1,3,2
1992,Rumeal Robinson,PG,25,ATL,81,64,2220,423,928,0.456,34,104,0.327,389,824,0.472,0.474,175,275,0.636,64,155,219,446,105,24,206,178,1055
1992,Donald Royal,SF,25,SAS,60,4,718,80,178,0.449,0,0,NA,80,178,0.449,0.449,92,133,0.692,65,59,124,34,25,7,39,73,252
1992,John Salley,PF,27,DET,72,38,1774,249,486,0.512,0,3,0,249,483,0.516,0.512,186,260,0.715,106,190,296,116,49,110,102,222,684
1992,Mike Sanders,SF,31,IND,10,0,81,11,22,0.5,0,0,NA,11,22,0.5,0.5,5,6,0.833,0,8,8,11,2,1,6,8,27
1992,Mike Sanders,SF,31,CLE,21,20,552,81,139,0.583,1,3,0.333,80,136,0.588,0.586,31,41,0.756,27,61,88,42,22,9,16,75,194
1992,Danny Schayes,C,32,MIL,43,4,726,83,199,0.417,0,0,NA,83,199,0.417,0.417,74,96,0.771,58,110,168,34,19,19,41,98,240
1992,Steve Scheffler,C,24,SAC,4,0,15,2,2,1,0,0,NA,2,2,1,1,5,6,0.833,2,1,3,0,0,1,0,2,9
1992,Steve Scheffler,C,24,DEN,7,0,46,4,7,0.571,0,0,NA,4,7,0.571,0.571,4,6,0.667,8,3,11,0,3,0,1,8,12
1992,Dennis Scott,SF,23,ORL,18,15,608,133,331,0.402,29,89,0.326,104,242,0.43,0.446,64,71,0.901,14,52,66,35,20,9,31,49,359
1992,Rony Seikaly,C,26,MIA,79,78,2800,463,947,0.489,0,3,0,463,944,0.49,0.489,370,505,0.733,307,627,934,109,40,121,216,278,1296
1992,Brad Sellers,PF,29,DET,43,1,226,41,88,0.466,0,1,0,41,87,0.471,0.466,20,26,0.769,15,27,42,14,1,10,15,20,102
1992,Brian Shaw,PG,25,BOS,17,3,436,70,164,0.427,0,7,0,70,157,0.446,0.427,35,40,0.875,11,58,69,89,12,10,32,29,175
1992,Brian Shaw,PG,25,MIA,46,23,987,139,349,0.398,5,16,0.313,134,333,0.402,0.405,37,51,0.725,39,96,135,161,45,12,67,86,320
1992,Charles Smith,SF,26,LAC,49,25,1310,251,539,0.466,0,6,0,251,533,0.471,0.466,212,270,0.785,95,206,301,56,41,98,69,159,714
1992,Kenny Smith,PG,26,HOU,81,80,2735,432,910,0.475,54,137,0.394,378,773,0.489,0.504,219,253,0.866,34,143,177,562,104,7,227,112,1137
1992,LaBradford Smith,SG,22,WSB,48,5,708,100,246,0.407,2,21,0.095,98,225,0.436,0.411,45,56,0.804,30,51,81,99,44,1,63,98,247
1992,Steve Smith,SG,22,MIA,61,59,1806,297,654,0.454,40,125,0.32,257,529,0.486,0.485,95,127,0.748,81,107,188,278,59,19,152,162,729
1992,Tony Smith,PG,23,LAL,63,0,820,113,283,0.399,0,11,0,113,272,0.415,0.399,49,75,0.653,31,45,76,109,39,8,50,91,275
1992,Mike Smrek,C,29,GSW,2,0,3,0,0,NA,0,0,NA,0,0,NA,NA,0,0,NA,0,1,1,0,0,0,0,0,0
1992,Rory Sparrow,PG,33,CHI,4,0,18,1,8,0.125,1,2,0.5,0,6,0,0.188,0,0,NA,0,1,1,4,0,0,2,2,3
1992,Rory Sparrow,PG,33,LAL,42,0,471,57,143,0.399,2,13,0.154,55,130,0.423,0.406,8,13,0.615,3,24,27,79,12,5,31,55,124
1992,Felton Spencer,C,24,MIN,61,54,1481,141,331,0.426,0,0,NA,141,331,0.426,0.426,123,178,0.691,167,268,435,53,27,79,70,241,405
1992,John Starks,SG,26,NYK,82,0,2118,405,902,0.449,94,270,0.348,311,632,0.492,0.501,235,302,0.778,45,146,191,276,103,18,150,231,1139
1992,Rod Strickland,PG,25,SAS,57,54,2053,300,659,0.455,5,15,0.333,295,644,0.458,0.459,182,265,0.687,92,173,265,491,118,17,160,122,787
1992,Greg Sutton,PG,24,SAS,67,2,601,93,240,0.388,26,89,0.292,67,151,0.444,0.442,34,45,0.756,6,41,47,91,26,9,70,111,246
1992,Carl Thomas,SG,22,SAC,1,0,31,5,12,0.417,1,2,0.5,4,10,0.4,0.458,1,2,0.5,0,0,0,1,1,0,1,3,12
1992,LaSalle Thompson,C,30,IND,80,49,1299,168,359,0.468,0,2,0,168,357,0.471,0.468,58,71,0.817,98,283,381,102,52,34,98,207,394
1992,Stephen Thompson,SG,23,ORL,1,0,15,1,3,0.333,0,0,NA,1,3,0.333,0.333,0,0,NA,0,1,1,1,0,0,2,2,2
1992,Stephen Thompson,SG,23,SAC,18,0,76,13,34,0.382,0,1,0,13,33,0.394,0.382,3,8,0.375,11,7,18,7,6,3,3,7,29
1992,Otis Thorpe,PF,29,HOU,82,82,3056,558,943,0.592,0,7,0,558,936,0.596,0.592,304,463,0.657,285,577,862,250,52,37,237,307,1420
1992,Andre Turner,PG,27,WSB,70,3,871,111,261,0.425,1,16,0.063,110,245,0.449,0.427,61,77,0.792,17,73,90,177,57,2,84,59,284
1992,Loy Vaught,PF,23,LAC,79,38,1687,271,551,0.492,4,5,0.8,267,546,0.489,0.495,55,69,0.797,160,352,512,71,37,31,66,165,601
1992,Darrell Walker,SG,30,DET,74,4,1541,161,381,0.423,0,10,0,161,371,0.434,0.423,65,105,0.619,85,153,238,205,63,18,79,134,387
1992,Spud Webb,PG,28,SAC,77,77,2724,448,1006,0.445,73,199,0.367,375,807,0.465,0.482,262,305,0.859,30,193,223,547,125,24,229,193,1231
1992,Morlon Wiley,PG,25,ORL,9,0,90,9,28,0.321,0,4,0,9,24,0.375,0.321,3,5,0.6,2,5,7,13,4,0,8,13,21
1992,Morlon Wiley,PG,25,SAS,3,0,13,3,5,0.6,0,0,NA,3,5,0.6,0.6,0,0,NA,0,1,1,1,0,0,0,3,6
1992,Morlon Wiley,PG,25,ATL,41,19,767,71,160,0.444,14,38,0.368,57,122,0.467,0.488,21,30,0.7,22,51,73,166,43,3,52,73,177
1992,Dominique Wilkins,SF,32,ATL,42,42,1601,424,914,0.464,37,128,0.289,387,786,0.492,0.484,294,352,0.835,103,192,295,158,52,24,122,77,1179
1992,Herb Williams,C,33,DAL,75,26,2040,367,851,0.431,1,6,0.167,366,845,0.433,0.432,124,171,0.725,106,348,454,94,35,98,114,189,859
1992,Micheal Williams,PG,25,IND,79,76,2750,404,824,0.49,8,33,0.242,396,791,0.501,0.495,372,427,0.871,73,209,282,647,233,22,240,262,1188
1992,Reggie Williams,SF,27,DEN,81,80,2623,601,1277,0.471,56,156,0.359,545,1121,0.486,0.493,216,269,0.803,145,260,405,235,148,68,173,270,1474
1992,Scott Williams,PF,23,CHI,63,0,690,83,172,0.483,0,3,0,83,169,0.491,0.483,48,74,0.649,90,157,247,50,13,36,35,122,214
1992,Kevin Willis,PF,29,ATL,81,80,2962,591,1224,0.483,6,37,0.162,585,1187,0.493,0.485,292,363,0.804,418,840,1258,173,72,54,197,223,1480
1992,Kennard Winchester,SG,25,HOU,4,0,17,1,3,0.333,0,0,NA,1,3,0.333,0.333,0,0,NA,0,0,0,0,0,0,0,1,2
1992,Kennard Winchester,SF,25,NYK,15,0,64,12,27,0.444,1,2,0.5,11,25,0.44,0.463,8,10,0.8,6,9,15,8,2,2,2,4,33
1992,Joe Wolf,C,27,DEN,67,0,1160,100,277,0.361,1,11,0.091,99,266,0.372,0.363,53,66,0.803,97,143,240,61,32,14,60,124,254
1992,Orlando Woolridge,SF,32,DET,82,61,2113,452,907,0.498,1,9,0.111,451,898,0.502,0.499,241,353,0.683,109,151,260,88,41,33,133,154,1146
1992,Danny Young,PG,29,POR,18,0,134,16,40,0.4,3,10,0.3,13,30,0.433,0.438,10,14,0.714,0,9,9,20,6,0,5,6,45
1992,Danny Young,PG,29,LAC,44,5,889,84,215,0.391,20,60,0.333,64,155,0.413,0.437,47,53,0.887,16,50,66,152,40,4,42,47,235
1993,Alaa Abdelnaby,PF,24,MIL,12,0,159,26,56,0.464,0,1,0,26,55,0.473,0.464,12,16,0.75,12,25,37,10,6,4,13,24,64
1993,Alaa Abdelnaby,PF,24,BOS,63,52,1152,219,417,0.525,0,0,NA,219,417,0.525,0.525,76,100,0.76,114,186,300,17,19,22,84,165,514
1993,Mark Acres,C,30,HOU,6,0,23,2,9,0.222,1,2,0.5,1,7,0.143,0.278,1,2,0.5,2,4,6,0,0,0,2,2,6
1993,Mark Acres,C,30,WSB,12,7,246,24,40,0.6,0,0,NA,24,40,0.6,0.6,10,14,0.714,24,37,61,5,3,6,11,32,58
1993,Kenny Anderson,PG,22,NJN,55,55,2010,370,850,0.435,7,25,0.28,363,825,0.44,0.439,180,232,0.776,51,175,226,449,96,11,153,140,927
1993,Ron Anderson,SF,34,PHI,69,0,1263,225,544,0.414,39,120,0.325,186,424,0.439,0.449,72,89,0.809,62,122,184,93,31,5,63,75,561
1993,Willie Anderson,SG,26,SAS,38,7,560,80,186,0.43,1,8,0.125,79,178,0.444,0.433,22,28,0.786,7,50,57,79,14,6,44,52,183
1993,Greg Anthony,PG,25,NYK,70,35,1699,174,419,0.415,4,30,0.133,170,389,0.437,0.42,107,159,0.673,42,128,170,398,113,12,104,141,459
1993,B.J. Armstrong,PG,25,CHI,82,74,2492,408,818,0.499,63,139,0.453,345,679,0.508,0.537,130,151,0.861,27,122,149,330,66,6,83,169,1009
1993,Vincent Askew,SG,26,SAC,9,0,76,8,17,0.471,0,0,NA,8,17,0.471,0.471,11,15,0.733,7,4,11,5,2,1,8,11,27
1993,Vincent Askew,SG,26,SEA,64,4,1053,144,292,0.493,2,6,0.333,142,286,0.497,0.497,94,134,0.701,55,95,150,117,38,18,61,124,384
1993,Stacey Augmon,SG,24,ATL,73,66,2112,397,792,0.501,0,4,0,397,788,0.504,0.501,227,307,0.739,141,146,287,170,91,18,157,141,1021
1993,Isaac Austin,C,23,UTA,46,3,306,50,112,0.446,0,1,0,50,111,0.45,0.446,29,44,0.659,38,41,79,6,8,14,23,60,129
1993,Anthony Avent,PF,23,MIL,82,78,2285,347,802,0.433,0,2,0,347,800,0.434,0.433,112,172,0.651,180,332,512,91,57,73,140,237,806
1993,Thurl Bailey,PF,31,MIN,70,3,1276,203,446,0.455,0,0,NA,203,446,0.455,0.455,119,142,0.838,53,162,215,61,20,47,60,88,525
1993,Jon Barry,SG,23,MIL,47,0,552,76,206,0.369,21,63,0.333,55,143,0.385,0.42,33,49,0.673,10,33,43,68,35,3,42,57,206
1993,Kenny Battle,SG,28,BOS,3,1,29,6,13,0.462,0,1,0,6,12,0.5,0.462,2,2,1,7,4,11,2,1,0,2,2,14
1993,Benoit Benjamin,C,28,SEA,31,6,448,81,163,0.497,0,0,NA,81,163,0.497,0.497,47,67,0.701,27,86,113,12,17,35,42,73,209
1993,Benoit Benjamin,C,28,LAL,28,0,306,52,108,0.481,0,0,NA,52,108,0.481,0.481,22,37,0.595,24,72,96,10,14,13,36,61,126
1993,David Benoit,SF,24,UTA,82,27,1712,258,592,0.436,34,98,0.347,224,494,0.453,0.465,114,152,0.75,116,276,392,43,45,43,90,201,664
1993,Muggsy Bogues,PG,28,CHH,81,80,2833,331,730,0.453,6,26,0.231,325,704,0.462,0.458,140,168,0.833,51,247,298,711,161,5,154,179,808
1993,Manute Bol,C,30,PHI,58,23,855,52,127,0.409,10,32,0.313,42,95,0.442,0.449,12,19,0.632,44,149,193,18,14,119,50,87,126
1993,Walter Bond,SG,23,DAL,74,38,1578,227,565,0.402,7,42,0.167,220,523,0.421,0.408,129,167,0.772,52,144,196,122,75,18,112,223,590
1993,Terrell Brandon,PG,22,CLE,82,8,1622,297,621,0.478,13,42,0.31,284,579,0.491,0.489,118,143,0.825,37,142,179,302,79,27,107,122,725
1993,Randy Breuer,C,32,ATL,12,0,107,15,31,0.484,0,0,NA,15,31,0.484,0.484,2,5,0.4,10,18,28,6,2,3,5,12,32
1993,Frank Brickowski,C,33,MIL,66,64,2075,456,836,0.545,8,26,0.308,448,810,0.553,0.55,195,268,0.728,120,285,405,196,80,44,202,235,1115
1993,Scott Brooks,PG,27,HOU,82,0,1516,183,385,0.475,41,99,0.414,142,286,0.497,0.529,112,135,0.83,22,77,99,243,79,3,72,136,519
1993,Chucky Brown,SF,24,NJN,77,20,1186,160,331,0.483,0,5,0,160,326,0.491,0.483,71,98,0.724,88,144,232,51,20,24,56,112,391
1993,Dee Brown,PG,24,BOS,80,48,2254,328,701,0.468,26,82,0.317,302,619,0.488,0.486,192,242,0.793,45,201,246,461,138,32,136,203,874
1993,Mark Bryant,C,27,POR,80,24,1396,186,370,0.503,0,1,0,186,369,0.504,0.503,104,148,0.703,132,192,324,41,37,23,65,226,476
1993,Jud Buechler,SF,24,GSW,70,9,1287,176,403,0.437,20,59,0.339,156,344,0.453,0.462,65,87,0.747,81,114,195,94,47,19,55,98,437
1993,Elden Campbell,PF,24,LAL,79,13,1551,238,520,0.458,0,3,0,238,517,0.46,0.458,130,204,0.637,127,205,332,48,59,100,69,165,606
1993,Tony Campbell,SF,30,NYK,58,13,1062,194,396,0.49,2,5,0.4,192,391,0.491,0.492,59,87,0.678,59,96,155,62,34,5,51,150,449
1993,Antoine Carr,PF,31,SAS,71,46,1947,379,705,0.538,0,5,0,379,700,0.541,0.538,174,224,0.777,107,281,388,97,35,87,96,264,932
1993,Cedric Ceballos,SF,23,PHO,74,46,1607,381,662,0.576,0,2,0,381,660,0.577,0.576,187,258,0.725,172,236,408,77,54,28,106,103,949
1993,Rex Chapman,SG,25,WSB,60,23,1300,287,602,0.477,43,116,0.371,244,486,0.502,0.512,132,163,0.81,19,69,88,116,38,10,79,119,749
1993,Maurice Cheeks,PG,36,NJN,35,0,510,51,93,0.548,0,2,0,51,91,0.56,0.548,24,27,0.889,5,37,42,107,33,2,33,35,126
1993,Pete Chilcutt,PF,24,SAC,59,9,834,165,340,0.485,0,0,NA,165,340,0.485,0.485,32,46,0.696,80,114,194,64,22,21,54,102,362
1993,Doug Christie,SG,22,LAL,23,0,332,45,106,0.425,2,12,0.167,43,94,0.457,0.434,50,66,0.758,24,27,51,53,22,5,50,53,142
1993,Bimbo Coles,PG,24,MIA,81,37,2232,318,686,0.464,42,137,0.307,276,549,0.503,0.494,177,220,0.805,58,108,166,373,80,11,108,199,855
1993,Marty Conlon,C,25,SAC,46,0,467,81,171,0.474,0,4,0,81,167,0.485,0.474,57,81,0.704,48,75,123,37,13,5,28,43,219
1993,Lester Conner,PG,33,LAC,31,0,422,28,62,0.452,0,0,NA,28,62,0.452,0.452,18,19,0.947,16,33,49,65,34,4,21,39,74
1993,Tyrone Corbin,SF,30,UTA,82,58,2555,385,766,0.503,0,5,0,385,761,0.506,0.503,180,218,0.826,194,325,519,173,108,32,108,252,950
1993,Chris Corchiani,PG,24,ORL,9,0,102,13,23,0.565,0,3,0,13,20,0.65,0.565,16,21,0.762,1,6,7,16,6,0,8,17,42
1993,Chris Corchiani,PG,24,WSB,1,0,3,1,1,1,0,0,NA,1,1,1,1,0,0,NA,0,0,0,0,0,0,0,1,2
1993,Joe Courtney,PF,23,CHI,5,0,34,4,9,0.444,0,0,NA,4,9,0.444,0.444,3,4,0.75,2,0,2,1,2,1,3,9,11
1993,Joe Courtney,PF,23,GSW,7,0,70,9,23,0.391,0,0,NA,9,23,0.391,0.391,4,5,0.8,2,15,17,2,3,4,3,8,22
1993,John Crotty,PG,23,UTA,40,0,243,37,72,0.514,2,14,0.143,35,58,0.603,0.528,26,38,0.684,4,13,17,55,11,0,30,29,102
1993,Terry Cummings,PF,31,SAS,8,0,76,11,29,0.379,0,0,NA,11,29,0.379,0.379,5,10,0.5,6,13,19,4,1,1,2,17,27
1993,Lloyd Daniels,SG,25,SAS,77,10,1573,285,644,0.443,59,177,0.333,226,467,0.484,0.488,72,99,0.727,86,130,216,148,38,30,102,144,701
1993,Dale Davis,PF,23,IND,82,82,2264,304,535,0.568,0,0,NA,304,535,0.568,0.568,119,225,0.529,291,432,723,69,63,148,79,274,727
1993,Hubert Davis,SG,22,NYK,50,2,815,110,251,0.438,6,19,0.316,104,232,0.448,0.45,43,54,0.796,13,43,56,83,22,4,45,71,269
1993,Todd Day,SG,23,MIL,71,37,1931,358,828,0.432,54,184,0.293,304,644,0.472,0.465,213,297,0.717,144,147,291,117,75,48,118,222,983
1993,Vinny Del Negro,PG,26,SAS,73,31,1526,218,430,0.507,6,24,0.25,212,406,0.522,0.514,101,117,0.863,19,144,163,291,44,1,92,146,543
1993,James Donaldson,C,35,UTA,6,1,94,8,14,0.571,0,0,NA,8,14,0.571,0.571,5,9,0.556,6,23,29,1,1,7,4,13,21
1993,Sherman Douglas,PG,26,BOS,79,36,1932,264,530,0.498,6,29,0.207,258,501,0.515,0.504,84,150,0.56,65,97,162,508,49,10,161,166,618
1993,Clyde Drexler,SG,30,POR,49,49,1671,350,816,0.429,31,133,0.233,319,683,0.467,0.448,245,292,0.839,126,183,309,278,95,37,115,159,976
1993,Chris Dudley,C,27,NJN,71,16,1398,94,266,0.353,0,0,NA,94,266,0.353,0.353,57,110,0.518,215,298,513,16,17,103,54,195,245
1993,Blue Edwards,SF,27,MIL,82,81,2729,554,1083,0.512,37,106,0.349,517,977,0.529,0.529,237,300,0.79,123,259,382,214,129,45,175,242,1382
1993,Kevin Edwards,SG,27,MIA,40,30,1134,216,462,0.468,5,17,0.294,211,445,0.474,0.473,119,141,0.844,48,73,121,120,68,12,75,69,556
1993,Mario Elie,SF,29,POR,82,7,1757,240,524,0.458,45,129,0.349,195,395,0.494,0.501,183,214,0.855,59,157,216,177,74,20,89,145,708
1993,Dale Ellis,SG,32,SAS,82,76,2731,545,1092,0.499,119,297,0.401,426,795,0.536,0.554,157,197,0.797,81,231,312,107,78,18,111,179,1366
1993,Greg Foster,PF,24,WSB,10,0,93,11,25,0.44,0,0,NA,11,25,0.44,0.44,2,3,0.667,8,19,27,11,0,5,9,17,24
1993,Greg Foster,PF,24,ATL,33,0,205,44,95,0.463,0,4,0,44,91,0.484,0.463,13,18,0.722,24,32,56,10,3,9,16,41,101
1993,Kevin Gamble,SF,27,BOS,82,58,2541,459,906,0.507,52,139,0.374,407,767,0.531,0.535,123,149,0.826,46,200,246,226,86,37,81,185,1093
1993,Winston Garland,PG,28,HOU,66,4,1004,152,343,0.443,6,13,0.462,146,330,0.442,0.452,81,89,0.91,32,76,108,138,39,4,67,116,391
1993,Chris Gatling,PF,25,GSW,70,11,1248,249,462,0.539,0,6,0,249,456,0.546,0.539,150,207,0.725,129,191,320,40,44,53,102,197,648
1993,Kendall Gill,SG,24,CHH,69,67,2430,463,1032,0.449,17,62,0.274,446,970,0.46,0.457,224,290,0.772,120,220,340,268,98,36,174,191,1167
1993,Armen Gilliam,PF,28,PHI,80,26,1742,359,774,0.464,0,1,0,359,773,0.464,0.464,274,325,0.843,136,336,472,116,37,54,157,123,992
1993,Gerald Glass,SF,25,MIN,4,0,71,8,27,0.296,0,2,0,8,25,0.32,0.296,4,6,0.667,1,2,3,9,3,0,5,6,20
1993,Gerald Glass,SF,25,DET,56,5,777,134,312,0.429,7,31,0.226,127,281,0.452,0.441,21,33,0.636,60,79,139,68,30,18,30,98,296
1993,Mike Gminski,C,33,CHH,34,0,251,42,83,0.506,0,0,NA,42,83,0.506,0.506,9,10,0.9,34,51,85,7,1,9,11,28,93
1993,Greg Grant,PG,26,PHI,72,0,996,77,220,0.35,20,68,0.294,57,152,0.375,0.395,20,31,0.645,24,43,67,206,43,1,54,73,194
1993,Jeff Grayer,SG,27,GSW,48,12,1025,165,353,0.467,2,14,0.143,163,339,0.481,0.47,91,136,0.669,71,86,157,70,31,8,54,120,423
1993,A.C. Green,PF,29,LAL,82,55,2819,379,706,0.537,16,46,0.348,363,660,0.55,0.548,277,375,0.739,287,424,711,116,88,39,116,149,1051
1993,Sean Green,SG,22,IND,13,0,81,28,55,0.509,3,10,0.3,25,45,0.556,0.536,3,4,0.75,4,5,9,7,2,1,9,11,62
1993,Sidney Green,PF,32,SAS,15,0,202,20,49,0.408,0,0,NA,20,49,0.408,0.408,13,15,0.867,18,53,71,19,5,3,12,21,53
1993,Sidney Green,PF,32,CHH,24,0,127,14,40,0.35,0,2,0,14,38,0.368,0.35,12,16,0.75,14,33,47,5,1,2,8,16,40
1993,Tom Gugliotta,PF,23,WSB,81,81,2795,484,1135,0.426,38,135,0.281,446,1000,0.446,0.443,181,281,0.644,219,562,781,306,134,35,230,195,1187
1993,Tom Hammonds,PF,25,CHH,19,5,142,19,45,0.422,0,0,NA,19,45,0.422,0.422,5,8,0.625,5,26,31,8,0,4,3,20,43
1993,Tom Hammonds,PF,25,DEN,35,0,571,86,176,0.489,0,1,0,86,175,0.491,0.489,33,54,0.611,33,63,96,16,18,8,31,57,205
1993,Tim Hardaway,PG,26,GSW,66,66,2609,522,1168,0.447,102,309,0.33,420,859,0.489,0.491,273,367,0.744,60,203,263,699,116,12,220,152,1419
1993,Derek Harper,SG,31,DAL,62,60,2108,393,939,0.419,101,257,0.393,292,682,0.428,0.472,239,316,0.756,42,81,123,334,80,16,136,145,1126
1993,Ron Harper,SG,29,LAC,80,77,2970,542,1203,0.451,52,186,0.28,490,1017,0.482,0.472,307,399,0.769,117,308,425,360,177,73,222,212,1443
1993,Carl Herrera,PF,26,HOU,81,12,1800,240,444,0.541,0,2,0,240,442,0.543,0.541,125,176,0.71,148,306,454,61,47,35,92,190,605
1993,Sean Higgins,SF,24,GSW,29,4,591,96,215,0.447,13,37,0.351,83,178,0.466,0.477,35,47,0.745,23,45,68,66,13,5,64,54,240
1993,Tyrone Hill,C,24,GSW,74,66,2070,251,494,0.508,0,4,0,251,490,0.512,0.508,138,221,0.624,255,499,754,68,41,40,92,320,640
1993,Donald Hodge,C,23,DAL,79,8,1267,161,400,0.403,0,0,NA,161,400,0.403,0.403,71,104,0.683,93,201,294,75,33,37,90,204,393
1993,Dave Hoppen,C,28,NJN,2,0,10,1,1,1,0,0,NA,1,1,1,1,0,2,0,1,3,4,0,0,0,0,2,2
1993,Jeff Hornacek,PG,29,PHI,79,78,2860,582,1239,0.47,97,249,0.39,485,990,0.49,0.509,250,289,0.865,84,258,342,548,131,21,222,203,1511
1993,Robert Horry,SF,22,HOU,79,79,2330,323,682,0.474,12,47,0.255,311,635,0.49,0.482,143,200,0.715,113,279,392,191,80,83,156,210,801
1993,Stephen Howard,SF,22,UTA,49,0,260,35,93,0.376,0,0,NA,35,93,0.376,0.376,34,53,0.642,26,34,60,10,15,12,23,58,104
1993,Jay Humphries,SG,30,UTA,78,20,2034,287,659,0.436,15,75,0.2,272,584,0.466,0.447,101,130,0.777,40,103,143,317,101,11,132,236,690
1993,Jim Jackson,SF,22,DAL,28,28,938,184,466,0.395,21,73,0.288,163,393,0.415,0.417,68,92,0.739,42,80,122,131,40,11,115,80,457
1993,Mark Jackson,PG,27,LAC,82,81,3117,459,945,0.486,22,82,0.268,437,863,0.506,0.497,241,300,0.803,129,259,388,724,136,12,220,158,1181
1993,Henry James,PF,27,SAC,8,0,79,20,45,0.444,3,10,0.3,17,35,0.486,0.478,17,20,0.85,6,4,10,1,3,0,7,9,60
1993,Henry James,PF,27,UTA,2,0,9,1,6,0.167,0,3,0,1,3,0.333,0.167,5,6,0.833,1,0,1,0,0,0,0,0,7
1993,Avery Johnson,PG,27,SAS,75,49,2030,256,510,0.502,0,8,0,256,502,0.51,0.502,144,182,0.791,20,126,146,561,85,16,145,141,656
1993,Eddie Johnson,SF,33,SEA,82,0,1869,463,991,0.467,17,56,0.304,446,935,0.477,0.476,234,257,0.911,124,148,272,135,36,4,134,173,1177
1993,Tim Kempton,PF,29,PHO,30,0,167,19,48,0.396,0,0,NA,19,48,0.396,0.396,18,31,0.581,12,27,39,19,4,4,16,30,56
1993,Steve Kerr,PG,27,CLE,5,0,41,5,10,0.5,0,2,0,5,8,0.625,0.5,2,2,1,0,7,7,11,2,0,2,2,12
1993,Steve Kerr,SG,27,ORL,47,0,440,48,112,0.429,6,24,0.25,42,88,0.477,0.455,20,22,0.909,5,33,38,59,8,1,25,34,122
1993,Stacey King,C,26,CHI,76,3,1059,160,340,0.471,2,6,0.333,158,334,0.473,0.474,86,122,0.705,105,102,207,71,26,20,70,128,408
1993,Greg Kite,C,31,ORL,64,1,640,38,84,0.452,0,1,0,38,83,0.458,0.452,13,24,0.542,66,127,193,10,13,12,35,133,89
1993,Joe Kleine,C,31,BOS,78,3,1129,108,267,0.404,0,6,0,108,261,0.414,0.404,41,58,0.707,113,233,346,39,17,17,37,123,257
1993,Negele Knight,PG,25,PHO,52,35,888,124,317,0.391,0,7,0,124,310,0.4,0.391,67,86,0.779,28,36,64,145,23,4,73,66,315
1993,Christian Laettner,PF,23,MIN,81,81,2823,503,1061,0.474,4,40,0.1,499,1021,0.489,0.476,462,553,0.835,171,537,708,223,105,83,275,290,1472
1993,Jerome Lane,PF,26,CLE,21,2,149,27,54,0.5,0,0,NA,27,54,0.5,0.5,5,20,0.25,24,29,53,17,12,3,7,32,59
1993,Andrew Lang,C,26,PHI,73,59,1861,149,351,0.425,1,5,0.2,148,346,0.428,0.426,87,114,0.763,136,300,436,79,46,141,89,261,386
1993,Tim Legler,SG,26,UTA,3,0,5,1,3,0.333,0,0,NA,1,3,0.333,0.333,0,0,NA,0,1,1,0,0,0,0,0,2
1993,Tim Legler,SG,26,DAL,30,0,630,104,238,0.437,22,65,0.338,82,173,0.474,0.483,57,71,0.803,25,33,58,46,24,6,28,63,287
1993,Jim Les,PG,29,SAC,73,0,881,110,259,0.425,66,154,0.429,44,105,0.419,0.552,42,50,0.84,20,69,89,169,40,7,48,81,328
1993,Marcus Liberty,SF,24,DEN,78,32,1585,252,620,0.406,22,59,0.373,230,561,0.41,0.424,102,156,0.654,131,204,335,105,64,21,79,143,628
1993,Todd Lichti,SG,26,DEN,48,12,752,124,276,0.449,2,6,0.333,122,270,0.452,0.453,81,102,0.794,35,67,102,52,28,11,49,60,331
1993,Alton Lister,C,34,GSW,20,9,174,19,42,0.452,0,0,NA,19,42,0.452,0.452,7,13,0.538,15,29,44,5,0,9,18,40,45
1993,Brad Lohaus,PF,28,MIL,80,24,1766,283,614,0.461,85,230,0.37,198,384,0.516,0.53,73,101,0.723,59,217,276,127,47,74,93,178,724
1993,Grant Long,PF,26,MIA,76,62,2728,397,847,0.469,6,26,0.231,391,821,0.476,0.472,261,341,0.765,197,371,568,182,104,31,133,264,1061
1993,Luc Longley,C,24,MIN,55,25,1045,133,292,0.455,0,0,NA,133,292,0.455,0.455,53,74,0.716,71,169,240,51,47,77,88,169,319
1993,Sam Mack,SF,22,SAS,40,0,267,47,118,0.398,3,22,0.136,44,96,0.458,0.411,45,58,0.776,18,30,48,15,14,5,22,44,142
1993,Mark Macon,PG,23,DEN,48,27,1141,158,381,0.415,0,6,0,158,375,0.421,0.415,42,60,0.7,33,70,103,126,69,3,72,135,358
1993,Jeff Malone,SG,31,UTA,79,59,2558,595,1205,0.494,3,9,0.333,592,1196,0.495,0.495,236,277,0.852,31,142,173,128,42,4,125,117,1429
1993,Danny Manning,PF,26,LAC,79,77,2761,702,1379,0.509,8,30,0.267,694,1349,0.514,0.512,388,484,0.802,198,322,520,207,108,101,230,323,1800
1993,Vernon Maxwell,SG,27,HOU,71,68,2251,349,858,0.407,120,361,0.332,229,497,0.461,0.477,164,228,0.719,29,192,221,297,86,8,140,124,982
1993,George McCloud,SF,25,IND,78,21,1500,216,525,0.411,58,181,0.32,158,344,0.459,0.467,75,102,0.735,60,145,205,192,53,11,107,165,565
1993,Xavier McDaniel,PF,29,BOS,82,27,2215,457,924,0.495,6,22,0.273,451,902,0.5,0.498,191,241,0.793,168,321,489,163,72,51,171,249,1111
1993,Oliver Miller,C,22,PHO,56,1,1069,121,255,0.475,0,3,0,121,252,0.48,0.475,71,100,0.71,70,205,275,118,38,100,108,145,313
1993,Terry Mills,PF,25,DET,81,46,2183,494,1072,0.461,10,36,0.278,484,1036,0.467,0.465,201,254,0.791,176,296,472,111,44,50,142,282,1199
1993,Alonzo Mourning,C,22,CHH,78,78,2644,572,1119,0.511,0,3,0,572,1116,0.513,0.511,495,634,0.781,263,542,805,76,27,271,236,286,1639
1993,Eric Murdock,PG,24,MIL,79,78,2437,438,936,0.468,31,119,0.261,407,817,0.498,0.485,231,296,0.78,95,189,284,603,174,7,207,177,1138
1993,Tracy Murray,SF,21,POR,48,14,495,108,260,0.415,21,70,0.3,87,190,0.458,0.456,35,40,0.875,40,43,83,11,8,5,31,59,272
1993,Dikembe Mutombo,C,26,DEN,82,82,3029,398,781,0.51,0,0,NA,398,781,0.51,0.51,335,492,0.681,344,726,1070,147,43,287,216,284,1131
1993,Ed Nealy,PF,32,GSW,30,4,229,16,46,0.348,7,22,0.318,9,24,0.375,0.424,7,10,0.7,8,40,48,13,9,1,5,35,46
1993,Ed Nealy,PF,32,CHI,11,0,79,10,23,0.435,1,5,0.2,9,18,0.5,0.457,2,2,1,4,12,16,2,3,1,2,6,23
1993,Johnny Newman,SF,29,CHH,64,27,1471,279,534,0.522,12,45,0.267,267,489,0.546,0.534,194,240,0.808,72,71,143,117,45,19,90,154,764
1993,Shaquille O'Neal,C,20,ORL,81,81,3071,733,1304,0.562,0,2,0,733,1302,0.563,0.562,427,721,0.592,342,780,1122,152,60,286,307,321,1893
1993,Dan O'Sullivan,C,24,NJN,3,0,10,2,3,0.667,0,0,NA,2,3,0.667,0.667,0,0,NA,2,2,4,0,0,0,0,1,4
1993,Dan O'Sullivan,C,24,MIL,3,0,7,1,2,0.5,0,0,NA,1,2,0.5,0.5,3,4,0.75,0,2,2,1,1,0,0,3,5
1993,Alan Ogg,C,25,MIL,3,0,26,3,9,0.333,0,0,NA,3,9,0.333,0.333,2,2,1,1,5,6,4,1,3,3,6,8
1993,Alan Ogg,C,25,WSB,3,0,3,2,4,0.5,0,0,NA,2,4,0.5,0.5,1,2,0.5,2,2,4,0,0,0,0,0,5
1993,Doug Overton,PG,23,WSB,45,13,990,152,323,0.471,3,13,0.231,149,310,0.481,0.475,59,81,0.728,25,81,106,157,31,6,72,81,366
1993,Billy Owens,PF,23,GSW,37,37,1201,247,493,0.501,1,11,0.091,246,482,0.51,0.502,117,183,0.639,108,156,264,144,35,28,106,105,612
1993,Robert Pack,PG,23,DEN,77,1,1579,285,606,0.47,1,8,0.125,284,598,0.475,0.471,239,311,0.768,52,108,160,335,81,10,185,182,810
1993,Gerald Paddio,SF,27,SEA,41,3,307,71,159,0.447,2,8,0.25,69,151,0.457,0.453,14,21,0.667,17,33,50,33,14,6,16,24,158
1993,Gary Payton,PG,24,SEA,82,78,2548,476,963,0.494,7,34,0.206,469,929,0.505,0.498,151,196,0.77,95,186,281,399,177,21,148,250,1110
1993,Anthony Peeler,SG,23,LAL,77,11,1656,297,634,0.468,46,118,0.39,251,516,0.486,0.505,162,206,0.786,64,115,179,166,60,14,123,193,802
1993,Sam Perkins,PF,31,LAL,49,49,1589,242,527,0.459,5,29,0.172,237,498,0.476,0.464,184,222,0.829,111,268,379,128,40,51,76,139,673
1993,Sam Perkins,PF,31,SEA,30,13,762,139,272,0.511,19,42,0.452,120,230,0.522,0.546,66,83,0.795,52,93,145,28,20,31,32,86,363
1993,Tim Perry,PF,27,PHI,81,51,2104,287,613,0.468,10,49,0.204,277,564,0.491,0.476,147,207,0.71,154,255,409,126,40,91,123,159,731
1993,Dražen Petrović,SG,28,NJN,70,67,2660,587,1134,0.518,75,167,0.449,512,967,0.529,0.551,315,362,0.87,42,148,190,247,94,13,204,237,1564
1993,Ricky Pierce,SG,33,SEA,77,72,2218,524,1071,0.489,42,113,0.372,482,958,0.503,0.509,313,352,0.889,58,134,192,220,100,7,160,167,1403
1993,Ed Pinckney,PF,29,BOS,7,5,151,10,24,0.417,0,0,NA,10,24,0.417,0.417,12,13,0.923,14,29,43,1,4,7,8,13,32
1993,Olden Polynice,C,28,DET,67,18,1299,210,429,0.49,0,1,0,210,428,0.491,0.49,66,142,0.465,181,237,418,29,31,21,54,126,486
1993,Kurt Rambis,PF,34,PHO,5,0,41,4,7,0.571,0,0,NA,4,7,0.571,0.571,1,2,0.5,2,4,6,1,3,0,6,3,9
1993,Kurt Rambis,PF,34,SAC,67,1,781,63,122,0.516,0,2,0,63,120,0.525,0.516,42,63,0.667,75,146,221,52,40,18,36,119,168
1993,Mark Randall,PF,25,MIN,2,0,8,0,1,0,0,1,0,0,0,NA,0,0,0,NA,0,0,0,1,0,0,1,1,0
1993,Mark Randall,PF,25,DET,35,0,240,40,79,0.506,1,7,0.143,39,72,0.542,0.513,16,26,0.615,27,28,55,10,4,2,16,32,97
1993,J.R. Reid,PF,24,CHH,17,1,295,42,98,0.429,0,1,0,42,97,0.433,0.429,43,58,0.741,20,50,70,24,11,5,24,49,127
1993,J.R. Reid,PF,24,SAS,66,24,1592,241,497,0.485,0,4,0,241,493,0.489,0.485,171,222,0.77,100,286,386,56,36,26,101,217,653
1993,Doc Rivers,PG,31,NYK,77,45,1886,216,494,0.437,39,123,0.317,177,371,0.477,0.477,133,162,0.821,26,166,192,405,123,9,114,215,604
1993,Alvin Robertson,SG,30,MIL,39,32,1065,139,290,0.479,17,55,0.309,122,235,0.519,0.509,44,70,0.629,47,90,137,156,90,9,77,120,339
1993,Alvin Robertson,SG,30,DET,30,22,941,108,249,0.434,23,67,0.343,85,182,0.467,0.48,40,58,0.69,60,72,132,107,65,9,56,98,279
1993,Clifford Robinson,PF,26,POR,82,12,2575,632,1336,0.473,19,77,0.247,613,1259,0.487,0.48,287,416,0.69,165,377,542,182,98,163,173,287,1570
1993,Larry Robinson,SG,25,WSB,4,0,33,6,16,0.375,0,1,0,6,15,0.4,0.375,3,5,0.6,1,2,3,3,1,1,1,0,15
1993,Rumeal Robinson,PG,26,NJN,80,28,1585,270,638,0.423,20,56,0.357,250,582,0.43,0.439,112,195,0.574,49,110,159,323,96,12,140,169,672
1993,Sean Rooks,C,23,DAL,72,68,2087,368,747,0.493,0,2,0,368,745,0.494,0.493,234,389,0.602,196,340,536,95,38,81,160,204,970
1993,Donald Royal,SF,26,ORL,77,0,1636,194,391,0.496,0,3,0,194,388,0.5,0.496,318,390,0.815,116,179,295,80,36,25,113,179,706
1993,John Salley,PF,28,MIA,51,34,1422,154,307,0.502,0,0,NA,154,307,0.502,0.502,115,144,0.799,113,200,313,83,32,70,101,192,423
1993,Mike Sanders,SF,32,CLE,53,51,1189,197,396,0.497,1,4,0.25,196,392,0.5,0.499,59,78,0.756,52,118,170,75,39,30,57,150,454
1993,Danny Schayes,C,33,MIL,70,7,1124,105,263,0.399,0,3,0,105,260,0.404,0.399,112,137,0.818,72,177,249,78,36,36,65,148,322
1993,Steve Scheffler,C,25,SEA,29,5,166,25,48,0.521,0,0,NA,25,48,0.521,0.521,16,24,0.667,15,21,36,5,6,1,5,37,66
1993,Dennis Scott,SF,24,ORL,54,43,1759,329,763,0.431,108,268,0.403,221,495,0.446,0.502,92,117,0.786,38,148,186,136,57,18,104,131,858
1993,Rony Seikaly,C,27,MIA,72,64,2456,417,868,0.48,1,8,0.125,416,860,0.484,0.481,397,540,0.735,259,587,846,100,38,83,203,260,1232
1993,Brad Sellers,PF,30,MIN,54,4,533,49,130,0.377,0,1,0,49,129,0.38,0.377,37,39,0.949,27,56,83,46,6,11,27,40,135
1993,Brian Shaw,PG,26,MIA,68,45,1603,197,501,0.393,43,130,0.331,154,371,0.415,0.436,61,78,0.782,70,187,257,235,48,19,96,163,498
1993,Charles Smith,SF,27,NYK,81,68,2172,358,764,0.469,0,2,0,358,762,0.47,0.469,287,367,0.782,170,262,432,142,48,96,155,254,1003
1993,Kenny Smith,PG,27,HOU,82,82,2422,387,744,0.52,96,219,0.438,291,525,0.554,0.585,195,222,0.878,28,132,160,446,80,7,163,110,1065
1993,LaBradford Smith,SG,23,WSB,69,33,1546,261,570,0.458,8,23,0.348,253,547,0.463,0.465,109,127,0.858,26,80,106,186,58,9,103,178,639
1993,Steve Smith,SG,23,MIA,48,43,1610,279,619,0.451,53,132,0.402,226,487,0.464,0.494,155,197,0.787,56,141,197,267,50,16,129,148,766
1993,Tony Smith,SG,24,LAL,55,9,752,133,275,0.484,2,11,0.182,131,264,0.496,0.487,62,82,0.756,46,41,87,63,50,7,40,72,330
1993,Andre Spencer,SF,28,ATL,3,0,15,0,3,0,0,0,NA,0,3,0,0,0,0,NA,0,1,1,0,2,0,2,3,0
1993,Andre Spencer,SF,28,GSW,17,1,407,73,160,0.456,0,2,0,73,158,0.462,0.456,41,54,0.759,38,42,80,24,15,7,24,61,187
1993,Elmore Spencer,C,23,LAC,44,4,280,44,82,0.537,0,0,NA,44,82,0.537,0.537,16,32,0.5,17,45,62,8,8,18,26,54,104
1993,Felton Spencer,C,25,MIN,71,48,1296,105,226,0.465,0,0,NA,105,226,0.465,0.465,83,127,0.654,134,190,324,17,23,66,70,243,293
1993,John Starks,SG,27,NYK,80,51,2477,513,1199,0.428,108,336,0.321,405,863,0.469,0.473,263,331,0.795,54,150,204,404,91,12,173,234,1397
1993,Alex Stivrins,PF,30,PHO,10,0,35,11,18,0.611,0,1,0,11,17,0.647,0.611,0,0,NA,2,6,8,1,1,1,5,7,22
1993,Alex Stivrins,SF,30,LAC,1,0,1,0,1,0,0,0,NA,0,1,0,0,0,0,NA,0,0,0,0,0,0,0,0,0
1993,Alex Stivrins,SF,30,MIL,3,0,25,4,11,0.364,0,0,NA,4,11,0.364,0.364,3,4,0.75,3,3,6,2,1,0,2,4,11
1993,Alex Stivrins,PF,30,ATL,5,0,15,4,9,0.444,0,1,0,4,8,0.5,0.444,0,0,NA,2,3,5,0,0,1,0,0,8
1993,Rod Strickland,SG,26,POR,78,35,2474,396,816,0.485,4,30,0.133,392,786,0.499,0.488,273,381,0.717,120,217,337,559,131,24,199,153,1069
1993,LaSalle Thompson,C,31,IND,63,0,730,104,213,0.488,0,1,0,104,212,0.491,0.488,29,39,0.744,55,123,178,34,29,24,47,137,237
1993,Otis Thorpe,PF,30,HOU,72,69,2357,385,690,0.558,0,2,0,385,688,0.56,0.558,153,256,0.598,219,370,589,181,43,19,151,234,923
1993,Loy Vaught,PF,24,LAC,79,4,1653,313,616,0.508,1,4,0.25,312,612,0.51,0.509,116,155,0.748,164,328,492,54,55,39,83,172,743
1993,Darrell Walker,SG,31,DET,9,2,144,3,19,0.158,0,1,0,3,18,0.167,0.158,2,6,0.333,4,15,19,9,10,0,13,12,8
1993,Darrell Walker,PG,31,CHI,28,0,367,31,77,0.403,0,0,NA,31,77,0.403,0.403,10,20,0.5,18,21,39,44,23,2,12,51,72
1993,Clarence Weatherspoon,SF,22,PHI,82,82,2654,494,1053,0.469,1,4,0.25,493,1049,0.47,0.47,291,408,0.713,179,410,589,147,85,67,176,188,1280
1993,Spud Webb,PG,29,SAC,69,68,2335,342,789,0.433,37,135,0.274,305,654,0.466,0.457,279,328,0.851,44,149,193,481,104,6,194,177,1000
1993,Morlon Wiley,PG,26,ATL,25,2,354,26,81,0.321,15,51,0.294,11,30,0.367,0.414,5,8,0.625,9,26,35,81,26,2,29,49,72
1993,Morlon Wiley,PG,26,DAL,33,13,641,70,173,0.405,39,103,0.379,31,70,0.443,0.517,12,18,0.667,20,36,56,100,39,1,51,78,191
1993,Dominique Wilkins,SF,33,ATL,71,70,2647,741,1584,0.468,120,316,0.38,621,1268,0.49,0.506,519,627,0.828,187,295,482,227,70,27,184,116,2121
1993,Herb Williams,C,34,NYK,55,0,571,72,175,0.411,0,0,NA,72,175,0.411,0.411,14,21,0.667,44,102,146,19,21,28,22,78,158
1993,Lorenzo Williams,C,23,CHH,2,0,18,1,3,0.333,0,0,NA,1,3,0.333,0.333,0,0,NA,3,6,9,0,0,2,2,4,2
1993,Lorenzo Williams,PF,23,ORL,3,0,10,0,2,0,0,0,NA,0,2,0,0,0,0,NA,1,1,2,0,1,1,0,2,0
1993,Lorenzo Williams,PF,23,BOS,22,7,151,16,31,0.516,0,0,NA,16,31,0.516,0.516,2,7,0.286,13,31,44,5,4,14,6,23,34
1993,Micheal Williams,PG,26,MIN,76,76,2661,353,791,0.446,26,107,0.243,327,684,0.478,0.463,419,462,0.907,84,189,273,661,165,23,227,268,1151
1993,Reggie Williams,SF,28,DEN,79,79,2722,535,1167,0.458,33,122,0.27,502,1045,0.48,0.473,238,296,0.804,132,296,428,295,126,76,194,284,1341
1993,Scott Williams,PF,24,CHI,71,5,1369,166,356,0.466,0,7,0,166,349,0.476,0.466,90,126,0.714,168,283,451,68,55,66,73,230,422
1993,Walt Williams,SF,22,SAC,59,26,1673,358,823,0.435,61,191,0.319,297,632,0.47,0.472,224,302,0.742,115,150,265,178,66,29,179,209,1001
1993,Kevin Willis,PF,30,ATL,80,80,2878,616,1218,0.506,7,29,0.241,609,1189,0.512,0.509,196,300,0.653,335,693,1028,165,68,41,213,264,1435
1993,Kennard Winchester,SG,26,HOU,39,0,340,61,139,0.439,4,19,0.211,57,120,0.475,0.453,17,22,0.773,17,32,49,13,10,10,15,40,143
1993,Joe Wolf,C,28,BOS,2,0,9,0,1,0,0,0,NA,0,1,0,0,1,2,0.5,1,2,3,0,0,1,2,2,1
1993,Joe Wolf,C,28,POR,21,0,156,20,43,0.465,0,1,0,20,42,0.476,0.465,12,14,0.857,13,32,45,5,7,0,5,22,52
1993,David Wood,PF,28,SAS,64,2,598,52,117,0.444,5,21,0.238,47,96,0.49,0.466,46,55,0.836,38,59,97,34,13,12,29,93,155
1993,Orlando Woolridge,SF,33,DET,50,47,1477,271,566,0.479,0,9,0,271,557,0.487,0.479,113,168,0.673,84,92,176,112,26,25,73,114,655
1993,Orlando Woolridge,SF,33,MIL,8,0,78,18,33,0.545,0,0,NA,18,33,0.545,0.545,7,9,0.778,3,6,9,3,1,2,6,8,43
1993,Howard Wright,PF,25,ORL,4,0,10,4,5,0.8,0,0,NA,4,5,0.8,0.8,0,2,0,1,1,2,0,0,0,0,0,8
1993,Danny Young,PG,30,DET,65,2,836,69,167,0.413,22,68,0.324,47,99,0.475,0.479,28,32,0.875,13,34,47,119,31,5,30,36,188
1994,Alaa Abdelnaby,PF,25,BOS,13,0,159,24,55,0.436,0,0,NA,24,55,0.436,0.436,16,25,0.64,12,34,46,3,2,3,17,20,64
1994,Gary Alexander,PF,24,MIA,4,0,12,1,2,0.5,0,0,NA,1,2,0.5,0.5,0,2,0,1,2,3,1,0,0,1,3,2
1994,Gary Alexander,PF,24,CLE,7,0,43,7,12,0.583,0,0,NA,7,12,0.583,0.583,3,7,0.429,6,6,12,1,3,0,7,7,17
1994,Greg Anderson,PF,29,DET,77,47,1624,201,370,0.543,1,3,0.333,200,367,0.545,0.545,88,154,0.571,183,388,571,51,55,68,94,234,491
1994,Kenny Anderson,PG,23,NJN,82,82,3135,576,1381,0.417,40,132,0.303,536,1249,0.429,0.432,346,423,0.818,89,233,322,784,158,15,266,201,1538
1994,Ron Anderson,SF,35,NJN,11,2,176,15,43,0.349,4,12,0.333,11,31,0.355,0.395,10,12,0.833,8,18,26,6,5,2,1,9,44
1994,Ron Anderson,SF,35,WSB,10,0,180,20,43,0.465,3,14,0.214,17,29,0.586,0.5,9,11,0.818,8,19,27,11,3,1,9,7,52
1994,Willie Anderson,SG,27,SAS,80,79,2488,394,837,0.471,22,68,0.324,372,769,0.484,0.484,145,171,0.848,68,174,242,347,71,46,153,187,955
1994,Greg Anthony,PG,26,NYK,80,36,1994,225,571,0.394,48,160,0.3,177,411,0.431,0.436,130,168,0.774,43,146,189,365,114,13,127,163,628
1994,B.J. Armstrong,PG,26,CHI,82,82,2770,479,1007,0.476,60,135,0.444,419,872,0.481,0.505,194,227,0.855,28,142,170,323,80,9,131,147,1212
1994,Vincent Askew,SG,27,SEA,80,3,1690,273,567,0.481,6,31,0.194,267,536,0.498,0.487,175,211,0.829,60,124,184,194,73,19,70,145,727
1994,Stacey Augmon,SG,25,ATL,82,82,2605,439,861,0.51,1,7,0.143,438,854,0.513,0.51,333,436,0.764,178,216,394,187,149,45,147,179,1212
1994,Isaac Austin,C,24,PHI,14,0,201,29,66,0.439,0,1,0,29,65,0.446,0.439,14,23,0.609,25,44,69,17,5,10,17,29,72
1994,Anthony Avent,PF,24,MIL,33,20,695,92,228,0.404,0,0,NA,92,228,0.404,0.404,61,79,0.772,60,94,154,33,16,20,43,60,245
1994,Anthony Avent,PF,24,ORL,41,20,676,58,170,0.341,0,0,NA,58,170,0.341,0.341,28,44,0.636,84,100,184,32,17,11,42,87,144
1994,Thurl Bailey,PF,32,MIN,79,3,1297,232,455,0.51,0,2,0,232,453,0.512,0.51,119,149,0.799,66,149,215,54,20,58,58,93,583
1994,Vin Baker,C,22,MIL,82,63,2560,435,869,0.501,1,5,0.2,434,864,0.502,0.501,234,411,0.569,277,344,621,163,60,114,162,231,1105
1994,Jon Barry,SG,24,MIL,72,7,1242,158,382,0.414,32,115,0.278,126,267,0.472,0.455,97,122,0.795,36,110,146,168,102,17,83,110,445
1994,Benoit Benjamin,C,29,NJN,77,74,1817,283,589,0.48,0,0,NA,283,589,0.48,0.48,152,214,0.71,135,364,499,44,35,90,97,198,718
1994,David Benoit,SF,25,UTA,55,18,1070,139,361,0.385,12,59,0.203,127,302,0.421,0.402,68,88,0.773,89,171,260,23,23,37,37,115,358
1994,Corie Blount,PF,25,CHI,67,8,690,76,174,0.437,0,0,NA,76,174,0.437,0.437,46,75,0.613,76,118,194,56,19,33,52,93,198
1994,Muggsy Bogues,PG,29,CHH,77,77,2746,354,751,0.471,2,12,0.167,352,739,0.476,0.473,125,155,0.806,78,235,313,780,133,2,171,147,835
1994,Manute Bol,C,31,MIA,8,0,61,1,12,0.083,0,3,0,1,9,0.111,0.083,0,0,NA,1,10,11,0,0,6,5,4,2
1994,Manute Bol,C,31,WSB,2,0,6,0,0,NA,0,0,NA,0,0,NA,NA,0,0,NA,0,1,1,1,0,1,0,1,0
1994,Manute Bol,C,31,PHI,4,0,49,3,7,0.429,0,0,NA,3,7,0.429,0.429,0,0,NA,2,4,6,0,2,9,0,8,6
1994,Walter Bond,SG,24,UTA,56,4,559,63,156,0.404,19,54,0.352,44,102,0.431,0.465,31,40,0.775,20,41,61,31,16,12,17,90,176
1994,Shawn Bradley,C,21,PHI,49,45,1385,201,491,0.409,0,3,0,201,488,0.412,0.409,102,168,0.607,98,208,306,98,45,147,148,170,504
1994,Terrell Brandon,PG,23,CLE,73,10,1548,230,548,0.42,7,32,0.219,223,516,0.432,0.426,139,162,0.858,38,121,159,277,84,16,111,108,606
1994,Randy Breuer,C,33,SAC,26,3,247,8,26,0.308,0,1,0,8,25,0.32,0.308,3,14,0.214,15,41,56,8,6,19,9,30,19
1994,Frank Brickowski,C,34,MIL,43,40,1441,251,521,0.482,3,18,0.167,248,503,0.493,0.485,148,191,0.775,53,226,279,165,52,16,125,165,653
1994,Frank Brickowski,C,34,CHH,28,6,653,117,233,0.502,1,2,0.5,116,231,0.502,0.504,47,63,0.746,32,93,125,57,28,11,56,77,282
1994,Scott Brooks,PG,28,HOU,73,0,1225,142,289,0.491,23,61,0.377,119,228,0.522,0.531,74,85,0.871,10,92,102,149,51,2,55,98,381
1994,Chucky Brown,SF,25,DAL,1,0,10,1,1,1,0,0,NA,1,1,1,1,1,1,1,0,1,1,0,0,0,0,2,3
1994,Dee Brown,SG,25,BOS,77,76,2867,490,1021,0.48,30,96,0.313,460,925,0.497,0.495,182,219,0.831,63,237,300,347,156,47,126,207,1192
1994,Mark Bryant,C,28,POR,79,10,1441,185,384,0.482,0,1,0,185,383,0.483,0.482,72,104,0.692,117,198,315,37,32,29,66,187,442
1994,Jud Buechler,SF,25,GSW,36,0,218,42,84,0.5,12,29,0.414,30,55,0.545,0.571,10,20,0.5,13,19,32,16,8,1,12,24,106
1994,Scott Burrell,SF,23,CHH,51,16,767,98,234,0.419,2,6,0.333,96,228,0.421,0.423,46,70,0.657,46,86,132,62,37,16,45,88,244
1994,Elden Campbell,PF,25,LAL,76,74,2253,373,808,0.462,0,2,0,373,806,0.463,0.462,188,273,0.689,167,352,519,86,64,146,98,241,934
1994,Tony Campbell,SF,31,NYK,22,11,379,63,128,0.492,1,3,0.333,62,125,0.496,0.496,30,37,0.811,28,32,60,31,20,1,29,59,157
1994,Tony Campbell,SF,31,DAL,41,3,835,164,384,0.427,6,25,0.24,158,359,0.44,0.435,64,83,0.771,48,78,126,51,30,14,55,75,398
1994,Antoine Carr,PF,32,SAS,34,0,465,78,160,0.488,0,1,0,78,159,0.491,0.488,42,58,0.724,12,39,51,15,9,22,15,75,198
1994,Sam Cassell,PG,24,HOU,66,6,1122,162,388,0.418,26,88,0.295,136,300,0.453,0.451,90,107,0.841,25,109,134,192,59,7,94,136,440
1994,Cedric Ceballos,SF,24,PHO,53,43,1602,425,795,0.535,0,9,0,425,786,0.541,0.535,160,221,0.724,153,191,344,91,59,23,93,124,1010
1994,Rex Chapman,SG,26,WSB,60,59,2025,431,865,0.498,64,165,0.388,367,700,0.524,0.535,168,206,0.816,57,89,146,185,59,8,117,83,1094
1994,Pete Chilcutt,PF,25,SAC,46,24,974,152,328,0.463,0,1,0,152,327,0.465,0.463,31,52,0.596,100,171,271,71,43,28,56,116,335
1994,Pete Chilcutt,PF,25,DET,30,0,391,51,120,0.425,3,14,0.214,48,106,0.453,0.438,10,13,0.769,29,71,100,15,10,11,18,48,115
1994,Doug Christie,SG,23,LAL,65,34,1515,244,562,0.434,39,119,0.328,205,443,0.463,0.469,145,208,0.697,93,142,235,136,89,28,140,186,672
1994,Bimbo Coles,PG,25,MIA,76,4,1726,233,519,0.449,20,99,0.202,213,420,0.507,0.468,102,131,0.779,50,109,159,263,75,12,107,132,588
1994,Marty Conlon,C,26,CHH,16,8,378,66,109,0.606,0,1,0,66,108,0.611,0.606,31,38,0.816,34,55,89,28,5,7,23,36,163
1994,Marty Conlon,C,26,WSB,14,1,201,29,56,0.518,0,1,0,29,55,0.527,0.518,12,15,0.8,19,31,50,6,4,1,10,33,70
1994,Lester Conner,PG,34,IND,11,0,169,14,38,0.368,0,3,0,14,35,0.4,0.368,3,6,0.5,10,14,24,31,14,1,9,12,31
1994,Anthony Cook,PF,26,ORL,2,0,2,0,1,0,0,0,NA,0,1,0,0,0,0,NA,0,0,0,0,0,2,1,0,0
1994,Anthony Cook,PF,26,MIL,23,0,201,26,53,0.491,0,1,0,26,52,0.5,0.491,10,25,0.4,20,36,56,4,3,12,11,22,62
1994,Tyrone Corbin,SF,31,UTA,82,17,2149,268,588,0.456,6,29,0.207,262,559,0.469,0.461,117,144,0.813,150,239,389,122,99,24,92,212,659
1994,Chris Corchiani,PG,25,BOS,51,0,467,40,94,0.426,11,38,0.289,29,56,0.518,0.484,26,38,0.684,8,36,44,86,22,2,38,47,117
1994,Joe Courtney,PF,24,PHO,33,1,168,40,78,0.513,0,0,NA,40,78,0.513,0.513,23,32,0.719,14,13,27,9,3,6,10,23,103
1994,Joe Courtney,PF,24,MIL,19,0,177,27,70,0.386,2,3,0.667,25,67,0.373,0.4,9,15,0.6,14,15,29,6,7,6,11,21,65
1994,John Crotty,PG,24,UTA,45,0,313,45,99,0.455,11,24,0.458,34,75,0.453,0.51,31,36,0.861,11,20,31,77,15,1,27,36,132
1994,Terry Cummings,PF,32,SAS,59,29,1133,183,428,0.428,0,2,0,183,426,0.43,0.428,63,107,0.589,132,165,297,50,31,13,59,137,429
1994,Michael Curry,SG,25,PHI,10,0,43,3,14,0.214,0,2,0,3,12,0.25,0.214,3,4,0.75,0,1,1,1,1,0,3,6,9
1994,Lloyd Daniels,SG,26,SAS,65,5,980,140,372,0.376,44,125,0.352,96,247,0.389,0.435,46,64,0.719,45,66,111,94,29,16,60,69,370
1994,Antonio Davis,PF,25,IND,81,4,1732,216,425,0.508,0,1,0,216,424,0.509,0.508,194,302,0.642,190,315,505,55,45,84,107,189,626
1994,Dale Davis,PF,24,IND,66,64,2292,308,582,0.529,0,1,0,308,581,0.53,0.529,155,294,0.527,280,438,718,100,48,106,102,214,771
1994,Hubert Davis,SG,23,NYK,56,27,1333,238,505,0.471,53,132,0.402,185,373,0.496,0.524,85,103,0.825,23,44,67,165,40,4,76,118,614
1994,Todd Day,SG,24,MIL,76,39,2127,351,845,0.415,33,148,0.223,318,697,0.456,0.435,231,331,0.698,115,195,310,138,103,52,129,221,966
1994,Terry Dehere,PG,22,LAC,64,6,759,129,342,0.377,23,57,0.404,106,285,0.372,0.411,61,81,0.753,25,43,68,78,28,3,61,69,342
1994,Vinny Del Negro,SG,27,SAS,77,56,1949,309,634,0.487,15,43,0.349,294,591,0.497,0.499,140,170,0.824,27,134,161,320,64,1,102,168,773
1994,Sherman Douglas,PG,27,BOS,78,78,2789,425,919,0.462,13,56,0.232,412,863,0.477,0.47,177,276,0.641,70,123,193,683,89,11,233,171,1040
1994,Clyde Drexler,SG,31,POR,68,68,2334,473,1105,0.428,71,219,0.324,402,886,0.454,0.46,286,368,0.777,154,291,445,333,98,34,167,202,1303
1994,Chris Dudley,C,28,POR,6,3,86,6,25,0.24,0,0,NA,6,25,0.24,0.24,2,4,0.5,16,8,24,5,4,3,2,18,14
1994,Acie Earl,C,23,BOS,74,8,1149,151,372,0.406,0,1,0,151,371,0.407,0.406,108,160,0.675,85,162,247,12,24,53,72,178,410
1994,Blue Edwards,SF,28,MIL,82,64,2322,382,800,0.478,38,106,0.358,344,694,0.496,0.501,151,189,0.799,104,225,329,171,83,27,146,235,953
1994,Kevin Edwards,SG,28,NJN,82,82,2727,471,1028,0.458,35,99,0.354,436,929,0.469,0.475,167,217,0.77,94,187,281,232,120,34,135,150,1144
1994,Mario Elie,SF,30,HOU,67,8,1606,208,466,0.446,56,167,0.335,152,299,0.508,0.506,154,179,0.86,28,153,181,208,50,8,109,124,626
1994,Dale Ellis,SF,33,SAS,77,75,2590,478,967,0.494,131,332,0.395,347,635,0.546,0.562,83,107,0.776,70,185,255,80,66,11,75,141,1170
1994,Jim Farmer,SG,29,DEN,4,0,29,2,6,0.333,0,2,0,2,4,0.5,0.333,0,0,NA,0,2,2,4,0,0,5,3,4
1994,Greg Foster,PF,25,MIL,3,0,19,4,7,0.571,0,0,NA,4,7,0.571,0.571,2,2,1,0,3,3,0,0,1,1,3,10
1994,Kevin Gamble,SF,28,BOS,75,28,1880,368,804,0.458,25,103,0.243,343,701,0.489,0.473,103,126,0.817,41,118,159,149,57,22,77,134,864
1994,Chris Gatling,C,26,GSW,82,23,1296,271,461,0.588,0,1,0,271,460,0.589,0.588,129,208,0.62,143,254,397,41,40,63,84,223,671
1994,Kendall Gill,SG,25,SEA,79,77,2435,429,969,0.443,38,120,0.317,391,849,0.461,0.462,215,275,0.782,91,177,268,275,151,32,143,194,1111
1994,Armen Gilliam,PF,29,NJN,82,5,1969,348,682,0.51,0,1,0,348,681,0.511,0.51,274,361,0.759,197,303,500,69,38,61,106,129,970
1994,Mike Gminski,C,34,CHH,21,6,255,31,79,0.392,0,0,NA,31,79,0.392,0.392,11,14,0.786,19,40,59,11,13,13,11,20,73
1994,Mike Gminski,C,34,MIL,8,1,54,5,24,0.208,0,0,NA,5,24,0.208,0.208,3,4,0.75,3,12,15,0,0,3,2,3,13
1994,Greg Graham,SG,23,PHI,70,6,889,122,305,0.4,2,25,0.08,120,280,0.429,0.403,92,110,0.836,21,65,86,66,61,4,65,54,338
1994,Jeff Grayer,SG,28,GSW,67,4,1096,191,363,0.526,2,12,0.167,189,351,0.538,0.529,71,118,0.602,76,115,191,62,33,13,63,103,455
1994,A.C. Green,PF,30,PHO,82,55,2825,465,926,0.502,8,35,0.229,457,891,0.513,0.506,266,362,0.735,275,478,753,137,70,38,100,142,1204
1994,Sean Green,SG,23,PHI,35,0,332,63,182,0.346,10,41,0.244,53,141,0.376,0.374,13,18,0.722,10,24,34,16,18,6,27,21,149
1994,Sean Green,SG,23,UTA,1,0,2,0,1,0,0,0,NA,0,1,0,0,0,0,NA,0,0,0,0,0,0,0,0,0
1994,Tom Gugliotta,PF,24,WSB,78,78,2795,540,1159,0.466,40,148,0.27,500,1011,0.495,0.483,213,311,0.685,189,539,728,276,172,51,247,174,1333
1994,Jack Haley,PF,30,SAS,28,0,94,21,48,0.438,0,0,NA,21,48,0.438,0.438,17,21,0.81,6,18,24,1,0,0,10,18,59
1994,Geert Hammink,C,24,ORL,1,0,3,1,3,0.333,0,0,NA,1,3,0.333,0.333,0,0,NA,1,0,1,1,0,0,0,1,2
1994,Tom Hammonds,PF,26,DEN,74,2,877,115,230,0.5,0,0,NA,115,230,0.5,0.5,71,104,0.683,62,137,199,34,20,12,41,91,301
1994,Anfernee Hardaway,PG,22,ORL,82,82,3015,509,1092,0.466,50,187,0.267,459,905,0.507,0.489,245,330,0.742,192,247,439,544,190,51,292,205,1313
1994,Derek Harper,PG,32,DAL,28,28,893,130,342,0.38,37,105,0.352,93,237,0.392,0.434,28,50,0.56,10,45,55,98,45,4,54,46,325
1994,Derek Harper,PG,32,NYK,54,27,1311,173,402,0.43,36,98,0.367,137,304,0.451,0.475,84,113,0.743,10,76,86,236,80,4,81,117,466
1994,Ron Harper,SG,30,LAC,75,75,2856,569,1335,0.426,71,236,0.301,498,1099,0.453,0.453,299,418,0.715,129,331,460,344,144,54,242,167,1508
1994,Antonio Harvey,PF,23,LAL,27,6,247,29,79,0.367,0,0,NA,29,79,0.367,0.367,12,26,0.462,26,33,59,5,8,19,17,39,70
1994,Carl Herrera,PF,27,HOU,75,0,1292,142,310,0.458,0,0,NA,142,310,0.458,0.458,69,97,0.711,101,184,285,37,32,26,69,159,353
1994,Tyrone Hill,PF,25,CLE,57,20,1447,216,398,0.543,0,2,0,216,396,0.545,0.543,171,256,0.668,184,315,499,46,53,35,78,193,603
1994,Donald Hodge,C,24,DAL,50,0,428,46,101,0.455,0,0,NA,46,101,0.455,0.455,44,52,0.846,46,49,95,32,15,13,30,66,136
1994,Jeff Hornacek,SG,30,PHI,53,53,1994,325,715,0.455,52,166,0.313,273,549,0.497,0.491,178,204,0.873,41,171,212,315,95,10,138,115,880
1994,Jeff Hornacek,SG,30,UTA,27,9,826,147,289,0.509,18,42,0.429,129,247,0.522,0.54,82,92,0.891,19,48,67,104,32,3,33,71,394
1994,Robert Horry,SF,23,HOU,81,81,2370,322,702,0.459,44,136,0.324,278,566,0.491,0.49,115,157,0.732,128,312,440,231,119,75,137,186,803
1994,Stephen Howard,SF,23,UTA,9,0,53,10,17,0.588,0,0,NA,10,17,0.588,0.588,11,16,0.688,10,6,16,1,1,3,6,13,31
1994,Jay Humphries,SG,31,UTA,75,19,1619,233,535,0.436,38,96,0.396,195,439,0.444,0.471,57,76,0.75,35,92,127,219,65,11,95,168,561
1994,Bobby Hurley,PG,22,SAC,19,19,499,54,146,0.37,2,16,0.125,52,130,0.4,0.377,24,30,0.8,6,28,34,115,13,1,48,28,134
1994,Jim Jackson,SG,23,DAL,82,82,3066,637,1432,0.445,17,60,0.283,620,1372,0.452,0.451,285,347,0.821,169,219,388,374,87,25,334,161,1576
1994,Mark Jackson,PG,28,LAC,79,79,2711,331,732,0.452,36,127,0.283,295,605,0.488,0.477,167,211,0.791,107,241,348,678,120,6,232,115,865
1994,Dave Jamerson,SG,26,UTA,1,0,4,0,2,0,0,0,NA,0,2,0,0,1,1,1,0,1,1,0,0,0,0,0,1
1994,Dave Jamerson,SG,26,NJN,4,0,10,0,5,0,0,0,NA,0,5,0,0,1,2,0.5,0,3,3,1,0,0,1,0,1
1994,Henry James,PF,28,LAC,12,0,75,16,42,0.381,4,18,0.222,12,24,0.5,0.429,5,5,1,6,8,14,1,2,0,2,9,41
1994,Avery Johnson,PG,28,GSW,82,70,2332,356,724,0.492,0,12,0,356,712,0.5,0.492,178,253,0.704,41,135,176,433,113,8,172,160,890
1994,Eddie Johnson,SF,34,CHH,73,27,1460,339,738,0.459,59,150,0.393,280,588,0.476,0.499,99,127,0.78,80,144,224,125,36,8,84,143,836
1994,Reggie Jordan,SG,26,LAL,23,0,259,44,103,0.427,2,4,0.5,42,99,0.424,0.437,35,51,0.686,46,21,67,26,14,5,14,26,125
1994,Tim Kempton,PF,30,CHH,9,0,103,9,26,0.346,0,0,NA,9,26,0.346,0.346,7,10,0.7,6,8,14,6,4,1,4,25,25
1994,Tim Kempton,PF,30,CLE,4,0,33,6,12,0.5,0,0,NA,6,12,0.5,0.5,2,6,0.333,4,6,10,3,2,1,7,8,14
1994,Steve Kerr,PG,28,CHI,82,0,2036,287,577,0.497,52,124,0.419,235,453,0.519,0.542,83,97,0.856,26,105,131,210,75,3,57,97,709
1994,Stacey King,C,27,CHI,31,15,537,68,171,0.398,0,2,0,68,169,0.402,0.398,36,53,0.679,50,82,132,39,18,12,43,64,172
1994,Stacey King,C,27,MIN,18,15,516,78,170,0.459,0,0,NA,78,170,0.459,0.459,57,83,0.687,40,69,109,19,13,30,40,57,213
1994,Greg Kite,C,32,ORL,29,0,309,13,35,0.371,0,0,NA,13,35,0.371,0.371,8,22,0.364,22,48,70,4,2,12,17,61,34
1994,Joe Kleine,C,32,PHO,74,4,848,125,256,0.488,5,11,0.455,120,245,0.49,0.498,30,39,0.769,50,143,193,45,14,19,35,118,285
1994,Negele Knight,PG,26,PHO,1,0,8,1,4,0.25,0,0,NA,1,4,0.25,0.25,0,0,NA,0,0,0,0,0,1,0,1,2
1994,Negele Knight,PG,26,SAS,64,18,1430,224,471,0.476,4,21,0.19,220,450,0.489,0.48,141,174,0.81,28,75,103,197,34,10,94,120,593
1994,Toni Kukoč,SF,25,CHI,75,8,1808,313,726,0.431,32,118,0.271,281,608,0.462,0.453,156,210,0.743,98,199,297,252,81,33,167,122,814
1994,Christian Laettner,PF,24,MIN,70,67,2428,396,883,0.448,6,25,0.24,390,858,0.455,0.452,375,479,0.783,160,442,602,307,87,86,259,264,1173
1994,Andrew Lang,C,27,ATL,82,0,1608,215,458,0.469,1,4,0.25,214,454,0.471,0.471,73,106,0.689,126,187,313,51,38,87,81,192,504
1994,Eric Leckner,C,27,PHI,71,36,1163,139,286,0.486,0,2,0,139,284,0.489,0.486,84,130,0.646,75,207,282,86,18,34,86,190,362
1994,Tim Legler,SG,27,DAL,79,0,1322,231,528,0.438,52,139,0.374,179,389,0.46,0.487,142,169,0.84,36,92,128,120,52,13,60,133,656
1994,Jim Les,PG,30,SAC,18,0,169,13,34,0.382,8,18,0.444,5,16,0.313,0.5,11,13,0.846,5,8,13,39,7,1,11,16,45
1994,Marcus Liberty,SF,25,DEN,3,0,11,4,7,0.571,0,1,0,4,6,0.667,0.571,1,2,0.5,0,5,5,2,0,0,2,5,9
1994,Marcus Liberty,SF,25,DET,35,0,274,36,116,0.31,10,27,0.37,26,89,0.292,0.353,18,37,0.486,26,30,56,15,11,4,22,29,100
1994,Todd Lichti,SG,27,ORL,4,0,20,4,9,0.444,0,0,NA,4,9,0.444,0.444,0,0,NA,3,1,4,2,2,0,2,3,8
1994,Todd Lichti,SG,27,GSW,5,0,58,10,28,0.357,2,2,1,8,26,0.308,0.393,9,11,0.818,3,7,10,3,0,0,0,9,31
1994,Todd Lichti,SG,27,BOS,4,0,48,6,14,0.429,0,0,NA,6,14,0.429,0.429,7,14,0.5,2,6,8,6,5,1,3,4,19
1994,Brad Lohaus,PF,29,MIL,67,2,962,102,281,0.363,46,134,0.343,56,147,0.381,0.445,20,29,0.69,33,117,150,62,30,55,58,142,270
1994,Grant Long,PF,27,MIA,69,59,2201,300,672,0.446,1,6,0.167,299,666,0.449,0.447,187,238,0.786,190,305,495,170,89,26,125,244,788
1994,Luc Longley,C,25,MIN,49,29,989,134,289,0.464,0,1,0,134,288,0.465,0.464,56,80,0.7,87,208,295,46,35,58,79,131,324
1994,Luc Longley,C,25,CHI,27,17,513,85,176,0.483,0,0,NA,85,176,0.483,0.483,34,45,0.756,42,96,138,63,10,21,40,85,204
1994,Mark Macon,SG,24,DEN,7,0,126,14,45,0.311,0,3,0,14,42,0.333,0.311,8,10,0.8,3,4,7,11,6,1,14,17,36
1994,Mark Macon,SG,24,DET,35,1,370,55,139,0.396,2,7,0.286,53,132,0.402,0.403,15,24,0.625,15,19,34,40,33,0,26,56,127
1994,Jeff Malone,SG,32,UTA,50,50,1657,338,692,0.488,3,6,0.5,335,686,0.488,0.491,129,153,0.843,28,87,115,66,26,5,57,77,808
1994,Jeff Malone,SG,32,PHI,27,23,903,187,389,0.481,4,6,0.667,183,383,0.478,0.486,76,94,0.809,23,61,84,59,14,0,28,46,454
1994,Danny Manning,PF,27,LAC,42,41,1595,409,829,0.493,2,14,0.143,407,815,0.499,0.495,174,258,0.674,82,214,296,176,53,57,147,167,994
1994,Danny Manning,PF,27,ATL,26,25,925,177,372,0.476,1,3,0.333,176,369,0.477,0.477,54,83,0.651,49,120,169,85,46,25,86,93,409
1994,Jamal Mashburn,SF,21,DAL,79,73,2896,561,1382,0.406,85,299,0.284,476,1083,0.44,0.437,306,438,0.699,107,246,353,266,89,14,245,205,1513
1994,Vernon Maxwell,SG,28,HOU,75,73,2571,380,976,0.389,120,403,0.298,260,573,0.454,0.451,143,191,0.749,42,187,229,380,125,20,185,143,1023
1994,Xavier McDaniel,SF,30,BOS,82,5,1971,387,839,0.461,10,41,0.244,377,798,0.472,0.467,144,213,0.676,142,258,400,126,48,39,116,193,928
1994,Oliver Miller,C,23,PHO,69,30,1786,277,455,0.609,2,9,0.222,275,446,0.617,0.611,80,137,0.584,140,336,476,244,83,156,164,230,636
1994,Terry Mills,PF,26,DET,80,74,2773,588,1151,0.511,24,73,0.329,564,1078,0.523,0.521,181,227,0.797,193,479,672,177,64,62,153,309,1381
1994,Darren Morningstar,C,24,DAL,22,15,363,38,81,0.469,0,0,NA,38,81,0.469,0.469,18,30,0.6,31,49,80,15,14,2,19,69,94
1994,Darren Morningstar,C,24,UTA,1,0,4,1,1,1,0,0,NA,1,1,1,1,0,0,NA,0,1,1,0,0,0,0,1,2
1994,Alonzo Mourning,C,23,CHH,60,59,2018,427,845,0.505,0,2,0,427,843,0.507,0.505,433,568,0.762,177,433,610,86,27,188,199,207,1287
1994,Eric Murdock,PG,25,MIL,82,76,2533,477,1019,0.468,69,168,0.411,408,851,0.479,0.502,234,288,0.813,91,170,261,546,197,12,206,189,1257
1994,Tod Murphy,PF,30,DET,7,0,57,6,12,0.5,0,0,NA,6,12,0.5,0.5,3,6,0.5,4,5,9,3,2,0,1,8,15
1994,Tod Murphy,PF,30,GSW,2,0,10,0,0,NA,0,0,NA,0,0,NA,NA,0,0,NA,0,1,1,1,0,0,0,2,0
1994,Tracy Murray,SF,22,POR,66,1,820,167,355,0.47,50,109,0.459,117,246,0.476,0.541,50,72,0.694,43,68,111,31,21,20,37,76,434
1994,Dikembe Mutombo,C,27,DEN,82,82,2853,365,642,0.569,0,1,0,365,641,0.569,0.569,256,439,0.583,286,685,971,127,59,336,206,262,986
1994,Pete Myers,SG,30,CHI,82,81,2030,253,556,0.455,8,29,0.276,245,527,0.465,0.462,136,194,0.701,54,127,181,245,78,20,136,195,650
1994,Johnny Newman,SF,30,CHH,18,18,429,91,174,0.523,4,16,0.25,87,158,0.551,0.534,48,59,0.814,21,37,58,29,18,5,28,44,234
1994,Johnny Newman,SF,30,NJN,63,0,1268,222,490,0.453,20,74,0.27,202,416,0.486,0.473,134,166,0.807,65,57,122,43,51,22,62,152,598
1994,Shaquille O'Neal,C,21,ORL,81,81,3224,953,1591,0.599,0,2,0,953,1589,0.6,0.599,471,850,0.554,384,688,1072,195,76,231,222,281,2377
1994,Dan O'Sullivan,C,25,DET,13,0,56,4,12,0.333,0,0,NA,4,12,0.333,0.333,9,12,0.75,2,8,10,3,0,0,3,10,17
1994,Bo Outlaw,SF,22,LAC,37,14,871,98,167,0.587,0,2,0,98,165,0.594,0.587,61,103,0.592,81,131,212,36,36,37,31,94,257
1994,Doug Overton,PG,24,WSB,61,1,749,87,216,0.403,1,11,0.091,86,205,0.42,0.405,43,52,0.827,19,50,69,92,21,1,54,48,218
1994,Billy Owens,PF,24,GSW,79,72,2738,492,971,0.507,3,15,0.2,489,956,0.512,0.508,199,326,0.61,230,410,640,326,83,60,214,269,1186
1994,Robert Pack,PG,24,DEN,66,4,1382,223,503,0.443,6,29,0.207,217,474,0.458,0.449,179,236,0.758,25,98,123,356,81,9,204,147,631
1994,Gerald Paddio,SF,28,IND,7,1,55,9,23,0.391,0,0,NA,9,23,0.391,0.391,1,2,0.5,0,5,5,4,1,0,4,2,19
1994,Gerald Paddio,SF,28,NYK,3,0,8,2,5,0.4,0,0,NA,2,5,0.4,0.4,0,0,NA,0,0,0,0,0,0,0,3,4
1994,Gerald Paddio,SF,28,WSB,8,0,74,11,32,0.344,0,1,0,11,31,0.355,0.344,8,14,0.571,5,6,11,7,3,0,2,4,30
1994,Gary Payton,PG,25,SEA,82,82,2881,584,1159,0.504,15,54,0.278,569,1105,0.515,0.51,166,279,0.595,105,164,269,494,188,19,173,227,1349
1994,Anthony Peeler,SG,24,LAL,30,30,923,176,409,0.43,14,63,0.222,162,346,0.468,0.447,57,71,0.803,48,61,109,94,43,8,59,93,423
1994,Mike Peplowski,C,23,SAC,55,19,667,76,141,0.539,0,1,0,76,140,0.543,0.539,24,44,0.545,49,120,169,24,17,25,34,131,176
1994,Sam Perkins,PF,32,SEA,81,41,2170,341,779,0.438,99,270,0.367,242,509,0.475,0.501,218,272,0.801,120,246,366,111,67,31,103,197,999
1994,Elliot Perry,PG,24,PHO,27,9,432,42,113,0.372,0,3,0,42,110,0.382,0.372,21,28,0.75,12,27,39,125,25,1,43,36,105
1994,Tim Perry,PF,28,PHI,80,68,2336,272,625,0.435,73,200,0.365,199,425,0.468,0.494,102,176,0.58,117,287,404,94,60,82,80,154,719
1994,Ricky Pierce,SG,34,SEA,51,0,1022,272,577,0.471,6,32,0.188,266,545,0.488,0.477,189,211,0.896,29,54,83,91,42,5,64,84,739
1994,Ed Pinckney,PF,30,BOS,76,35,1524,151,289,0.522,0,0,NA,151,289,0.522,0.522,92,125,0.736,160,318,478,62,58,44,62,131,394
1994,Olden Polynice,C,29,DET,37,36,1350,222,406,0.547,0,1,0,222,405,0.548,0.547,42,92,0.457,148,308,456,22,24,36,49,108,486
1994,Olden Polynice,C,29,SAC,31,29,1052,124,256,0.484,0,1,0,124,255,0.486,0.484,55,99,0.556,151,202,353,19,18,31,29,81,303
1994,Kurt Rambis,PF,35,LAL,50,1,635,59,114,0.518,0,1,0,59,113,0.522,0.518,46,71,0.648,84,105,189,32,22,23,26,89,164
1994,Mark Randall,PF,26,DEN,28,0,155,17,50,0.34,2,14,0.143,15,36,0.417,0.36,22,28,0.786,9,13,22,11,8,3,10,18,58
1994,J.R. Reid,PF,25,SAS,70,11,1344,260,530,0.491,0,3,0,260,527,0.493,0.491,107,153,0.699,91,129,220,73,43,25,84,165,627
1994,Doc Rivers,PG,32,NYK,19,19,499,55,127,0.433,19,52,0.365,36,75,0.48,0.508,14,22,0.636,4,35,39,100,25,5,29,44,143
1994,Clifford Robinson,C,27,POR,82,64,2853,641,1404,0.457,13,53,0.245,628,1351,0.465,0.461,352,460,0.765,164,386,550,159,118,111,169,263,1647
1994,James Robinson,PG,23,POR,58,3,673,104,285,0.365,23,73,0.315,81,212,0.382,0.405,45,67,0.672,34,44,78,68,30,15,52,69,276
1994,Larry Robinson,SG,26,HOU,6,0,55,10,20,0.5,2,8,0.25,8,12,0.667,0.55,3,8,0.375,4,6,10,6,7,0,10,8,25
1994,Rumeal Robinson,PG,27,NJN,17,0,301,42,119,0.353,7,15,0.467,35,104,0.337,0.382,10,20,0.5,4,20,24,45,15,3,25,33,101
1994,Rumeal Robinson,PG,27,CHH,14,0,95,13,33,0.394,1,5,0.2,12,28,0.429,0.409,3,9,0.333,2,6,8,18,3,0,18,15,30
1994,Rodney Rogers,SF,22,DEN,79,14,1406,239,545,0.439,35,92,0.38,204,453,0.45,0.471,127,189,0.672,90,136,226,101,63,48,131,195,640
1994,Sean Rooks,C,24,DAL,47,28,1255,193,393,0.491,0,1,0,193,392,0.492,0.491,150,210,0.714,84,175,259,49,21,44,80,109,536
1994,Donald Royal,SF,27,ORL,74,0,1357,174,347,0.501,0,2,0,174,345,0.504,0.501,199,269,0.74,94,154,248,61,50,16,76,121,547
1994,John Salley,PF,29,MIA,76,45,1910,208,436,0.477,2,3,0.667,206,433,0.476,0.479,164,225,0.729,132,275,407,135,56,78,94,260,582
1994,Danny Schayes,C,34,MIL,23,6,230,14,46,0.304,0,0,NA,14,46,0.304,0.304,21,22,0.955,16,29,45,5,5,8,14,27,49
1994,Danny Schayes,C,34,LAL,13,0,133,14,38,0.368,0,0,NA,14,38,0.368,0.368,8,10,0.8,15,19,34,8,5,2,9,18,36
1994,Steve Scheffler,C,26,SEA,35,1,152,28,46,0.609,0,0,NA,28,46,0.609,0.609,19,20,0.95,11,15,26,6,7,0,8,25,75
1994,Dennis Scott,SF,25,ORL,82,37,2283,384,949,0.405,155,388,0.399,229,561,0.408,0.486,123,159,0.774,54,164,218,216,81,32,93,161,1046
1994,Rony Seikaly,C,28,MIA,72,60,2410,392,803,0.488,0,2,0,392,801,0.489,0.488,304,422,0.72,244,496,740,136,59,100,195,279,1088
1994,Brian Shaw,SG,27,MIA,77,52,2037,278,667,0.417,73,216,0.338,205,451,0.455,0.472,64,89,0.719,104,246,350,385,71,21,173,195,693
1994,Charles Smith,SF,28,NYK,43,21,1105,176,397,0.443,8,16,0.5,168,381,0.441,0.453,87,121,0.719,66,99,165,50,26,45,64,144,447
1994,Kenny Smith,PG,28,HOU,78,78,2209,341,711,0.48,89,220,0.405,252,491,0.513,0.542,135,155,0.871,24,114,138,327,59,4,126,121,906
1994,LaBradford Smith,SG,24,WSB,7,0,48,8,18,0.444,0,0,NA,8,18,0.444,0.444,15,20,0.75,5,3,8,5,3,1,1,8,31
1994,LaBradford Smith,SG,24,SAC,59,2,829,116,288,0.403,21,60,0.35,95,228,0.417,0.439,48,64,0.75,29,47,76,104,37,4,49,88,301
1994,Steve Smith,SG,24,MIA,78,77,2776,491,1076,0.456,91,262,0.347,400,814,0.491,0.499,273,327,0.835,156,196,352,394,84,35,202,217,1346
1994,Tony Smith,SG,25,LAL,73,31,1617,272,617,0.441,16,50,0.32,256,567,0.451,0.454,85,119,0.714,106,89,195,148,59,14,76,128,645
1994,Andre Spencer,SF,29,GSW,5,1,63,9,18,0.5,0,0,NA,9,18,0.5,0.5,3,4,0.75,4,8,12,3,1,2,2,6,21
1994,Andre Spencer,SF,29,SAC,23,0,286,43,100,0.43,0,0,NA,43,100,0.43,0.43,52,73,0.712,26,35,61,19,18,5,19,37,138
1994,Elmore Spencer,C,24,LAC,76,63,1930,288,540,0.533,0,2,0,288,538,0.535,0.533,97,162,0.599,96,319,415,75,30,127,168,208,673
1994,Felton Spencer,C,26,UTA,79,79,2210,256,507,0.505,0,0,NA,256,507,0.505,0.505,165,272,0.607,235,423,658,43,41,67,127,304,677
1994,John Starks,SG,28,NYK,59,54,2057,410,977,0.42,113,337,0.335,297,640,0.464,0.477,187,248,0.754,37,148,185,348,95,6,184,191,1120
1994,Rod Strickland,PG,27,POR,82,58,2889,528,1093,0.483,2,10,0.2,526,1083,0.486,0.484,353,471,0.749,122,248,370,740,147,24,257,171,1411
1994,LaSalle Thompson,C,32,IND,30,1,282,27,77,0.351,0,0,NA,27,77,0.351,0.351,16,30,0.533,26,49,75,16,10,8,23,59,70
1994,Otis Thorpe,PF,31,HOU,82,82,2909,449,801,0.561,0,2,0,449,799,0.562,0.561,251,382,0.657,271,599,870,189,66,28,185,253,1149
1994,Sedric Toney,PG,31,CLE,12,0,64,2,12,0.167,0,1,0,2,11,0.182,0.167,2,2,1,1,2,3,11,0,0,5,8,6
1994,Nick Van Exel,PG,22,LAL,81,80,2700,413,1049,0.394,123,364,0.338,290,685,0.423,0.452,150,192,0.781,47,191,238,466,85,8,145,154,1099
1994,Loy Vaught,PF,25,LAC,75,56,2118,373,695,0.537,0,5,0,373,690,0.541,0.537,131,182,0.72,218,438,656,74,76,22,96,221,877
1994,Rex Walters,SG,23,NJN,48,0,386,60,115,0.522,14,28,0.5,46,87,0.529,0.583,28,34,0.824,6,32,38,71,15,3,30,41,162
1994,Clarence Weatherspoon,SF,23,PHI,82,82,3147,602,1246,0.483,4,17,0.235,598,1229,0.487,0.485,298,430,0.693,254,578,832,192,100,116,195,152,1506
1994,Spud Webb,PG,30,SAC,79,62,2567,373,810,0.46,55,164,0.335,318,646,0.492,0.494,204,251,0.813,44,178,222,528,93,23,168,182,1005
1994,Chris Webber,C,20,GSW,76,76,2438,572,1037,0.552,0,14,0,572,1023,0.559,0.552,189,355,0.532,305,389,694,272,93,164,206,247,1333
1994,David Wesley,PG,23,NJN,60,0,542,64,174,0.368,11,47,0.234,53,127,0.417,0.399,44,53,0.83,10,34,44,123,38,4,52,47,183
1994,Chris Whitney,PG,22,SAS,40,4,339,25,82,0.305,10,30,0.333,15,52,0.288,0.366,12,15,0.8,5,24,29,53,11,1,37,53,72
1994,Morlon Wiley,PG,27,MIA,4,0,34,3,8,0.375,1,4,0.25,2,4,0.5,0.438,0,0,NA,0,4,4,7,2,0,6,4,7
1994,Morlon Wiley,PG,27,DAL,12,0,124,6,21,0.286,2,6,0.333,4,15,0.267,0.333,0,0,NA,0,6,6,16,13,0,11,17,14
1994,Dominique Wilkins,SF,34,ATL,49,49,1687,430,996,0.432,61,198,0.308,369,798,0.462,0.462,275,322,0.854,119,186,305,114,63,22,120,87,1196
1994,Dominique Wilkins,SF,34,LAC,25,25,948,268,592,0.453,24,97,0.247,244,495,0.493,0.473,167,200,0.835,63,113,176,55,29,8,52,39,727
1994,Aaron Williams,PF,22,UTA,6,0,12,2,8,0.25,0,0,NA,2,8,0.25,0.25,0,1,0,1,2,3,1,0,0,1,4,4
1994,Herb Williams,C,35,NYK,70,3,774,103,233,0.442,0,1,0,103,232,0.444,0.442,27,42,0.643,56,126,182,28,18,43,39,108,233
1994,Lorenzo Williams,PF,24,ORL,3,0,19,1,6,0.167,0,1,0,1,5,0.2,0.167,0,0,NA,3,1,4,2,2,3,0,3,2
1994,Lorenzo Williams,PF,24,CHH,1,0,19,0,1,0,0,0,NA,0,1,0,0,0,0,NA,0,4,4,0,1,2,1,2,0
1994,Lorenzo Williams,PF,24,DAL,34,11,678,48,103,0.466,0,0,NA,48,103,0.466,0.466,12,28,0.429,92,117,209,23,15,41,21,87,108
1994,Micheal Williams,PG,27,MIN,71,66,2206,314,687,0.457,10,45,0.222,304,642,0.474,0.464,333,397,0.839,67,154,221,512,118,24,203,193,971
1994,Reggie Williams,SF,29,DEN,82,68,2654,418,1014,0.412,64,230,0.278,354,784,0.452,0.444,165,225,0.733,98,294,392,300,117,66,163,288,1065
1994,Scott Williams,C,25,CHI,38,11,638,114,236,0.483,1,5,0.2,113,231,0.489,0.485,60,98,0.612,69,112,181,39,16,21,44,112,289
1994,Walt Williams,SF,23,SAC,57,4,1356,226,580,0.39,38,132,0.288,188,448,0.42,0.422,148,233,0.635,71,164,235,132,52,23,145,200,638
1994,Kevin Willis,PF,31,ATL,80,80,2867,627,1257,0.499,9,24,0.375,618,1233,0.501,0.502,268,376,0.713,335,628,963,150,79,38,188,250,1531
1994,Trevor Wilson,PF,25,LAL,5,4,126,19,39,0.487,0,0,NA,19,39,0.487,0.487,13,25,0.52,12,16,28,12,5,1,6,17,51
1994,Trevor Wilson,PF,25,SAC,52,9,1095,168,349,0.481,0,2,0,168,347,0.484,0.481,79,141,0.56,108,137,245,60,33,10,87,106,415
1994,David Wood,PF,29,DET,78,3,1182,119,259,0.459,22,49,0.449,97,210,0.462,0.502,62,82,0.756,104,135,239,51,39,19,35,201,322
1994,Orlando Woolridge,SF,34,PHI,74,1,1955,364,773,0.471,1,14,0.071,363,759,0.478,0.472,208,302,0.689,103,195,298,139,41,56,142,186,937
1994,Haywoode Workman,PG,28,IND,65,52,1714,195,460,0.424,18,56,0.321,177,404,0.438,0.443,93,116,0.802,32,172,204,404,85,4,151,152,501
1995,Alaa Abdelnaby,PF,26,SAC,51,0,476,117,220,0.532,0,2,0,117,218,0.537,0.532,20,35,0.571,34,72,106,13,15,12,40,102,254
1995,Alaa Abdelnaby,PF,26,PHI,3,0,30,1,11,0.091,0,0,NA,1,11,0.091,0.091,0,0,NA,3,5,8,0,0,0,5,2,2
1995,Greg Anderson,PF,30,ATL,51,0,622,57,104,0.548,0,0,NA,57,104,0.548,0.548,34,71,0.479,62,126,188,17,23,32,32,103,148
1995,Kenny Anderson,PG,24,NJN,72,70,2689,411,1031,0.399,97,294,0.33,314,737,0.426,0.446,348,414,0.841,73,177,250,680,103,14,225,184,1267
1995,Willie Anderson,SG,28,SAS,38,11,556,76,162,0.469,3,19,0.158,73,143,0.51,0.478,30,41,0.732,15,40,55,52,26,10,38,71,185
1995,Greg Anthony,PG,27,NYK,61,2,943,128,293,0.437,56,155,0.361,72,138,0.522,0.532,60,76,0.789,7,57,64,160,50,7,57,99,372
1995,B.J. Armstrong,PG,27,CHI,82,82,2577,418,894,0.468,108,253,0.427,310,641,0.484,0.528,206,233,0.884,25,161,186,244,84,8,103,159,1150
1995,Darrell Armstrong,PG,26,ORL,3,0,8,3,8,0.375,2,6,0.333,1,2,0.5,0.5,2,2,1,1,0,1,3,1,0,1,3,10
1995,Vincent Askew,SG,28,SEA,71,1,1721,248,504,0.492,31,94,0.33,217,410,0.529,0.523,176,238,0.739,65,116,181,176,49,13,85,191,703
1995,Stacey Augmon,SG,26,ATL,76,76,2362,397,876,0.453,7,26,0.269,390,850,0.459,0.457,252,346,0.728,157,211,368,197,100,47,152,163,1053
1995,Anthony Avent,PF,25,ORL,71,3,1066,105,244,0.43,0,0,NA,105,244,0.43,0.43,48,75,0.64,97,196,293,41,28,50,53,170,258
1995,Vin Baker,PF,23,MIL,82,82,3361,594,1229,0.483,7,24,0.292,587,1205,0.487,0.486,256,432,0.593,289,557,846,296,86,116,221,277,1451
1995,Jon Barry,SG,25,MIL,52,0,602,57,134,0.425,16,48,0.333,41,86,0.477,0.485,61,80,0.763,15,34,49,85,30,4,41,54,191
1995,Benoit Benjamin,C,30,NJN,61,57,1598,271,531,0.51,0,0,NA,271,531,0.51,0.51,133,175,0.76,94,346,440,38,23,64,125,151,675
1995,Elmer Bennett,PG,24,CLE,4,0,18,6,11,0.545,0,2,0,6,9,0.667,0.545,3,4,0.75,0,1,1,3,4,0,3,3,15
1995,David Benoit,SF,26,UTA,71,67,1841,285,587,0.486,38,115,0.33,247,472,0.523,0.518,132,157,0.841,96,272,368,58,45,47,75,183,740
1995,James Blackwell,PG,26,CHH,4,0,19,2,3,0.667,0,0,NA,2,3,0.667,0.667,0,0,NA,0,3,3,5,1,0,2,1,4
1995,James Blackwell,PG,26,BOS,9,0,61,6,10,0.6,0,0,NA,6,10,0.6,0.6,2,3,0.667,2,6,8,6,3,0,3,7,14
1995,Corie Blount,PF,26,CHI,68,9,889,100,210,0.476,0,2,0,100,208,0.481,0.476,38,67,0.567,107,133,240,60,26,33,59,146,238
1995,Muggsy Bogues,PG,30,CHH,78,78,2629,348,730,0.477,6,30,0.2,342,700,0.489,0.481,160,180,0.889,51,206,257,675,103,0,132,151,862
1995,Manute Bol,C,32,GSW,5,2,81,6,10,0.6,3,5,0.6,3,5,0.6,0.75,0,0,NA,1,11,12,0,0,9,1,10,15
1995,Walter Bond,SG,25,DET,5,0,51,3,12,0.25,1,4,0.25,2,8,0.25,0.292,3,4,0.75,1,4,5,7,1,0,3,10,10
1995,Walter Bond,SG,25,UTA,18,0,239,36,72,0.5,14,37,0.378,22,35,0.629,0.597,11,16,0.688,7,20,27,17,5,4,14,37,97
1995,Shawn Bradley,C,22,PHI,82,59,2365,315,693,0.455,0,3,0,315,690,0.457,0.455,148,232,0.638,243,416,659,53,54,274,142,338,778
1995,Terrell Brandon,PG,24,CLE,67,41,1961,341,762,0.448,48,121,0.397,293,641,0.457,0.479,159,186,0.855,35,151,186,363,107,14,144,118,889
1995,Scott Brooks,PG,29,HOU,28,0,186,35,65,0.538,8,17,0.471,27,48,0.563,0.6,18,21,0.857,1,12,13,22,8,1,14,14,96
1995,Scott Brooks,PG,29,DAL,31,0,622,91,210,0.433,17,52,0.327,74,158,0.468,0.474,46,58,0.793,13,40,53,94,26,3,33,42,245
1995,Chucky Brown,SF,26,HOU,41,14,814,105,174,0.603,1,3,0.333,104,171,0.608,0.606,38,62,0.613,64,125,189,30,11,14,29,105,249
1995,Dee Brown,SG,26,BOS,79,69,2792,437,977,0.447,126,327,0.385,311,650,0.478,0.512,236,277,0.852,63,186,249,301,110,49,146,181,1236
1995,Mark Bryant,PF,29,POR,49,0,658,101,192,0.526,1,2,0.5,100,190,0.526,0.529,41,63,0.651,55,106,161,28,19,16,39,109,244
1995,Jud Buechler,SF,26,CHI,57,0,605,90,183,0.492,15,48,0.313,75,135,0.556,0.533,22,39,0.564,36,62,98,50,24,12,30,64,217
1995,Scott Burrell,SF,24,CHH,65,62,2014,277,593,0.467,96,235,0.409,181,358,0.506,0.548,100,144,0.694,96,272,368,161,75,40,85,187,750
1995,Adrian Caldwell,PF,28,HOU,7,0,30,1,4,0.25,0,0,NA,1,4,0.25,0.25,3,6,0.5,1,9,10,0,1,0,1,6,5
1995,Elden Campbell,PF,26,LAL,73,59,2076,360,785,0.459,0,1,0,360,784,0.459,0.459,193,290,0.666,168,277,445,92,69,132,98,246,913
1995,Tony Campbell,SF,32,CLE,78,0,1128,161,392,0.411,15,42,0.357,146,350,0.417,0.43,132,159,0.83,60,93,153,69,32,8,65,122,469
1995,Antoine Carr,C,33,UTA,78,4,1677,290,546,0.531,1,4,0.25,289,542,0.533,0.532,165,201,0.821,81,184,265,67,24,68,87,253,746
1995,Sam Cassell,PG,25,HOU,82,1,1882,253,593,0.427,63,191,0.33,190,402,0.473,0.48,214,254,0.843,38,173,211,405,94,14,167,209,783
1995,Cedric Ceballos,SF,25,LAL,58,54,2029,497,977,0.509,58,146,0.397,439,831,0.528,0.538,209,292,0.716,169,295,464,105,60,19,143,131,1261
1995,Rex Chapman,SG,27,WSB,45,29,1468,254,639,0.397,86,274,0.314,168,365,0.46,0.465,137,159,0.862,23,90,113,128,67,15,62,85,731
1995,Pete Chilcutt,PF,26,HOU,68,17,1347,146,328,0.445,35,86,0.407,111,242,0.459,0.498,31,42,0.738,106,211,317,66,25,43,61,117,358
1995,Chris Childs,PG,27,NJN,53,11,1021,106,279,0.38,41,125,0.328,65,154,0.422,0.453,55,73,0.753,14,55,69,219,42,3,76,116,308
1995,Doug Christie,SG,24,NYK,12,0,79,5,22,0.227,1,7,0.143,4,15,0.267,0.25,4,5,0.8,3,10,13,8,2,1,13,18,15
1995,Bimbo Coles,PG,26,MIA,68,65,2207,261,607,0.43,16,76,0.211,245,531,0.461,0.443,141,174,0.81,46,145,191,416,99,13,156,185,679
1995,Marty Conlon,C,27,MIL,82,3,2064,344,647,0.532,8,29,0.276,336,618,0.544,0.538,119,194,0.613,160,266,426,110,42,18,123,218,815
1995,Lester Conner,SG,35,LAL,2,0,5,0,0,NA,0,0,NA,0,0,NA,NA,2,2,1,0,0,0,0,1,0,0,3,2
1995,Tyrone Corbin,SF,32,ATL,81,4,1389,205,464,0.442,14,56,0.25,191,408,0.468,0.457,78,114,0.684,98,164,262,67,55,16,74,161,502
1995,John Crotty,PG,25,UTA,80,0,1019,93,231,0.403,11,36,0.306,82,195,0.421,0.426,98,121,0.81,27,70,97,205,39,6,70,105,295
1995,Terry Cummings,PF,33,SAS,76,20,1273,224,464,0.483,0,0,NA,224,464,0.483,0.483,72,123,0.585,138,240,378,59,36,19,95,188,520
1995,Bill Curley,PF,22,DET,53,1,595,58,134,0.433,0,0,NA,58,134,0.433,0.433,27,36,0.75,54,70,124,25,21,21,25,128,143
1995,Lloyd Daniels,SG,27,PHI,5,0,63,9,27,0.333,3,14,0.214,6,13,0.462,0.389,2,2,1,2,5,7,4,2,0,8,8,23
1995,Lloyd Daniels,SG,27,LAL,25,14,541,71,182,0.39,23,86,0.267,48,96,0.5,0.453,20,25,0.8,27,29,56,36,20,10,23,40,185
1995,Antonio Davis,PF,26,IND,44,1,1030,109,245,0.445,0,0,NA,109,245,0.445,0.445,117,174,0.672,105,175,280,25,19,29,64,134,335
1995,Dale Davis,PF,25,IND,74,70,2346,324,576,0.563,0,1,0,324,575,0.563,0.563,138,259,0.533,259,437,696,58,72,116,124,222,786
1995,Hubert Davis,SG,24,NYK,82,4,1697,296,617,0.48,131,288,0.455,165,329,0.502,0.586,97,120,0.808,30,80,110,150,35,11,87,146,820
1995,Todd Day,SG,25,MIL,82,81,2717,445,1049,0.424,163,418,0.39,282,631,0.447,0.502,257,341,0.754,95,227,322,134,104,63,157,283,1310
1995,Terry Dehere,PG,23,LAC,80,28,1774,279,685,0.407,48,163,0.294,231,522,0.443,0.442,229,292,0.784,35,117,152,225,45,7,157,200,835
1995,Vinny Del Negro,SG,28,SAS,75,71,2360,372,766,0.486,66,162,0.407,306,604,0.507,0.529,128,162,0.79,28,164,192,226,61,14,56,179,938
1995,James Donaldson,C,37,UTA,43,40,613,44,74,0.595,0,0,NA,44,74,0.595,0.595,22,31,0.71,19,88,107,14,6,28,22,66,110
1995,Sherman Douglas,PG,28,BOS,65,43,2048,365,769,0.475,20,82,0.244,345,687,0.502,0.488,204,296,0.689,48,122,170,446,80,2,162,152,954
1995,Clyde Drexler,SG,32,POR,41,41,1428,305,712,0.428,87,240,0.363,218,472,0.462,0.489,207,248,0.835,84,150,234,208,74,22,97,117,904
1995,Clyde Drexler,SG,32,HOU,35,34,1300,266,526,0.506,60,168,0.357,206,358,0.575,0.563,157,194,0.809,68,178,246,154,62,23,89,89,749
1995,Chris Dudley,C,29,POR,82,82,2245,181,446,0.406,0,1,0,181,445,0.407,0.406,85,183,0.464,325,439,764,34,43,126,81,286,447
1995,Tony Dumas,SG,22,DAL,58,0,613,96,250,0.384,22,73,0.301,74,177,0.418,0.428,50,77,0.649,32,30,62,57,13,4,50,78,264
1995,Acie Earl,C,24,BOS,30,3,208,26,68,0.382,0,0,NA,26,68,0.382,0.382,14,29,0.483,19,26,45,2,6,8,14,39,66
1995,Blue Edwards,SF,29,BOS,31,7,507,83,195,0.426,11,43,0.256,72,152,0.474,0.454,43,48,0.896,25,40,65,47,19,10,39,64,220
1995,Blue Edwards,SF,29,UTA,36,0,605,98,198,0.495,11,32,0.344,87,166,0.524,0.523,32,42,0.762,25,40,65,30,24,6,42,79,239
1995,Kevin Edwards,SG,29,NJN,14,14,466,69,154,0.448,18,45,0.4,51,109,0.468,0.506,40,42,0.952,10,27,37,27,19,5,35,42,196
1995,Howard Eisley,PG,22,MIN,34,4,496,37,105,0.352,8,32,0.25,29,73,0.397,0.39,31,40,0.775,10,32,42,77,18,5,42,78,113
1995,Howard Eisley,PG,22,SAS,15,0,56,3,17,0.176,1,5,0.2,2,12,0.167,0.206,0,0,NA,2,4,6,18,0,1,8,3,7
1995,Mario Elie,SF,31,HOU,81,13,1896,243,487,0.499,80,201,0.398,163,286,0.57,0.581,144,171,0.842,50,146,196,189,65,12,104,158,710
1995,Dale Ellis,SF,34,DEN,81,3,1996,351,774,0.453,106,263,0.403,245,511,0.479,0.522,110,127,0.866,56,166,222,57,37,9,81,142,918
1995,Matt Fish,C,25,LAC,26,8,370,49,103,0.476,0,1,0,49,102,0.48,0.476,25,37,0.676,32,52,84,17,16,7,28,70,123
1995,Greg Foster,PF,26,CHI,17,3,299,41,86,0.477,0,0,NA,41,86,0.477,0.477,22,31,0.71,18,36,54,16,2,8,17,54,104
1995,Greg Foster,PF,26,MIN,61,0,845,109,232,0.47,7,23,0.304,102,209,0.488,0.485,56,80,0.7,67,138,205,23,13,20,54,129,281
1995,Kevin Gamble,SF,29,MIA,77,0,1223,220,450,0.489,39,98,0.398,181,352,0.514,0.532,87,111,0.784,29,93,122,119,52,10,49,130,566
1995,Winston Garland,PG,30,MIN,73,58,1931,170,410,0.415,19,75,0.253,151,335,0.451,0.438,89,112,0.795,48,120,168,318,71,13,105,184,448
1995,Chris Gatling,PF,27,GSW,58,22,1470,324,512,0.633,0,1,0,324,511,0.634,0.633,148,250,0.592,144,299,443,51,39,52,117,184,796
1995,Kendall Gill,SG,26,SEA,73,58,2125,392,858,0.457,63,171,0.368,329,687,0.479,0.494,155,209,0.742,99,191,290,192,117,28,138,186,1002
1995,Armen Gilliam,PF,30,NJN,82,30,2472,455,905,0.503,0,2,0,455,903,0.504,0.503,302,392,0.77,192,421,613,99,67,89,152,171,1212
1995,Greg Graham,SG,24,PHI,50,7,775,95,223,0.426,6,28,0.214,89,195,0.456,0.439,55,73,0.753,19,43,62,66,29,6,48,76,251
1995,Ron Grandison,PF,30,NYK,2,0,8,1,4,0.25,0,0,NA,1,4,0.25,0.25,0,0,NA,3,2,5,2,0,0,0,2,2
1995,Greg Grant,PG,28,DEN,14,0,151,10,33,0.303,2,7,0.286,8,26,0.308,0.333,9,12,0.75,2,7,9,43,6,2,14,20,31
1995,Jeff Grayer,SG,29,PHI,47,25,1098,163,381,0.428,5,15,0.333,158,366,0.432,0.434,58,83,0.699,58,91,149,74,27,4,56,80,389
1995,A.C. Green,SF,31,PHO,82,52,2687,311,617,0.504,43,127,0.339,268,490,0.547,0.539,251,343,0.732,194,475,669,127,55,31,114,146,916
1995,Tom Gugliotta,PF,25,WSB,6,6,226,33,83,0.398,4,8,0.5,29,75,0.387,0.422,26,33,0.788,16,37,53,18,21,11,15,19,96
1995,Tom Gugliotta,PF,25,GSW,40,40,1324,176,397,0.443,28,90,0.311,148,307,0.482,0.479,55,97,0.567,100,197,297,122,50,23,93,98,435
1995,Tom Gugliotta,SF,25,MIN,31,17,1018,162,357,0.454,28,88,0.318,134,269,0.498,0.493,93,122,0.762,49,173,222,139,61,28,81,86,445
1995,Jack Haley,PF,31,SAS,31,0,117,26,61,0.426,0,1,0,26,60,0.433,0.426,21,32,0.656,8,19,27,2,3,5,13,31,73
1995,Geert Hammink,C,25,ORL,1,0,7,1,3,0.333,0,0,NA,1,3,0.333,0.333,2,2,1,0,2,2,1,0,0,0,1,4
1995,Tom Hammonds,PF,27,DEN,70,5,956,139,260,0.535,0,1,0,139,259,0.537,0.535,132,177,0.746,55,167,222,36,11,14,56,132,410
1995,Darrin Hancock,SF,23,CHH,46,7,424,68,121,0.562,1,3,0.333,67,118,0.568,0.566,16,39,0.41,14,39,53,30,19,4,30,48,153
1995,Anfernee Hardaway,PG,23,ORL,77,77,2901,585,1142,0.512,87,249,0.349,498,893,0.558,0.55,356,463,0.769,139,197,336,551,130,26,258,158,1613
1995,Tim Hardaway,PG,28,GSW,62,62,2321,430,1007,0.427,168,444,0.378,262,563,0.465,0.51,219,288,0.76,46,144,190,578,88,12,214,155,1247
1995,Derek Harper,PG,33,NYK,80,80,2716,337,756,0.446,106,292,0.363,231,464,0.498,0.516,139,192,0.724,31,163,194,458,79,10,151,219,919
1995,Ron Harper,SG,31,CHI,77,53,1536,209,491,0.426,31,110,0.282,178,381,0.467,0.457,81,131,0.618,51,129,180,157,97,27,100,132,530
1995,Antonio Harvey,PF,24,LAL,59,8,572,77,176,0.438,1,1,1,76,175,0.434,0.44,24,45,0.533,39,63,102,23,15,41,25,87,179
1995,Carl Herrera,PF,28,HOU,61,26,1331,171,327,0.523,0,2,0,171,325,0.526,0.523,73,117,0.624,98,180,278,44,40,38,71,136,415
1995,Sean Higgins,SF,26,NJN,57,7,735,105,273,0.385,23,78,0.295,82,195,0.421,0.427,35,40,0.875,25,52,77,29,10,9,35,93,268
1995,Tyrone Hill,C,26,CLE,70,67,2397,350,694,0.504,0,1,0,350,693,0.505,0.504,263,397,0.662,269,496,765,55,55,41,151,245,963
1995,Donald Hodge,C,25,DAL,54,0,633,83,204,0.407,4,14,0.286,79,190,0.416,0.417,39,51,0.765,40,82,122,41,10,14,39,107,209
1995,Jeff Hornacek,SG,31,UTA,81,81,2696,482,937,0.514,89,219,0.406,393,718,0.547,0.562,284,322,0.882,53,157,210,347,129,17,145,181,1337
1995,Robert Horry,PF,24,HOU,64,61,2074,240,537,0.447,86,227,0.379,154,310,0.497,0.527,86,113,0.761,81,243,324,216,94,76,122,161,652
1995,Juwan Howard,PF,21,WSB,65,52,2348,455,931,0.489,0,7,0,455,924,0.492,0.489,194,292,0.664,184,361,545,165,52,15,166,236,1104
1995,Jay Humphries,SG,32,UTA,12,0,149,4,25,0.16,2,3,0.667,2,22,0.091,0.2,0,0,NA,2,8,10,9,7,0,12,25,10
1995,Jay Humphries,PG,32,BOS,6,0,52,4,9,0.444,0,1,0,4,8,0.5,0.444,2,4,0.5,2,1,3,10,2,0,5,10,10
1995,Bobby Hurley,PG,23,SAC,68,6,1105,103,284,0.363,21,76,0.276,82,208,0.394,0.4,58,76,0.763,14,56,70,226,29,0,110,79,285
1995,Jim Jackson,SG,24,DAL,51,51,1982,484,1026,0.472,35,110,0.318,449,916,0.49,0.489,306,380,0.805,120,140,260,191,28,12,160,92,1309
1995,Mark Jackson,PG,29,IND,82,67,2402,239,566,0.422,27,87,0.31,212,479,0.443,0.446,119,153,0.778,73,233,306,616,105,16,210,148,624
1995,Avery Johnson,PG,29,SAS,82,82,3011,448,863,0.519,3,22,0.136,445,841,0.529,0.521,202,295,0.685,49,159,208,670,114,13,207,154,1101
1995,Eddie Jones,SG,23,LAL,64,58,1981,342,744,0.46,91,246,0.37,251,498,0.504,0.521,122,169,0.722,79,170,249,128,131,41,75,175,897
1995,Steve Kerr,PG,29,CHI,82,0,1839,261,495,0.527,89,170,0.524,172,325,0.529,0.617,63,81,0.778,20,99,119,151,44,3,48,114,674
1995,Randolph Keys,SF,28,LAL,6,0,83,9,26,0.346,0,9,0,9,17,0.529,0.346,2,2,1,6,11,17,2,1,2,2,16,20
1995,Jason Kidd,PG,21,DAL,79,79,2668,330,857,0.385,70,257,0.272,260,600,0.433,0.426,192,275,0.698,152,278,430,607,151,24,250,146,922
1995,Stacey King,PF,28,MIN,50,10,792,99,212,0.467,0,1,0,99,211,0.469,0.467,68,102,0.667,54,111,165,26,24,20,64,126,266
1995,Greg Kite,C,33,NYK,2,0,16,0,3,0,0,0,NA,0,3,0,0,0,0,NA,2,2,4,0,0,0,1,2,0
1995,Greg Kite,C,33,IND,9,0,61,3,14,0.214,0,0,NA,3,14,0.214,0.214,2,10,0.2,10,8,18,1,0,0,5,13,8
1995,Joe Kleine,C,33,PHO,75,42,968,119,265,0.449,0,2,0,119,263,0.452,0.449,42,49,0.857,82,177,259,39,14,18,35,174,280
1995,Negele Knight,PG,27,POR,3,0,43,7,15,0.467,0,0,NA,7,15,0.467,0.467,4,4,1,1,2,3,11,1,0,4,5,18
1995,Negele Knight,PG,27,DET,44,17,665,78,199,0.392,11,28,0.393,67,171,0.392,0.42,14,21,0.667,20,38,58,116,20,5,45,65,181
1995,Toni Kukoč,SF,26,CHI,81,55,2584,487,967,0.504,62,198,0.313,425,769,0.553,0.536,235,314,0.748,155,285,440,372,102,16,165,163,1271
1995,Christian Laettner,C,25,MIN,81,80,2770,450,920,0.489,13,40,0.325,437,880,0.497,0.496,409,500,0.818,164,449,613,234,101,87,225,302,1322
1995,Andrew Lang,C,28,ATL,82,63,2340,320,677,0.473,2,3,0.667,318,674,0.472,0.474,152,188,0.809,154,302,456,72,45,144,108,271,794
1995,Antonio Lang,SF,22,PHO,12,0,53,4,10,0.4,0,0,NA,4,10,0.4,0.4,3,4,0.75,3,1,4,1,0,2,5,11,11
1995,Eric Leckner,C,28,DET,57,11,623,87,165,0.527,0,2,0,87,163,0.534,0.527,51,72,0.708,47,127,174,14,15,15,39,122,225
1995,Tim Legler,SG,28,GSW,24,0,371,60,115,0.522,26,50,0.52,34,65,0.523,0.635,30,34,0.882,12,28,40,27,12,1,20,33,176
1995,Jim Les,PG,31,ATL,24,0,188,11,38,0.289,5,23,0.217,6,15,0.4,0.355,23,27,0.852,6,20,26,44,4,0,21,28,50
1995,Alton Lister,C,36,MIL,60,32,776,66,134,0.493,0,1,0,66,133,0.496,0.493,35,70,0.5,67,169,236,12,16,57,38,146,167
1995,Brad Lohaus,PF,30,MIA,61,1,730,97,231,0.42,63,155,0.406,34,76,0.447,0.556,10,15,0.667,28,74,102,43,20,25,29,85,267
1995,Grant Long,PF,28,MIA,2,2,62,5,12,0.417,0,0,NA,5,12,0.417,0.417,6,10,0.6,1,10,11,4,2,0,4,11,16
1995,Grant Long,PF,28,ATL,79,77,2579,337,704,0.479,11,31,0.355,326,673,0.484,0.487,238,315,0.756,190,405,595,127,107,34,151,232,923
1995,Luc Longley,C,26,CHI,55,0,1001,135,302,0.447,0,2,0,135,300,0.45,0.447,88,107,0.822,82,181,263,73,24,45,86,177,358
1995,Mark Macon,SG,25,DET,55,6,721,101,265,0.381,20,62,0.323,81,203,0.399,0.419,54,68,0.794,29,47,76,63,67,1,41,97,276
1995,Jeff Malone,SG,33,PHI,19,19,660,144,284,0.507,11,28,0.393,133,256,0.52,0.526,51,59,0.864,11,44,55,29,15,0,29,35,350
1995,Danny Manning,PF,28,PHO,46,19,1510,340,622,0.547,6,21,0.286,334,601,0.556,0.551,136,202,0.673,97,179,276,154,41,57,121,176,822
1995,Donyell Marshall,SF,21,MIN,40,8,1036,158,423,0.374,32,106,0.302,126,317,0.397,0.411,83,122,0.68,64,132,196,57,25,50,58,63,431
1995,Donyell Marshall,SF,21,GSW,32,23,1050,187,453,0.413,37,137,0.27,150,316,0.475,0.454,64,100,0.64,73,136,209,48,20,38,57,94,475
1995,Darrick Martin,PG,23,MIN,34,9,803,95,233,0.408,7,38,0.184,88,195,0.451,0.423,57,65,0.877,14,50,64,133,34,0,62,88,254
1995,Jamal Mashburn,SF,22,DAL,80,80,2980,683,1566,0.436,113,344,0.328,570,1222,0.466,0.472,447,605,0.739,116,215,331,298,82,8,235,190,1926
1995,Tony Massenburg,C,27,LAC,80,50,2127,282,601,0.469,0,3,0,282,598,0.472,0.469,177,235,0.753,160,295,455,67,48,58,118,253,741
1995,Vernon Maxwell,SG,29,HOU,64,54,2038,306,777,0.394,143,441,0.324,163,336,0.485,0.486,99,144,0.688,18,146,164,274,75,13,137,157,854
1995,George McCloud,SF,27,DAL,42,3,802,144,328,0.439,34,89,0.382,110,239,0.46,0.491,80,96,0.833,82,65,147,53,23,9,40,71,402
1995,Xavier McDaniel,SF,31,BOS,68,15,1430,246,546,0.451,6,21,0.286,240,525,0.457,0.456,89,125,0.712,94,206,300,108,30,20,89,146,587
1995,Aaron McKie,SG,22,POR,45,20,827,116,261,0.444,11,28,0.393,105,233,0.451,0.466,50,73,0.685,35,94,129,89,36,16,39,97,293
1995,Anthony Miller,PF,23,LAL,46,1,527,70,132,0.53,2,5,0.4,68,127,0.535,0.538,47,76,0.618,67,85,152,35,20,7,38,77,189
1995,Oliver Miller,PF,24,DET,64,22,1558,232,418,0.555,3,13,0.231,229,405,0.565,0.559,78,124,0.629,162,313,475,93,60,116,115,217,545
1995,Terry Mills,PF,27,DET,72,69,2514,417,933,0.447,109,285,0.382,308,648,0.475,0.505,175,219,0.799,124,434,558,160,68,33,144,253,1118
1995,Eric Mobley,C,24,MIL,46,26,587,78,132,0.591,2,2,1,76,130,0.585,0.598,22,45,0.489,55,98,153,21,8,27,24,63,180
1995,Eric Montross,C,23,BOS,78,75,2315,307,575,0.534,0,1,0,307,574,0.535,0.534,167,263,0.635,196,370,566,36,29,61,112,299,781
1995,Alonzo Mourning,C,24,CHH,77,77,2941,571,1101,0.519,11,34,0.324,560,1067,0.525,0.524,490,644,0.761,200,561,761,111,49,225,241,275,1643
1995,Eric Murdock,PG,26,MIL,75,32,2158,338,814,0.415,90,240,0.375,248,574,0.432,0.471,211,267,0.79,48,166,214,482,113,12,194,139,977
1995,Tracy Murray,SF,23,POR,29,3,313,63,153,0.412,16,41,0.39,47,112,0.42,0.464,28,34,0.824,18,19,37,14,7,1,20,42,170
1995,Tracy Murray,SF,23,HOU,25,0,203,32,80,0.4,19,45,0.422,13,35,0.371,0.519,5,8,0.625,2,20,22,5,7,3,15,31,88
1995,Dikembe Mutombo,C,28,DEN,82,82,3100,349,628,0.556,0,0,NA,349,628,0.556,0.556,248,379,0.654,319,710,1029,113,40,321,192,284,946
1995,Pete Myers,SG,31,CHI,71,14,1270,119,287,0.415,10,39,0.256,109,248,0.44,0.432,70,114,0.614,57,82,139,148,58,15,88,125,318
1995,Johnny Newman,SF,31,MIL,82,11,1896,226,488,0.463,45,128,0.352,181,360,0.503,0.509,137,171,0.801,72,101,173,91,69,13,86,234,634
1995,Shaquille O'Neal,C,22,ORL,79,79,2923,930,1594,0.583,0,5,0,930,1589,0.585,0.583,455,854,0.533,328,573,901,214,73,192,204,258,2315
1995,Bo Outlaw,PF,23,LAC,81,31,1655,170,325,0.523,0,5,0,170,320,0.531,0.523,82,186,0.441,121,192,313,84,90,151,78,227,422
1995,Doug Overton,PG,25,WSB,82,20,1704,207,498,0.416,53,125,0.424,154,373,0.413,0.469,109,125,0.872,26,117,143,246,53,2,104,126,576
1995,Billy Owens,SG,25,MIA,70,60,2296,403,820,0.491,2,22,0.091,401,798,0.503,0.493,194,313,0.62,203,299,502,246,80,30,204,205,1002
1995,Robert Pack,PG,25,DEN,42,32,1144,170,395,0.43,30,72,0.417,140,323,0.433,0.468,137,175,0.783,19,94,113,290,61,6,134,101,507
1995,Gary Payton,PG,26,SEA,82,82,3015,685,1345,0.509,70,232,0.302,615,1113,0.553,0.535,249,348,0.716,108,173,281,583,204,13,201,206,1689
1995,Anthony Peeler,SG,25,LAL,73,24,1559,285,659,0.432,84,216,0.389,201,443,0.454,0.496,102,128,0.797,62,106,168,122,52,13,82,143,756
1995,Mike Peplowski,C,24,DET,6,0,21,5,5,1,0,0,NA,5,5,1,1,1,2,0.5,1,2,3,1,1,0,2,10,11
1995,Sam Perkins,C,33,SEA,82,37,2356,346,742,0.466,136,343,0.397,210,399,0.526,0.558,215,269,0.799,96,302,398,135,72,45,77,186,1043
1995,Elliot Perry,PG,25,PHO,82,51,1977,306,588,0.52,25,60,0.417,281,528,0.532,0.542,158,195,0.81,51,100,151,394,156,4,163,142,795
1995,Tim Perry,PF,29,PHI,42,1,446,27,78,0.346,0,14,0,27,64,0.422,0.346,22,40,0.55,38,51,89,12,10,15,21,51,76
1995,Wesley Person,SG,23,PHO,78,56,1800,309,638,0.484,116,266,0.436,193,372,0.519,0.575,80,101,0.792,67,134,201,105,48,24,79,149,814
1995,Ricky Pierce,PG,35,GSW,27,6,673,111,254,0.437,23,70,0.329,88,184,0.478,0.482,93,106,0.877,12,52,64,40,22,2,24,38,338
1995,Ed Pinckney,PF,31,MIL,62,17,835,48,97,0.495,0,0,NA,48,97,0.495,0.495,44,62,0.71,65,146,211,21,34,17,26,64,140
1995,Olden Polynice,C,30,SAC,81,81,2534,376,691,0.544,1,1,1,375,690,0.543,0.545,124,194,0.639,277,448,725,62,48,52,113,238,877
1995,Kevin Pritchard,PG,27,PHI,5,0,36,0,3,0,0,3,0,0,0,NA,0,1,4,0.25,0,1,1,11,0,0,5,3,1
1995,Kevin Pritchard,PG,27,MIA,14,0,158,13,29,0.448,2,5,0.4,11,24,0.458,0.483,15,17,0.882,0,11,11,23,2,1,7,19,43
1995,Kurt Rambis,PF,36,LAL,26,1,195,18,35,0.514,0,0,NA,18,35,0.514,0.514,8,12,0.667,10,24,34,16,3,9,8,35,44
1995,Mark Randall,PF,27,DEN,8,0,39,3,10,0.3,0,1,0,3,9,0.333,0.3,0,0,NA,4,8,12,1,0,0,1,5,6
1995,Eldridge Recasner,SG,27,DEN,3,0,13,1,6,0.167,0,1,0,1,5,0.2,0.167,4,4,1,0,2,2,1,3,0,2,0,6
1995,Khalid Reeves,PG,22,MIA,67,17,1462,206,465,0.443,67,171,0.392,139,294,0.473,0.515,140,196,0.714,52,134,186,288,77,10,132,139,619
1995,J.R. Reid,PF,26,SAS,81,37,1566,201,396,0.508,1,2,0.5,200,394,0.508,0.509,160,233,0.687,120,273,393,55,60,32,113,230,563
1995,Doc Rivers,PG,33,NYK,3,0,47,4,13,0.308,3,5,0.6,1,8,0.125,0.423,8,11,0.727,2,7,9,8,4,0,4,8,19
1995,Doc Rivers,PG,33,SAS,60,0,942,104,289,0.36,42,122,0.344,62,167,0.371,0.433,52,71,0.732,13,87,100,154,61,21,56,142,302
1995,Clifford Robinson,SF,28,POR,75,73,2725,597,1320,0.452,142,383,0.371,455,937,0.486,0.506,265,382,0.694,152,271,423,198,79,82,158,240,1601
1995,James Robinson,PG,24,POR,71,25,1539,255,624,0.409,76,223,0.341,179,401,0.446,0.47,65,110,0.591,42,90,132,180,48,13,127,142,651
1995,Carlos Rogers,C,23,GSW,49,18,1017,180,340,0.529,2,14,0.143,178,326,0.546,0.532,76,146,0.521,108,170,278,37,22,52,84,124,438
1995,Rodney Rogers,PF,23,DEN,80,77,2142,375,769,0.488,50,148,0.338,325,621,0.523,0.52,179,275,0.651,132,253,385,161,95,46,173,281,979
1995,Sean Rooks,C,25,MIN,80,70,2405,289,615,0.47,0,5,0,289,610,0.474,0.47,290,381,0.761,165,321,486,97,29,71,142,208,868
1995,Jalen Rose,SF,22,DEN,81,37,1798,227,500,0.454,36,114,0.316,191,386,0.495,0.49,173,234,0.739,57,160,217,389,65,22,160,206,663
1995,Donald Royal,SF,28,ORL,70,68,1841,206,434,0.475,0,4,0,206,430,0.479,0.475,223,299,0.746,83,196,279,198,45,16,125,156,635
1995,Clifford Rozier,C,22,GSW,66,34,1494,189,390,0.485,2,7,0.286,187,383,0.488,0.487,68,152,0.447,200,286,486,45,35,39,89,196,448
1995,John Salley,C,30,MIA,75,50,1955,197,395,0.499,0,0,NA,197,395,0.499,0.499,153,207,0.739,110,226,336,123,47,85,97,279,547
1995,Danny Schayes,C,35,PHO,69,27,823,126,248,0.508,1,1,1,125,247,0.506,0.51,50,69,0.725,57,151,208,89,20,37,64,170,303
1995,Steve Scheffler,C,27,SEA,18,0,102,12,23,0.522,0,0,NA,12,23,0.522,0.522,15,18,0.833,8,15,23,4,2,2,3,9,39
1995,Dennis Scott,SF,26,ORL,62,10,1499,283,645,0.439,150,352,0.426,133,293,0.454,0.555,86,114,0.754,25,121,146,131,45,14,57,119,802
1995,Rony Seikaly,C,29,GSW,36,35,1035,162,314,0.516,0,0,NA,162,314,0.516,0.516,111,160,0.694,77,189,266,45,20,37,104,122,435
1995,Brian Shaw,PG,28,ORL,78,9,1836,192,494,0.389,48,184,0.261,144,310,0.465,0.437,70,95,0.737,52,189,241,406,73,18,184,184,502
1995,Dickey Simpkins,PF,22,CHI,59,5,586,78,184,0.424,0,0,NA,78,184,0.424,0.424,50,72,0.694,60,91,151,37,10,7,45,72,206
1995,Reggie Slater,PF,24,DEN,25,0,236,40,81,0.494,0,0,NA,40,81,0.494,0.494,40,55,0.727,21,36,57,12,7,3,26,47,120
1995,Charles Smith,SF,29,NYK,76,58,2150,352,747,0.471,7,31,0.226,345,716,0.482,0.476,255,322,0.792,144,180,324,120,49,95,147,286,966
1995,Kenny Smith,PG,29,HOU,81,81,2030,287,593,0.484,142,331,0.429,145,262,0.553,0.604,126,148,0.851,27,128,155,323,71,10,123,109,842
1995,Michael Smith,PF,29,LAC,29,0,319,63,134,0.47,1,8,0.125,62,126,0.492,0.474,26,30,0.867,13,43,56,20,6,2,18,41,153
1995,Michael Smith,PF,22,SAC,82,0,1736,220,406,0.542,0,2,0,220,404,0.545,0.542,127,262,0.485,174,312,486,67,61,49,106,235,567
1995,Steve Smith,SG,25,MIA,2,2,62,11,29,0.379,2,12,0.167,9,17,0.529,0.414,17,22,0.773,4,2,6,7,2,1,4,9,41
1995,Steve Smith,SG,25,ATL,78,59,2603,417,976,0.427,135,404,0.334,282,572,0.493,0.496,295,349,0.845,100,170,270,267,60,32,151,216,1264
1995,Tony Smith,SG,26,LAL,61,4,1024,132,309,0.427,32,91,0.352,100,218,0.459,0.479,44,63,0.698,43,64,107,102,46,7,50,111,340
1995,Elmore Spencer,C,25,LAC,19,8,368,52,118,0.441,0,1,0,52,117,0.444,0.441,28,50,0.56,11,54,65,25,14,23,48,62,132
1995,Felton Spencer,C,27,UTA,34,34,905,105,215,0.488,0,0,NA,105,215,0.488,0.488,107,135,0.793,90,170,260,17,12,32,68,131,317
1995,John Starks,SG,29,NYK,80,78,2725,419,1062,0.395,217,611,0.355,202,451,0.448,0.497,168,228,0.737,34,185,219,411,92,4,160,257,1223
1995,Mark Strickland,PF,24,IND,4,0,9,1,3,0.333,0,0,NA,1,3,0.333,0.333,1,2,0.5,2,2,4,0,0,1,1,0,3
1995,Rod Strickland,PG,28,POR,64,61,2267,441,946,0.466,46,123,0.374,395,823,0.48,0.49,283,380,0.745,73,244,317,562,123,9,209,118,1211
1995,Greg Sutton,PG,27,CHH,53,4,690,94,230,0.409,43,115,0.374,51,115,0.443,0.502,32,45,0.711,8,48,56,91,33,2,51,114,263
1995,Žan Tabak,C,24,HOU,37,0,182,24,53,0.453,0,1,0,24,52,0.462,0.453,27,44,0.614,23,34,57,4,2,7,18,37,75
1995,Brooks Thompson,PG,24,ORL,38,2,246,45,114,0.395,18,58,0.31,27,56,0.482,0.474,8,12,0.667,7,16,23,43,10,2,27,46,116
1995,LaSalle Thompson,C,33,IND,38,3,453,49,118,0.415,0,0,NA,49,118,0.415,0.415,14,16,0.875,28,61,89,18,18,10,33,76,112
1995,Otis Thorpe,PF,32,HOU,36,35,1188,206,366,0.563,0,3,0,206,363,0.567,0.563,67,127,0.528,113,209,322,58,22,13,76,102,479
1995,Otis Thorpe,PF,32,POR,34,0,908,179,315,0.568,0,4,0,179,311,0.576,0.568,100,154,0.649,89,147,236,54,19,15,56,122,458
1995,Nick Van Exel,PG,23,LAL,80,80,2944,465,1107,0.42,183,511,0.358,282,596,0.473,0.503,235,300,0.783,27,196,223,660,97,6,220,157,1348
1995,Loy Vaught,PF,26,LAC,80,79,2966,609,1185,0.514,7,33,0.212,602,1152,0.523,0.517,176,248,0.71,261,511,772,139,104,29,166,243,1401
1995,Rex Walters,SG,24,NJN,80,30,1435,206,469,0.439,71,196,0.362,135,273,0.495,0.515,40,52,0.769,18,75,93,121,37,16,71,135,523
1995,Charlie Ward,PG,24,NYK,10,0,44,4,19,0.211,1,10,0.1,3,9,0.333,0.237,7,10,0.7,1,5,6,4,2,0,8,7,16
1995,Jamie Watson,SF,22,UTA,60,1,673,76,152,0.5,5,19,0.263,71,133,0.534,0.516,38,56,0.679,16,58,74,59,35,11,51,86,195
1995,Clarence Weatherspoon,SF,24,PHI,76,76,2991,543,1238,0.439,4,21,0.19,539,1217,0.443,0.44,283,377,0.751,144,382,526,215,115,67,191,195,1373
1995,Spud Webb,PG,31,SAC,76,76,2458,302,689,0.438,48,145,0.331,254,544,0.467,0.473,226,242,0.934,29,145,174,468,75,8,185,148,878
1995,Chris Webber,PF,21,WSB,54,52,2067,464,938,0.495,40,145,0.276,424,793,0.535,0.516,117,233,0.502,200,318,518,256,83,85,167,186,1085
1995,David Wesley,PG,24,BOS,51,36,1380,128,313,0.409,51,119,0.429,77,194,0.397,0.49,71,94,0.755,31,86,117,266,82,9,87,144,378
1995,Chris Whitney,PG,23,SAS,25,0,179,14,47,0.298,3,19,0.158,11,28,0.393,0.33,11,11,1,4,9,13,28,4,0,18,34,42
1995,Morlon Wiley,PG,28,DAL,38,2,407,47,111,0.423,29,75,0.387,18,36,0.5,0.554,7,10,0.7,6,33,39,69,21,1,19,44,130
1995,Morlon Wiley,PG,28,ATL,5,0,17,3,6,0.5,1,4,0.25,2,2,1,0.583,0,0,NA,0,4,4,6,1,1,4,0,7
1995,Dominique Wilkins,SF,35,BOS,77,64,2423,496,1169,0.424,112,289,0.388,384,880,0.436,0.472,266,340,0.782,157,244,401,166,61,14,173,130,1370
1995,Aaron Williams,PF,23,MIL,15,0,72,8,24,0.333,0,1,0,8,23,0.348,0.333,8,12,0.667,5,14,19,0,2,6,7,14,24
1995,Herb Williams,C,36,NYK,56,3,743,82,180,0.456,0,0,NA,82,180,0.456,0.456,23,37,0.622,23,109,132,27,13,45,40,108,187
1995,Lorenzo Williams,C,25,DAL,82,81,2383,145,304,0.477,0,0,NA,145,304,0.477,0.477,38,101,0.376,291,399,690,124,52,148,105,306,328
1995,Micheal Williams,PG,28,MIN,1,1,28,1,4,0.25,0,0,NA,1,4,0.25,0.25,4,5,0.8,0,1,1,3,2,0,3,3,6
1995,Monty Williams,SF,23,NYK,41,23,503,60,133,0.451,0,8,0,60,125,0.48,0.451,17,38,0.447,42,56,98,49,20,4,41,87,137
1995,Reggie Williams,SF,30,DEN,74,70,2198,388,846,0.459,85,266,0.32,303,580,0.522,0.509,132,174,0.759,94,235,329,231,114,67,124,264,993
1995,Scott Williams,PF,26,PHI,77,43,1781,206,434,0.475,0,7,0,206,427,0.482,0.475,79,107,0.738,173,312,485,59,71,40,84,237,491
1995,Walt Williams,SF,24,SAC,77,77,2739,445,998,0.446,103,296,0.348,342,702,0.487,0.497,266,364,0.731,100,245,345,316,123,63,243,265,1259
1995,Kevin Willis,PF,32,ATL,2,2,89,16,41,0.39,0,1,0,16,40,0.4,0.39,10,15,0.667,10,26,36,3,1,3,7,7,42
1995,Kevin Willis,PF,32,MIA,65,61,2301,457,974,0.469,3,14,0.214,454,960,0.473,0.471,195,282,0.691,217,479,696,83,59,33,155,208,1112
1995,Trevor Wilson,PF,26,SAC,15,0,147,18,40,0.45,0,0,NA,18,40,0.45,0.45,11,14,0.786,10,16,26,12,4,2,6,12,47
1995,Joe Wolf,PF,30,CHH,63,6,583,38,81,0.469,2,6,0.333,36,75,0.48,0.481,12,16,0.75,34,95,129,37,9,6,22,101,90
1995,David Wood,PF,30,GSW,78,13,1336,153,326,0.469,31,91,0.341,122,235,0.519,0.517,91,117,0.778,83,158,241,65,28,13,53,217,428
1995,Haywoode Workman,PG,29,IND,69,14,1028,101,269,0.375,35,98,0.357,66,171,0.386,0.441,55,74,0.743,21,90,111,194,59,5,73,115,292
1995,Sharone Wright,C,22,PHI,79,49,2044,361,776,0.465,0,8,0,361,768,0.47,0.465,182,282,0.645,191,281,472,48,37,104,151,246,904
1995,Danny Young,PG,32,MIL,7,0,77,9,17,0.529,5,12,0.417,4,5,0.8,0.676,1,1,1,1,4,5,12,4,0,4,8,24
1996,Cory Alexander,PG,22,SAS,60,0,560,63,155,0.406,26,66,0.394,37,89,0.416,0.49,16,25,0.64,9,33,42,121,27,2,68,94,168
1996,Jerome Allen,SG,23,MIN,41,0,362,36,105,0.343,10,33,0.303,26,72,0.361,0.39,26,36,0.722,5,20,25,49,21,5,34,42,108
1996,Greg Anderson,PF,31,SAS,46,7,344,24,47,0.511,0,1,0,24,46,0.522,0.511,6,25,0.24,29,71,100,10,9,24,22,66,54
1996,Kenny Anderson,PG,25,NJN,31,28,1042,143,380,0.376,36,99,0.364,107,281,0.381,0.424,151,188,0.803,37,64,101,247,52,8,58,73,473
1996,Kenny Anderson,PG,25,CHH,38,36,1302,206,454,0.454,56,157,0.357,150,297,0.505,0.515,109,150,0.727,26,76,102,328,59,6,88,105,577
1996,Willie Anderson,SG,29,TOR,49,42,1564,232,527,0.44,29,95,0.305,203,432,0.47,0.468,113,132,0.856,35,151,186,149,58,51,119,171,606
1996,Willie Anderson,SG,29,NYK,27,2,496,56,133,0.421,5,25,0.2,51,108,0.472,0.44,19,31,0.613,13,47,60,48,17,8,24,59,136
1996,Greg Anthony,PG,28,VAN,69,68,2096,324,781,0.415,90,271,0.332,234,510,0.459,0.472,229,297,0.771,29,145,174,476,116,11,160,137,967
1996,B.J. Armstrong,PG,28,GSW,82,64,2262,340,727,0.468,98,207,0.473,242,520,0.465,0.535,234,279,0.839,22,162,184,401,68,6,128,147,1012
1996,Darrell Armstrong,PG,27,ORL,13,0,41,16,32,0.5,6,12,0.5,10,20,0.5,0.594,4,4,1,0,2,2,5,6,0,6,4,42
1996,Vincent Askew,SG,29,SEA,69,2,1725,215,436,0.493,29,86,0.337,186,350,0.531,0.526,123,161,0.764,65,153,218,163,47,15,96,178,582
1996,Stacey Augmon,SF,27,ATL,77,49,2294,362,738,0.491,1,4,0.25,361,734,0.492,0.491,251,317,0.792,137,167,304,137,106,31,138,188,976
1996,Anthony Avent,PF,26,VAN,71,32,1586,179,466,0.384,0,0,NA,179,466,0.384,0.384,57,77,0.74,108,247,355,69,30,42,107,202,415
1996,Vin Baker,PF,24,MIL,82,82,3319,699,1429,0.489,10,48,0.208,689,1381,0.499,0.493,321,479,0.67,263,545,808,212,68,91,216,272,1729
1996,Brent Barry,SG,24,LAC,79,44,1898,283,597,0.474,123,296,0.416,160,301,0.532,0.577,111,137,0.81,38,130,168,230,95,22,120,196,800
1996,Jon Barry,SG,26,GSW,68,0,712,91,185,0.492,44,93,0.473,47,92,0.511,0.611,31,37,0.838,17,46,63,85,33,11,42,51,257
1996,Corey Beck,PG,24,CHH,5,0,33,2,8,0.25,0,0,NA,2,8,0.25,0.25,1,2,0.5,3,4,7,5,1,0,4,8,5
1996,Benoit Benjamin,C,31,VAN,13,13,404,71,161,0.441,0,0,NA,71,161,0.441,0.441,39,56,0.696,31,72,103,16,10,15,34,40,181
1996,Benoit Benjamin,C,31,MIL,70,58,1492,223,429,0.52,0,3,0,223,426,0.523,0.52,101,138,0.732,110,326,436,48,35,70,110,184,547
1996,Elmer Bennett,PG,25,PHI,8,0,66,4,17,0.235,0,0,NA,4,17,0.235,0.235,3,4,0.75,1,4,5,8,1,1,7,6,11
1996,David Benoit,SF,27,UTA,81,63,1961,255,581,0.439,64,192,0.333,191,389,0.491,0.494,87,112,0.777,90,293,383,82,43,49,71,166,661
1996,Travis Best,PG,23,IND,59,1,571,69,163,0.423,8,25,0.32,61,138,0.442,0.448,75,90,0.833,11,33,44,97,20,3,63,80,221
1996,Corie Blount,PF,27,LAL,57,2,715,79,167,0.473,0,2,0,79,165,0.479,0.473,25,44,0.568,69,101,170,42,25,35,47,109,183
1996,Muggsy Bogues,PG,31,CHH,6,0,77,6,16,0.375,0,1,0,6,15,0.4,0.375,2,2,1,6,1,7,19,2,0,6,4,14
1996,Melvin Booker,PG,23,HOU,11,0,131,16,50,0.32,3,19,0.158,13,31,0.419,0.35,9,11,0.818,1,8,9,21,5,1,12,18,44
1996,Shawn Bradley,C,23,PHI,12,11,334,43,97,0.443,0,0,NA,43,97,0.443,0.443,19,25,0.76,34,72,106,8,8,38,31,42,105
1996,Shawn Bradley,C,23,NJN,67,57,1995,344,776,0.443,1,4,0.25,343,772,0.444,0.444,150,221,0.679,187,345,532,55,41,250,148,244,839
1996,Terrell Brandon,PG,25,CLE,75,75,2570,510,1096,0.465,91,235,0.387,419,861,0.487,0.507,338,381,0.887,47,201,248,487,132,33,142,146,1449
1996,Frank Brickowski,C,36,SEA,63,8,986,123,252,0.488,32,79,0.405,91,173,0.526,0.552,61,86,0.709,26,125,151,58,26,8,78,185,339
1996,Scott Brooks,PG,30,DAL,69,0,716,134,293,0.457,25,62,0.403,109,231,0.472,0.5,59,69,0.855,11,30,41,100,42,3,43,53,352
1996,Chucky Brown,PF,27,HOU,82,82,2019,300,555,0.541,1,8,0.125,299,547,0.547,0.541,104,150,0.693,134,307,441,89,47,38,94,163,705
1996,Dee Brown,PG,27,BOS,65,23,1591,246,616,0.399,68,220,0.309,178,396,0.449,0.455,135,158,0.854,36,100,136,146,80,12,74,119,695
1996,Mark Bryant,PF,30,HOU,71,9,1587,242,446,0.543,0,2,0,242,444,0.545,0.543,127,177,0.718,131,220,351,52,31,19,85,234,611
1996,Jud Buechler,SF,27,CHI,74,0,740,112,242,0.463,40,90,0.444,72,152,0.474,0.545,14,22,0.636,45,66,111,56,34,7,39,70,278
1996,Scott Burrell,SF,25,CHH,20,20,693,92,206,0.447,37,98,0.378,55,108,0.509,0.536,42,56,0.75,26,72,98,47,27,13,43,76,263
1996,Jason Caffey,PF,22,CHI,57,0,545,71,162,0.438,0,1,0,71,161,0.441,0.438,40,68,0.588,51,60,111,24,12,7,48,91,182
1996,Adrian Caldwell,PF,29,IND,51,1,327,46,83,0.554,0,0,NA,46,83,0.554,0.554,18,36,0.5,42,68,110,6,9,5,35,73,110
1996,Elden Campbell,PF,27,LAL,82,82,2699,447,888,0.503,0,5,0,447,883,0.506,0.503,249,349,0.713,162,461,623,181,88,212,137,300,1143
1996,Antoine Carr,SF,34,UTA,80,0,1532,233,510,0.457,0,3,0,233,507,0.46,0.457,114,144,0.792,71,129,200,74,28,65,78,254,580
1996,Chris Carr,SG,21,PHO,60,10,590,90,217,0.415,11,42,0.262,79,175,0.451,0.44,49,60,0.817,27,75,102,43,10,5,40,77,240
1996,Sam Cassell,PG,26,HOU,61,0,1682,289,658,0.439,73,210,0.348,216,448,0.482,0.495,235,285,0.825,51,137,188,278,53,4,157,166,886
1996,Cedric Ceballos,SF,26,LAL,78,71,2628,638,1203,0.53,51,184,0.277,587,1019,0.576,0.552,329,409,0.804,215,321,536,119,94,22,167,144,1656
1996,Rex Chapman,SG,28,MIA,56,50,1865,289,679,0.426,125,337,0.371,164,342,0.48,0.518,83,113,0.735,22,123,145,166,45,10,79,117,786
1996,Pete Chilcutt,PF,27,HOU,74,0,651,73,179,0.408,37,98,0.378,36,81,0.444,0.511,17,26,0.654,51,105,156,26,19,14,22,65,200
1996,Randolph Childress,PG,23,POR,28,0,250,25,79,0.316,13,47,0.277,12,32,0.375,0.399,22,27,0.815,1,18,19,32,8,1,28,22,85
1996,Chris Childs,PG,28,NJN,78,54,2408,324,778,0.416,95,259,0.367,229,519,0.441,0.478,259,304,0.852,51,194,245,548,111,8,230,246,1002
1996,Doug Christie,SF,25,NYK,23,0,218,35,73,0.479,10,19,0.526,25,54,0.463,0.548,13,22,0.591,8,26,34,25,12,3,19,41,93
1996,Doug Christie,SF,25,TOR,32,17,818,115,264,0.436,36,87,0.414,79,177,0.446,0.504,56,71,0.789,26,94,120,92,58,16,76,100,322
1996,Bimbo Coles,PG,27,MIA,52,52,1882,231,559,0.413,63,172,0.366,168,387,0.434,0.47,139,173,0.803,38,163,201,296,63,12,123,175,664
1996,Bimbo Coles,PG,27,GSW,29,3,733,87,218,0.399,25,82,0.305,62,136,0.456,0.456,29,38,0.763,11,48,59,126,31,5,48,78,228
1996,Marty Conlon,C,28,MIL,74,1,958,153,327,0.468,5,30,0.167,148,297,0.498,0.476,84,110,0.764,58,119,177,68,20,11,79,126,395
1996,Anthony Cook,PF,28,POR,11,0,60,7,16,0.438,0,2,0,7,14,0.5,0.438,1,4,0.25,5,7,12,2,0,1,1,8,15
1996,Tyrone Corbin,SF,33,SAC,49,2,930,117,259,0.452,1,12,0.083,116,247,0.47,0.454,77,92,0.837,55,124,179,61,47,17,50,96,312
1996,Tyrone Corbin,SF,33,MIA,22,0,354,38,92,0.413,2,6,0.333,36,86,0.419,0.424,23,28,0.821,26,39,65,23,16,3,17,51,101
1996,Joe Courtney,PF,26,CLE,23,0,200,15,35,0.429,0,0,NA,15,35,0.429,0.429,8,18,0.444,24,25,49,9,5,6,17,35,38
1996,John Crotty,PG,26,CLE,58,4,617,51,114,0.447,8,27,0.296,43,87,0.494,0.482,62,72,0.861,20,34,54,102,22,6,51,60,172
1996,Terry Cummings,PF,34,MIL,81,13,1777,270,584,0.462,1,7,0.143,269,577,0.466,0.463,104,160,0.65,162,283,445,89,56,30,69,263,645
1996,Michael Curry,SF,27,WSB,5,0,34,3,10,0.3,0,3,0,3,7,0.429,0.3,4,4,1,2,3,5,1,1,0,1,3,10
1996,Michael Curry,SG,27,DET,41,1,749,70,151,0.464,20,50,0.4,50,101,0.495,0.53,41,58,0.707,25,55,80,26,23,2,23,89,201
1996,Sasha Danilović,SG,25,MIA,19,18,542,83,184,0.451,34,78,0.436,49,106,0.462,0.543,55,72,0.764,12,34,46,47,15,3,37,49,255
1996,Antonio Davis,PF,27,IND,82,14,2092,236,482,0.49,1,2,0.5,235,480,0.49,0.491,246,345,0.713,188,313,501,43,33,66,87,248,719
1996,Dale Davis,PF,26,IND,78,77,2617,334,599,0.558,0,0,NA,334,599,0.558,0.558,135,289,0.467,252,457,709,76,56,112,119,238,803
1996,Hubert Davis,SG,25,NYK,74,14,1773,275,566,0.486,127,267,0.476,148,299,0.495,0.598,112,129,0.868,35,88,123,103,31,8,63,120,789
1996,Todd Day,SG,26,MIL,8,0,171,22,71,0.31,5,25,0.2,17,46,0.37,0.345,24,26,0.923,8,14,22,5,4,3,11,27,73
1996,Todd Day,SG,26,BOS,71,12,1636,277,746,0.371,95,277,0.343,182,469,0.388,0.435,200,261,0.766,62,140,202,102,77,48,98,198,849
1996,Andrew DeClercq,C,22,GSW,22,1,203,24,50,0.48,0,1,0,24,49,0.49,0.48,11,19,0.579,18,21,39,9,7,5,4,30,59
1996,Terry Dehere,PG,24,LAC,82,10,2018,315,686,0.459,139,316,0.44,176,370,0.476,0.56,247,327,0.755,41,102,143,350,54,16,191,239,1016
1996,Vinny Del Negro,SG,29,SAS,82,82,2766,478,962,0.497,57,150,0.38,421,812,0.518,0.527,178,214,0.832,36,236,272,315,85,6,100,166,1191
1996,Sherman Douglas,PG,29,BOS,10,4,234,36,84,0.429,1,7,0.143,35,77,0.455,0.435,25,40,0.625,6,17,23,39,2,0,29,16,98
1996,Sherman Douglas,PG,29,MIL,69,62,2101,309,601,0.514,39,103,0.379,270,498,0.542,0.547,135,179,0.754,49,108,157,397,61,5,165,147,792
1996,Clyde Drexler,SG,33,HOU,52,51,1997,331,764,0.433,78,235,0.332,253,529,0.478,0.484,265,338,0.784,97,276,373,302,105,24,134,153,1005
1996,Chris Dudley,C,30,POR,80,61,1924,162,358,0.453,0,1,0,162,357,0.454,0.453,80,157,0.51,239,481,720,37,41,100,79,251,404
1996,Tony Dumas,SG,23,DAL,67,12,1284,274,655,0.418,74,207,0.357,200,448,0.446,0.475,154,257,0.599,58,57,115,99,42,13,77,128,776
1996,Acie Earl,C,25,TOR,42,7,655,117,276,0.424,0,3,0,117,273,0.429,0.424,82,114,0.719,51,78,129,27,18,37,49,73,316
1996,Blue Edwards,SF,30,VAN,82,82,2773,401,956,0.419,84,245,0.343,317,711,0.446,0.463,157,208,0.755,98,248,346,212,118,46,170,243,1043
1996,Kevin Edwards,SG,30,NJN,34,33,1007,142,390,0.364,42,104,0.404,100,286,0.35,0.418,68,84,0.81,14,61,75,71,54,7,68,67,394
1996,Howard Eisley,PG,23,UTA,65,0,961,104,242,0.43,14,62,0.226,90,180,0.5,0.459,65,77,0.844,22,56,78,146,29,3,77,130,287
1996,Mario Elie,SF,32,HOU,45,16,1385,180,357,0.504,41,127,0.323,139,230,0.604,0.562,98,115,0.852,47,108,155,138,45,11,59,93,499
1996,Dale Ellis,SF,35,DEN,81,52,2626,459,959,0.479,150,364,0.412,309,595,0.519,0.557,136,179,0.76,88,227,315,139,57,7,98,191,1204
1996,Michael Finley,SF,22,PHO,82,72,3212,465,976,0.476,61,186,0.328,404,790,0.511,0.508,242,323,0.749,139,235,374,289,85,31,133,199,1233
1996,Matt Fish,C,26,NYK,2,1,17,6,10,0.6,0,0,NA,6,10,0.6,0.6,0,1,0,3,0,3,1,0,1,0,3,12
1996,Matt Fish,C,26,DEN,16,0,117,15,26,0.577,0,0,NA,15,26,0.577,0.577,10,18,0.556,7,11,18,7,3,6,3,16,40
1996,Greg Foster,C,27,UTA,73,2,803,107,244,0.439,1,8,0.125,106,236,0.449,0.441,61,72,0.847,53,125,178,25,7,22,58,120,276
1996,Kevin Gamble,SF,30,MIA,44,13,1033,117,297,0.394,38,91,0.418,79,206,0.383,0.458,33,38,0.868,14,72,86,82,31,5,32,119,305
1996,Kevin Gamble,SF,30,SAC,21,0,292,35,82,0.427,6,23,0.261,29,59,0.492,0.463,5,10,0.5,7,20,27,18,4,3,11,28,81
1996,Kevin Garnett,SF,19,MIN,80,43,2293,361,735,0.491,8,28,0.286,353,707,0.499,0.497,105,149,0.705,175,326,501,145,86,131,110,189,835
1996,Chris Gatling,PF,28,GSW,47,2,862,171,308,0.555,0,1,0,171,307,0.557,0.555,84,132,0.636,78,164,242,26,19,29,60,135,426
1996,Chris Gatling,PF,28,MIA,24,0,565,155,259,0.598,0,0,NA,155,259,0.598,0.598,55,75,0.733,51,124,175,17,17,11,35,82,365
1996,Kendall Gill,SG,27,CHH,36,36,1265,179,372,0.481,17,54,0.315,162,318,0.509,0.504,89,117,0.761,56,133,189,225,42,22,110,101,464
1996,Kendall Gill,SG,27,NJN,11,10,418,67,152,0.441,9,25,0.36,58,127,0.457,0.47,49,59,0.831,16,27,43,35,22,2,21,30,192
1996,Armen Gilliam,SF,31,NJN,78,76,2856,576,1216,0.474,0,1,0,576,1215,0.474,0.474,277,350,0.791,241,472,713,140,73,53,177,180,1429
1996,Gerald Glass,SF,28,NJN,10,0,56,10,28,0.357,1,5,0.2,9,23,0.391,0.375,0,0,NA,5,1,6,4,2,1,0,5,21
1996,Gerald Glass,SF,28,CHH,5,0,15,2,5,0.4,0,1,0,2,4,0.5,0.4,1,1,1,1,1,2,0,1,0,0,5,5
1996,Anthony Goldwire,PG,24,CHH,42,8,621,76,189,0.402,33,83,0.398,43,106,0.406,0.489,46,60,0.767,8,35,43,112,16,0,63,79,231
1996,Greg Graham,SG,25,PHI,8,3,128,17,32,0.531,7,14,0.5,10,18,0.556,0.641,15,17,0.882,5,10,15,11,5,0,17,16,56
1996,Greg Graham,SG,25,NJN,45,2,485,61,161,0.379,25,68,0.368,36,93,0.387,0.457,37,51,0.725,12,30,42,41,20,1,29,48,184
1996,Ron Grandison,PF,31,MIA,18,3,235,13,39,0.333,4,13,0.308,9,26,0.346,0.385,13,19,0.684,14,22,36,10,8,1,11,27,43
1996,Ron Grandison,PF,31,ATL,4,0,19,2,4,0.5,0,1,0,2,3,0.667,0.5,0,0,NA,1,5,6,1,0,0,0,0,4
1996,Ron Grandison,PF,31,NYK,6,0,57,7,15,0.467,0,0,NA,7,15,0.467,0.467,4,6,0.667,5,8,13,2,4,1,1,4,18
1996,Greg Grant,PG,29,PHI,11,2,280,18,48,0.375,4,18,0.222,14,30,0.467,0.417,5,6,0.833,3,18,21,60,12,2,15,28,45
1996,Greg Grant,PG,29,WSB,10,0,138,11,28,0.393,2,10,0.2,9,18,0.5,0.429,0,0,NA,1,5,6,23,8,0,10,8,24
1996,Greg Grant,PG,29,DEN,10,0,109,6,23,0.261,2,6,0.333,4,17,0.235,0.304,0,0,NA,3,4,7,14,2,0,5,7,14
1996,A.C. Green,SF,32,PHO,82,36,2113,215,444,0.484,14,52,0.269,201,392,0.513,0.5,168,237,0.709,166,388,554,72,45,23,79,141,612
1996,Tom Gugliotta,PF,26,MIN,78,78,2835,473,1004,0.471,26,86,0.302,447,918,0.487,0.484,289,374,0.773,176,514,690,238,139,96,234,265,1261
1996,Jack Haley,C,32,CHI,1,0,7,2,6,0.333,0,0,NA,2,6,0.333,0.333,1,2,0.5,1,1,2,0,0,0,1,2,5
1996,Geert Hammink,C,26,ORL,3,0,7,1,2,0.5,0,0,NA,1,2,0.5,0.5,2,4,0.5,2,1,3,0,0,0,2,1,4
1996,Geert Hammink,C,26,GSW,3,0,10,1,2,0.5,0,0,NA,1,2,0.5,0.5,2,3,0.667,0,1,1,0,0,0,0,1,4
1996,Tom Hammonds,PF,28,DEN,71,4,1045,127,268,0.474,0,0,NA,127,268,0.474,0.474,88,115,0.765,85,138,223,23,23,13,48,137,342
1996,Darrin Hancock,SF,24,CHH,63,7,838,112,214,0.523,1,3,0.333,111,211,0.526,0.526,47,73,0.644,40,58,98,47,28,5,56,94,272
1996,Anfernee Hardaway,PG,24,ORL,82,82,3015,623,1215,0.513,89,283,0.314,534,932,0.573,0.549,445,580,0.767,129,225,354,582,166,41,229,160,1780
1996,Tim Hardaway,PG,29,GSW,52,18,1487,255,606,0.421,85,232,0.366,170,374,0.455,0.491,140,182,0.769,22,109,131,360,74,11,125,131,735
1996,Tim Hardaway,PG,29,MIA,28,28,1047,164,386,0.425,53,147,0.361,111,239,0.464,0.494,101,123,0.821,13,85,98,280,58,6,110,70,482
1996,Derek Harper,PG,34,NYK,82,82,2893,436,939,0.464,121,325,0.372,315,614,0.513,0.529,156,206,0.757,32,170,202,352,131,5,178,201,1149
1996,Ron Harper,PG,32,CHI,80,80,1886,234,501,0.467,28,104,0.269,206,397,0.519,0.495,98,139,0.705,74,139,213,208,105,32,73,137,594
1996,Antonio Harvey,PF,25,VAN,18,6,410,39,95,0.411,0,2,0,39,93,0.419,0.411,20,43,0.465,27,67,94,9,14,21,18,38,98
1996,Antonio Harvey,PF,25,LAC,37,9,411,44,129,0.341,0,0,NA,44,129,0.341,0.341,18,40,0.45,42,64,106,6,13,26,26,38,106
1996,Carl Herrera,PF,29,SAS,44,6,393,40,97,0.412,0,1,0,40,96,0.417,0.412,5,17,0.294,30,51,81,16,9,8,29,61,85
1996,Sean Higgins,SF,27,PHI,44,4,916,134,323,0.415,48,129,0.372,86,194,0.443,0.489,35,37,0.946,20,72,92,55,24,11,49,90,351
1996,Tyrone Hill,PF,27,CLE,44,2,929,130,254,0.512,0,0,NA,130,254,0.512,0.512,81,135,0.6,94,150,244,33,31,20,64,144,341
1996,Donald Hodge,C,26,DAL,13,0,113,9,24,0.375,0,0,NA,9,24,0.375,0.375,0,0,NA,9,13,22,4,1,8,2,26,18
1996,Donald Hodge,C,26,CHH,2,0,2,0,0,NA,0,0,NA,0,0,NA,NA,0,0,NA,0,1,1,0,0,0,0,0,0
1996,Jeff Hornacek,SG,32,UTA,82,59,2588,442,880,0.502,104,223,0.466,338,657,0.514,0.561,259,290,0.893,62,147,209,340,106,20,127,171,1247
1996,Robert Horry,SF,25,HOU,71,71,2634,300,732,0.41,142,388,0.366,158,344,0.459,0.507,111,143,0.776,97,315,412,281,116,109,160,197,853
1996,Juwan Howard,PF,22,WSB,81,81,3294,733,1500,0.489,4,13,0.308,729,1487,0.49,0.49,319,426,0.749,188,472,660,360,67,39,303,269,1789
1996,Bobby Hurley,PG,24,SAC,72,22,1059,65,230,0.283,22,76,0.289,43,154,0.279,0.33,68,85,0.8,12,63,75,216,28,3,86,121,220
1996,Jim Jackson,SG,25,DAL,82,82,2820,569,1308,0.435,121,333,0.363,448,975,0.459,0.481,345,418,0.825,173,237,410,235,47,22,191,165,1604
1996,Mark Jackson,PG,30,IND,81,81,2643,296,626,0.473,64,149,0.43,232,477,0.486,0.524,150,191,0.785,66,241,307,635,100,5,201,153,806
1996,Henry James,PF,30,HOU,7,0,58,10,24,0.417,5,15,0.333,5,9,0.556,0.521,5,5,1,3,3,6,2,0,0,4,13,30
1996,Avery Johnson,PG,30,SAS,82,82,3084,438,887,0.494,6,31,0.194,432,856,0.505,0.497,189,262,0.721,37,169,206,789,119,21,195,179,1071
1996,Eddie Johnson,SF,36,IND,62,1,1002,180,436,0.413,45,128,0.352,135,308,0.438,0.464,70,79,0.886,45,108,153,69,20,4,56,104,475
1996,Eddie Jones,SG,24,LAL,70,66,2184,337,685,0.492,83,227,0.366,254,458,0.555,0.553,136,184,0.739,45,188,233,246,129,45,99,162,893
1996,Reggie Jordan,PG,28,ATL,24,0,247,36,71,0.507,0,0,NA,36,71,0.507,0.507,22,38,0.579,23,29,52,29,12,7,19,30,94
1996,Tim Kempton,PF,32,ATL,3,0,11,0,0,NA,0,0,NA,0,0,NA,NA,0,0,NA,0,2,2,1,0,0,1,5,0
1996,Steve Kerr,PG,30,CHI,82,0,1919,244,482,0.506,122,237,0.515,122,245,0.498,0.633,78,84,0.929,25,85,110,192,63,2,42,109,688
1996,Randolph Keys,SF,29,MIL,69,1,816,87,208,0.418,22,71,0.31,65,137,0.474,0.471,36,43,0.837,41,84,125,65,32,14,33,139,232
1996,Jason Kidd,PG,22,DAL,81,81,3034,493,1293,0.381,133,396,0.336,360,897,0.401,0.433,229,331,0.692,203,350,553,783,175,26,328,155,1348
1996,Stacey King,PF,29,MIA,15,0,156,17,36,0.472,0,0,NA,17,36,0.472,0.472,4,8,0.5,9,14,23,2,7,2,18,39,38
1996,Joe Kleine,C,34,PHO,56,9,663,71,169,0.42,2,7,0.286,69,162,0.426,0.426,20,25,0.8,36,96,132,44,13,6,37,113,164
1996,Toni Kukoč,SF,27,CHI,81,20,2103,386,787,0.49,87,216,0.403,299,571,0.524,0.546,206,267,0.772,115,208,323,287,64,28,114,150,1065
1996,Christian Laettner,C,26,MIN,44,44,1518,283,582,0.486,9,31,0.29,274,551,0.497,0.494,217,266,0.816,98,204,302,129,40,43,112,157,792
1996,Christian Laettner,C,26,ATL,30,27,977,159,325,0.489,0,8,0,159,317,0.502,0.489,107,130,0.823,86,150,236,68,31,28,75,119,425
1996,Andrew Lang,C,29,ATL,51,51,1815,281,619,0.454,0,3,0,281,616,0.456,0.454,95,118,0.805,111,223,334,62,35,85,94,178,657
1996,Andrew Lang,C,29,MIN,20,18,550,72,171,0.421,1,2,0.5,71,169,0.42,0.424,30,38,0.789,42,79,121,3,7,41,30,63,175
1996,Antonio Lang,SF,23,CLE,41,0,367,41,77,0.532,0,2,0,41,75,0.547,0.532,34,47,0.723,17,36,53,12,14,12,24,61,116
1996,Eric Leckner,C,29,DET,18,8,155,18,29,0.621,0,0,NA,18,29,0.621,0.621,8,13,0.615,8,26,34,1,2,4,11,30,44
1996,Tim Legler,SG,29,WSB,77,0,1775,233,460,0.507,128,245,0.522,105,215,0.488,0.646,132,153,0.863,29,111,140,136,45,12,45,141,726
1996,Voshon Lenard,SG,22,MIA,30,0,323,53,141,0.376,36,101,0.356,17,40,0.425,0.504,34,43,0.791,12,40,52,31,6,1,23,31,176
1996,Alton Lister,C,37,MIL,7,5,88,4,9,0.444,0,0,NA,4,9,0.444,0.444,2,2,1,7,22,29,4,0,3,4,15,10
1996,Alton Lister,C,37,BOS,57,14,647,47,96,0.49,0,0,NA,47,96,0.49,0.49,39,62,0.629,60,191,251,15,6,39,44,121,133
1996,Brad Lohaus,PF,31,SAS,32,1,273,39,96,0.406,27,65,0.415,12,31,0.387,0.547,2,3,0.667,5,28,33,17,2,7,9,34,107
1996,Brad Lohaus,PF,31,NYK,23,7,325,32,79,0.405,24,57,0.421,8,22,0.364,0.557,2,2,1,2,29,31,27,8,10,11,36,90
1996,Grant Long,PF,29,ATL,82,82,3008,395,838,0.471,31,86,0.36,364,752,0.484,0.49,257,337,0.763,248,540,788,183,108,34,157,233,1078
1996,Luc Longley,C,27,CHI,62,62,1641,242,502,0.482,0,0,NA,242,502,0.482,0.482,80,103,0.777,104,214,318,119,22,84,114,223,564
1996,Sam Mack,SF,25,HOU,31,20,868,121,287,0.422,54,135,0.4,67,152,0.441,0.516,39,46,0.848,18,80,98,79,22,9,28,75,335
1996,Mark Macon,PG,26,DET,23,0,287,29,67,0.433,7,15,0.467,22,52,0.423,0.485,9,11,0.818,10,12,22,16,15,0,9,34,74
1996,Jeff Malone,SG,34,PHI,25,3,407,63,160,0.394,5,16,0.313,58,144,0.403,0.409,24,26,0.923,8,24,32,19,13,0,19,19,155
1996,Jeff Malone,SG,34,MIA,7,0,103,13,33,0.394,0,0,NA,13,33,0.394,0.394,5,6,0.833,0,8,8,7,3,0,3,6,31
1996,Danny Manning,PF,29,PHO,33,4,816,178,388,0.459,3,14,0.214,175,374,0.468,0.463,82,109,0.752,30,113,143,65,38,24,77,121,441
1996,Rich Manning,PF,25,VAN,29,0,311,49,113,0.434,0,1,0,49,112,0.438,0.434,9,14,0.643,16,39,55,7,3,6,17,37,107
1996,Donyell Marshall,SF,22,GSW,62,6,934,125,314,0.398,28,94,0.298,97,220,0.441,0.443,64,83,0.771,65,148,213,49,22,31,48,83,342
1996,Darrick Martin,PG,24,VAN,24,0,402,59,131,0.45,5,22,0.227,54,109,0.495,0.469,38,46,0.826,13,25,38,61,27,1,37,47,161
1996,Darrick Martin,PG,24,MIN,35,16,747,88,231,0.381,15,47,0.319,73,184,0.397,0.413,63,74,0.851,3,41,44,156,26,2,70,76,254
1996,Jamal Mashburn,SF,23,DAL,18,18,669,145,383,0.379,35,102,0.343,110,281,0.391,0.424,97,133,0.729,37,60,97,50,14,3,55,39,422
1996,Tony Massenburg,PF,28,TOR,24,20,659,100,196,0.51,0,0,NA,100,196,0.51,0.51,43,65,0.662,52,114,166,18,13,9,35,67,243
1996,Tony Massenburg,PF,28,PHI,30,8,804,114,236,0.483,0,3,0,114,233,0.489,0.483,68,92,0.739,75,111,186,12,15,11,38,73,296
1996,Vernon Maxwell,PG,30,PHI,75,57,2467,410,1052,0.39,146,460,0.317,264,592,0.446,0.459,251,332,0.756,39,190,229,330,96,12,215,182,1217
1996,George McCloud,SF,28,DAL,79,63,2846,530,1281,0.414,257,678,0.379,273,603,0.453,0.514,180,224,0.804,116,263,379,212,113,38,166,212,1497
1996,Antonio McDyess,PF,21,DEN,76,75,2280,427,881,0.485,0,4,0,427,877,0.487,0.485,166,243,0.683,229,343,572,75,54,114,154,250,1020
1996,Aaron McKie,SG,23,POR,81,73,2259,337,722,0.467,38,117,0.325,299,605,0.494,0.493,152,199,0.764,86,218,304,205,92,21,135,205,864
1996,Loren Meyer,C,23,DAL,72,21,1266,145,330,0.439,3,11,0.273,142,319,0.445,0.444,70,102,0.686,114,205,319,57,20,32,67,224,363
1996,Anthony Miller,PF,24,LAL,27,0,123,15,35,0.429,0,2,0,15,33,0.455,0.429,6,10,0.6,11,14,25,4,4,1,8,19,36
1996,Oliver Miller,PF,25,TOR,76,72,2516,418,795,0.526,0,11,0,418,784,0.533,0.526,146,221,0.661,177,385,562,219,108,143,202,277,982
1996,Terry Mills,PF,28,DET,82,5,1656,283,675,0.419,82,207,0.396,201,468,0.429,0.48,121,157,0.771,108,244,352,98,42,20,98,197,769
1996,Eric Mobley,C,25,MIL,5,3,65,2,7,0.286,0,0,NA,2,7,0.286,0.286,2,4,0.5,3,9,12,0,1,1,1,5,6
1996,Eric Mobley,C,25,VAN,34,1,611,72,131,0.55,1,2,0.5,71,129,0.55,0.553,37,83,0.446,51,77,128,22,13,23,49,82,182
1996,Eric Montross,C,24,BOS,61,59,1432,196,346,0.566,0,0,NA,196,346,0.566,0.566,50,133,0.376,119,233,352,43,19,29,83,181,442
1996,Alonzo Mourning,C,25,MIA,70,70,2671,563,1076,0.523,9,30,0.3,554,1046,0.53,0.527,488,712,0.685,218,509,727,159,70,189,262,245,1623
1996,Todd Mundt,C,25,ATL,24,0,118,13,32,0.406,0,0,NA,13,32,0.406,0.406,5,8,0.625,10,15,25,2,1,4,3,23,31
1996,Todd Mundt,C,25,BOS,9,0,33,3,9,0.333,0,0,NA,3,9,0.333,0.333,0,0,NA,1,2,3,1,1,1,0,6,6
1996,Eric Murdock,PG,27,MIL,9,0,193,24,66,0.364,6,23,0.261,18,43,0.419,0.409,8,12,0.667,5,9,14,35,6,0,12,16,62
1996,Eric Murdock,PG,27,VAN,64,14,1480,220,521,0.422,39,122,0.32,181,399,0.454,0.46,106,131,0.809,21,134,155,292,129,9,120,124,585
1996,Tracy Murray,SF,24,TOR,82,37,2458,496,1092,0.454,151,358,0.422,345,734,0.47,0.523,182,219,0.831,114,238,352,131,87,40,132,208,1325
1996,Dikembe Mutombo,C,29,DEN,74,74,2713,284,569,0.499,0,1,0,284,568,0.5,0.499,246,354,0.695,249,622,871,108,38,332,150,258,814
1996,Pete Myers,SG,32,MIA,39,1,639,62,160,0.388,11,42,0.262,51,118,0.432,0.422,49,76,0.645,21,52,73,97,14,11,56,75,184
1996,Pete Myers,SG,32,CHH,32,1,453,29,87,0.333,3,16,0.188,26,71,0.366,0.351,31,46,0.674,14,53,67,48,20,6,25,57,92
1996,Johnny Newman,SG,32,MIL,82,82,2690,321,649,0.495,61,162,0.377,260,487,0.534,0.542,186,232,0.802,66,134,200,154,90,15,108,257,889
1996,Ed O'Bannon,SG,23,NJN,64,29,1253,156,400,0.39,10,56,0.179,146,344,0.424,0.403,77,108,0.713,65,103,168,63,44,11,62,95,399
1996,Shaquille O'Neal,C,23,ORL,54,52,1946,592,1033,0.573,1,2,0.5,591,1031,0.573,0.574,249,511,0.487,182,414,596,155,34,115,155,193,1434
1996,Dan O'Sullivan,C,27,TOR,5,2,139,13,35,0.371,0,1,0,13,34,0.382,0.371,7,8,0.875,13,19,32,2,2,4,5,13,33
1996,Bo Outlaw,PF,24,LAC,80,3,985,107,186,0.575,0,3,0,107,183,0.585,0.575,72,162,0.444,87,113,200,50,44,91,45,127,286
1996,Doug Overton,PG,26,DEN,55,0,607,67,178,0.376,8,26,0.308,59,152,0.388,0.399,40,55,0.727,8,55,63,106,13,5,40,49,182
1996,Billy Owens,SF,26,MIA,40,40,1388,239,473,0.505,0,6,0,239,467,0.512,0.505,112,177,0.633,94,192,286,134,30,22,113,132,590
1996,Billy Owens,SF,26,SAC,22,11,594,84,200,0.42,5,12,0.417,79,188,0.42,0.433,45,70,0.643,49,76,125,70,19,16,51,60,218
1996,Robert Pack,PG,26,WSB,31,31,1084,190,444,0.428,26,98,0.265,164,346,0.474,0.457,154,182,0.846,29,103,132,242,62,1,114,68,560
1996,Cherokee Parks,C,23,DAL,64,3,869,101,247,0.409,7,26,0.269,94,221,0.425,0.423,41,62,0.661,66,150,216,29,25,32,31,100,250
1996,Gary Payton,PG,27,SEA,81,81,3162,618,1276,0.484,98,299,0.328,520,977,0.532,0.523,229,306,0.748,104,235,339,608,231,19,260,221,1563
1996,Anthony Peeler,SG,26,LAL,73,12,1608,272,602,0.452,105,254,0.413,167,348,0.48,0.539,61,86,0.709,45,92,137,118,59,10,56,139,710
1996,Mike Peplowski,C,25,WSB,2,0,5,0,0,NA,0,0,NA,0,0,NA,NA,0,0,NA,0,0,0,0,0,0,0,4,0
1996,Mike Peplowski,C,25,MIL,5,0,12,3,5,0.6,0,0,NA,3,5,0.6,0.6,1,3,0.333,1,3,4,1,1,2,2,6,7
1996,Sam Perkins,PF,34,SEA,82,20,2169,325,797,0.408,129,363,0.355,196,434,0.452,0.489,191,241,0.793,101,266,367,120,83,48,82,174,970
1996,Elliot Perry,PG,26,PHO,81,26,1668,261,549,0.475,24,59,0.407,237,490,0.484,0.497,151,194,0.778,34,102,136,353,87,5,146,140,697
1996,Tim Perry,PF,30,PHI,8,0,87,8,18,0.444,1,1,1,7,17,0.412,0.472,2,3,0.667,6,7,13,2,2,3,3,5,19
1996,Tim Perry,PF,30,NJN,22,1,167,23,47,0.489,3,7,0.429,20,40,0.5,0.521,3,6,0.5,15,20,35,6,2,10,7,11,52
1996,Wesley Person,SG,24,PHO,82,47,2609,390,877,0.445,117,313,0.374,273,564,0.484,0.511,148,192,0.771,56,265,321,138,55,22,89,148,1045
1996,Ricky Pierce,SG,36,IND,76,2,1404,264,590,0.447,35,104,0.337,229,486,0.471,0.477,174,205,0.849,40,96,136,101,57,6,93,188,737
1996,Ed Pinckney,PF,32,TOR,47,24,1031,117,233,0.502,0,3,0,117,230,0.509,0.502,94,124,0.758,115,167,282,50,31,17,54,101,328
1996,Ed Pinckney,PF,32,PHI,27,23,679,54,102,0.529,0,0,NA,54,102,0.529,0.529,42,55,0.764,74,102,176,22,33,11,23,55,150
1996,Olden Polynice,C,31,SAC,81,80,2441,431,818,0.527,1,3,0.333,430,815,0.528,0.528,122,203,0.601,257,507,764,58,52,66,127,250,985
1996,Kevin Pritchard,PG,28,WSB,2,0,22,2,3,0.667,1,1,1,1,2,0.5,0.833,2,3,0.667,0,2,2,7,2,0,0,3,7
1996,Theo Ratliff,C,22,DET,75,2,1305,128,230,0.557,0,1,0,128,229,0.559,0.557,85,120,0.708,110,187,297,13,16,116,56,144,341
1996,Eldridge Recasner,SG,28,HOU,63,27,1275,149,359,0.415,81,191,0.424,68,168,0.405,0.528,57,66,0.864,31,113,144,170,23,5,61,111,436
1996,Khalid Reeves,PG,23,CHH,20,5,418,54,118,0.458,11,36,0.306,43,82,0.524,0.504,43,51,0.843,11,29,40,72,16,1,30,46,162
1996,Khalid Reeves,PG,23,NJN,31,7,415,41,109,0.376,17,55,0.309,24,54,0.444,0.454,18,31,0.581,7,32,39,46,21,2,33,69,117
1996,Don Reid,PF,22,DET,69,46,997,106,187,0.567,0,0,NA,106,187,0.567,0.567,51,77,0.662,78,125,203,11,47,40,41,199,263
1996,J.R. Reid,PF,27,SAS,32,5,643,72,164,0.439,0,1,0,72,163,0.442,0.439,64,87,0.736,35,88,123,14,25,10,49,98,208
1996,J.R. Reid,PF,27,NYK,33,16,670,88,160,0.55,0,0,NA,88,160,0.55,0.55,43,55,0.782,38,94,132,28,18,7,30,89,219
1996,Terrence Rencher,PG,22,MIA,34,1,397,32,99,0.323,9,29,0.31,23,70,0.329,0.369,30,43,0.698,9,33,42,54,16,1,41,36,103
1996,Terrence Rencher,PG,22,PHO,2,0,8,1,1,1,0,0,NA,1,1,1,1,1,3,0.333,0,2,2,0,0,1,2,1,3
1996,Shawn Respert,SG,23,MIL,62,0,845,113,292,0.387,42,122,0.344,71,170,0.418,0.459,35,42,0.833,28,46,74,68,32,4,42,67,303
1996,Doc Rivers,PG,34,SAS,78,0,1235,108,290,0.372,47,137,0.343,61,153,0.399,0.453,48,64,0.75,30,108,138,123,73,21,57,175,311
1996,Alvin Robertson,SG,33,TOR,77,69,2478,285,607,0.47,41,151,0.272,244,456,0.535,0.503,107,158,0.677,110,232,342,323,166,36,183,268,718
1996,Clifford Robinson,SF,29,POR,78,76,2980,553,1306,0.423,178,471,0.378,375,835,0.449,0.492,360,542,0.664,123,320,443,190,86,68,194,248,1644
1996,James Robinson,PG,25,POR,76,5,1627,229,574,0.399,102,284,0.359,127,290,0.438,0.488,89,135,0.659,44,113,157,150,34,16,111,146,649
1996,Rumeal Robinson,PG,29,POR,43,14,715,92,221,0.416,30,79,0.38,62,142,0.437,0.484,33,51,0.647,19,59,78,142,26,5,72,79,247
1996,Carlos Rogers,PF,24,TOR,56,18,1043,178,344,0.517,3,21,0.143,175,323,0.542,0.522,71,130,0.546,80,90,170,35,25,48,61,87,430
1996,Rodney Rogers,SF,24,LAC,67,51,1950,306,641,0.477,49,153,0.32,257,488,0.527,0.516,113,180,0.628,113,173,286,167,75,35,144,216,774
1996,Sean Rooks,C,26,MIN,49,7,902,112,227,0.493,1,6,0.167,111,221,0.502,0.496,106,159,0.667,60,144,204,38,19,28,49,106,331
1996,Sean Rooks,C,26,ATL,16,0,215,32,58,0.552,0,1,0,32,57,0.561,0.552,29,43,0.674,21,30,51,9,4,14,31,35,93
1996,Jalen Rose,SG,23,DEN,80,37,2134,290,604,0.48,32,108,0.296,258,496,0.52,0.507,191,277,0.69,46,214,260,495,53,39,234,229,803
1996,Donald Royal,SF,29,ORL,64,7,963,106,216,0.491,0,2,0,106,214,0.495,0.491,125,164,0.762,57,96,153,42,29,15,52,97,337
1996,Clifford Rozier,C,23,GSW,59,1,723,79,135,0.585,0,2,0,79,133,0.594,0.585,26,55,0.473,71,100,171,22,19,30,40,135,184
1996,John Salley,PF,31,TOR,25,6,482,51,105,0.486,0,0,NA,51,105,0.486,0.486,47,65,0.723,26,71,97,39,11,12,39,72,149
1996,John Salley,PF,31,CHI,17,0,191,12,35,0.343,0,0,NA,12,35,0.343,0.343,12,20,0.6,20,23,43,15,8,15,16,38,36
1996,Danny Schayes,C,36,MIA,32,6,399,32,94,0.34,0,0,NA,32,94,0.34,0.34,37,46,0.804,29,60,89,9,11,16,23,60,101
1996,Steve Scheffler,C,28,SEA,35,2,181,24,45,0.533,1,5,0.2,23,40,0.575,0.544,9,19,0.474,15,18,33,2,6,2,8,25,58
1996,Dennis Scott,SF,27,ORL,82,82,3041,491,1117,0.44,267,628,0.425,224,489,0.458,0.559,182,222,0.82,63,246,309,243,90,29,122,169,1431
1996,Rony Seikaly,C,30,GSW,64,60,1813,285,568,0.502,2,3,0.667,283,565,0.501,0.504,204,282,0.723,166,333,499,71,40,69,180,219,776
1996,Brian Shaw,PG,29,ORL,75,1,1679,182,486,0.374,41,144,0.285,141,342,0.412,0.417,91,114,0.798,58,166,224,336,58,11,173,160,496
1996,Dickey Simpkins,PF,23,CHI,60,12,685,77,160,0.481,1,1,1,76,159,0.478,0.484,61,97,0.629,66,90,156,38,9,8,56,78,216
1996,Reggie Slater,PF,25,POR,4,0,20,3,5,0.6,0,0,NA,3,5,0.6,0.6,0,0,NA,0,3,3,0,1,2,3,1,6
1996,Reggie Slater,PF,25,DEN,4,0,26,6,11,0.545,0,0,NA,6,11,0.545,0.545,2,5,0.4,3,4,7,2,1,1,3,4,14
1996,Reggie Slater,PF,25,DAL,3,0,26,5,11,0.455,0,0,NA,5,11,0.455,0.455,1,2,0.5,1,4,5,0,0,0,3,6,11
1996,Charles Smith,PG,28,MIN,8,0,39,3,10,0.3,0,3,0,3,7,0.429,0.3,0,2,0,0,5,5,6,1,0,5,7,6
1996,Charles Smith,PF,30,NYK,41,4,890,114,294,0.388,2,15,0.133,112,279,0.401,0.391,73,103,0.709,59,101,160,29,18,51,61,124,303
1996,Charles Smith,PF,30,SAS,32,30,826,130,284,0.458,0,0,NA,130,284,0.458,0.458,46,60,0.767,74,128,202,36,32,29,45,100,306
1996,Joe Smith,PF,20,GSW,82,82,2821,469,1024,0.458,10,28,0.357,459,996,0.461,0.463,303,392,0.773,300,417,717,79,85,134,138,224,1251
1996,Kenny Smith,PG,30,HOU,68,56,1617,201,464,0.433,91,238,0.382,110,226,0.487,0.531,87,106,0.821,21,75,96,245,47,3,100,116,580
1996,Michael Smith,PF,23,SAC,65,0,1384,144,238,0.605,1,1,1,143,237,0.603,0.607,68,177,0.384,143,246,389,110,47,46,72,166,357
1996,Steve Smith,SG,26,ATL,80,80,2856,494,1143,0.432,140,423,0.331,354,720,0.492,0.493,318,385,0.826,124,202,326,224,68,17,151,207,1446
1996,Tony Smith,SG,27,PHO,34,2,528,70,173,0.405,25,77,0.325,45,96,0.469,0.477,24,37,0.649,24,32,56,86,21,5,40,60,189
1996,Tony Smith,SG,27,MIA,25,1,410,46,101,0.455,13,39,0.333,33,62,0.532,0.52,4,9,0.444,6,33,39,68,16,5,26,46,109
1996,Eric Snow,PG,22,SEA,43,1,389,42,100,0.42,2,10,0.2,40,90,0.444,0.43,29,49,0.592,9,34,43,73,28,0,38,53,115
1996,Elmore Spencer,C,26,DEN,6,0,21,0,1,0,0,0,NA,0,1,0,0,0,0,NA,1,3,4,0,0,0,3,8,0
1996,Elmore Spencer,C,26,POR,11,0,37,5,12,0.417,0,0,NA,5,12,0.417,0.417,4,6,0.667,2,7,9,1,0,2,3,4,14
1996,Felton Spencer,C,28,UTA,71,70,1267,146,281,0.52,0,0,NA,146,281,0.52,0.52,104,151,0.689,100,206,306,11,20,54,77,240,396
1996,Jerry Stackhouse,SG,21,PHI,72,71,2701,452,1091,0.414,93,292,0.318,359,799,0.449,0.457,387,518,0.747,90,175,265,278,76,79,252,179,1384
1996,John Starks,SG,30,NYK,81,71,2491,375,846,0.443,143,396,0.361,232,450,0.516,0.528,131,174,0.753,31,206,237,315,103,11,156,226,1024
1996,Damon Stoudamire,PG,22,TOR,70,70,2865,481,1129,0.426,133,337,0.395,348,792,0.439,0.485,236,296,0.797,59,222,281,653,98,19,267,166,1331
1996,Rod Strickland,PG,29,POR,67,63,2526,471,1023,0.46,38,111,0.342,433,912,0.475,0.479,276,423,0.652,89,208,297,640,97,16,255,135,1256
1996,Bob Sura,SG,22,CLE,79,3,1150,148,360,0.411,27,78,0.346,121,282,0.429,0.449,99,141,0.702,34,101,135,233,56,21,115,126,422
1996,Greg Sutton,PG,28,CHH,18,0,190,20,50,0.4,7,21,0.333,13,29,0.448,0.47,15,19,0.789,4,11,15,39,8,0,17,36,62
1996,Greg Sutton,PG,28,PHI,30,2,465,65,167,0.389,40,96,0.417,25,71,0.352,0.509,20,27,0.741,4,31,35,63,17,2,45,56,190
1996,Žan Tabak,C,25,TOR,67,18,1332,225,414,0.543,0,1,0,225,413,0.545,0.543,64,114,0.561,117,203,320,62,24,31,101,204,514
1996,Kurt Thomas,PF,23,MIA,74,42,1655,274,547,0.501,0,2,0,274,545,0.503,0.501,118,178,0.663,122,317,439,46,47,36,98,271,666
1996,Brooks Thompson,PG,25,ORL,33,0,246,48,103,0.466,25,64,0.391,23,39,0.59,0.587,19,27,0.704,4,20,24,31,12,0,24,35,140
1996,LaSalle Thompson,C,34,PHI,44,11,773,33,83,0.398,0,0,NA,33,83,0.398,0.398,19,24,0.792,62,137,199,26,19,20,37,125,85
1996,Otis Thorpe,PF,33,DET,82,82,2841,452,853,0.53,0,4,0,452,849,0.532,0.53,257,362,0.71,211,477,688,158,53,39,195,300,1161
1996,Gary Trent,PF,21,POR,69,10,1219,220,429,0.513,0,9,0,220,420,0.524,0.513,78,141,0.553,84,154,238,50,25,11,92,116,518
1996,Nick Van Exel,PG,24,LAL,74,74,2513,396,950,0.417,144,403,0.357,252,547,0.461,0.493,163,204,0.799,29,152,181,509,70,10,156,115,1099
1996,David Vaughn,PF,22,ORL,33,0,266,27,80,0.338,0,1,0,27,79,0.342,0.338,10,18,0.556,33,47,80,8,6,15,18,68,64
1996,Loy Vaught,PF,27,LAC,80,78,2966,571,1087,0.525,7,19,0.368,564,1068,0.528,0.529,149,205,0.727,204,604,808,112,87,40,158,241,1298
1996,Rasheed Wallace,PF,21,WSB,65,51,1788,275,565,0.487,27,82,0.329,248,483,0.513,0.511,78,120,0.65,93,210,303,85,42,54,103,206,655
1996,Rex Walters,SG,25,NJN,11,0,87,12,33,0.364,3,12,0.25,9,21,0.429,0.409,6,6,1,2,5,7,11,3,0,7,4,33
1996,Rex Walters,SG,25,PHI,33,8,523,49,115,0.426,19,54,0.352,30,61,0.492,0.509,36,46,0.783,11,37,48,95,22,4,34,49,153
1996,Charlie Ward,PG,25,NYK,62,1,787,87,218,0.399,33,99,0.333,54,119,0.454,0.475,37,54,0.685,29,73,102,132,54,6,79,98,244
1996,Jamie Watson,SF,23,UTA,16,0,217,18,43,0.419,3,7,0.429,15,36,0.417,0.453,9,13,0.692,5,22,27,24,8,2,17,30,48
1996,Clarence Weatherspoon,SF,25,PHI,78,75,3096,491,1015,0.484,0,2,0,491,1013,0.485,0.484,318,426,0.746,237,516,753,158,112,108,179,214,1300
1996,Spud Webb,PG,32,ATL,51,0,817,104,222,0.468,18,57,0.316,86,165,0.521,0.509,74,87,0.851,19,41,60,140,27,2,51,68,300
1996,Spud Webb,PG,32,MIN,26,21,645,82,208,0.394,29,72,0.403,53,136,0.39,0.464,51,58,0.879,7,33,40,154,25,5,59,41,244
1996,Chris Webber,PF,22,WSB,15,15,558,150,276,0.543,15,34,0.441,135,242,0.558,0.571,41,69,0.594,37,77,114,75,27,9,49,51,356
1996,David Wesley,PG,25,BOS,82,53,2104,338,736,0.459,116,272,0.426,222,464,0.478,0.538,217,288,0.753,68,196,264,390,100,11,159,207,1009
1996,Chris Whitney,PG,24,WSB,21,0,335,45,99,0.455,19,44,0.432,26,55,0.473,0.551,41,44,0.932,2,31,33,51,18,1,23,46,150
1996,Eric Williams,SF,23,BOS,64,6,1470,241,546,0.441,3,10,0.3,238,536,0.444,0.444,200,298,0.671,92,125,217,70,56,11,88,147,685
1996,Herb Williams,C,37,TOR,1,0,31,3,8,0.375,0,0,NA,3,8,0.375,0.375,0,0,NA,1,7,8,0,1,2,0,4,6
1996,Herb Williams,PF,37,NYK,43,2,540,59,144,0.41,1,4,0.25,58,140,0.414,0.413,13,20,0.65,14,68,82,27,13,31,22,75,132
1996,Lorenzo Williams,C,26,DAL,65,61,1806,87,214,0.407,0,1,0,87,213,0.408,0.407,24,70,0.343,234,287,521,85,48,122,78,226,198
1996,Micheal Williams,PG,29,MIN,9,7,189,13,40,0.325,1,3,0.333,12,37,0.324,0.338,28,33,0.848,3,20,23,31,5,3,23,37,55
1996,Monty Williams,SF,24,NYK,14,0,62,7,22,0.318,0,0,NA,7,22,0.318,0.318,5,8,0.625,9,8,17,4,2,0,5,9,19
1996,Monty Williams,SF,24,SAS,17,0,122,20,46,0.435,0,1,0,20,45,0.444,0.435,9,12,0.75,11,12,23,4,4,2,13,17,49
1996,Reggie Williams,SF,31,DEN,52,5,817,94,254,0.37,20,89,0.225,74,165,0.448,0.409,33,39,0.846,25,97,122,74,34,21,51,137,241
1996,Scott Williams,PF,27,PHI,13,1,193,15,29,0.517,0,2,0,15,27,0.556,0.517,10,12,0.833,13,33,46,5,6,7,8,27,40
1996,Walt Williams,SF,25,SAC,45,45,1381,235,540,0.435,58,170,0.341,177,370,0.478,0.489,130,172,0.756,62,145,207,165,53,42,103,151,658
1996,Walt Williams,SF,25,MIA,28,28,788,124,268,0.463,56,123,0.455,68,145,0.469,0.567,33,60,0.55,37,75,112,65,32,16,48,87,337
1996,Corliss Williamson,SF,22,SAC,53,3,609,125,268,0.466,0,3,0,125,265,0.472,0.466,47,84,0.56,56,58,114,23,11,9,76,115,297
1996,Kevin Willis,PF,33,MIA,47,42,1357,195,412,0.473,0,5,0,195,407,0.479,0.473,89,125,0.712,134,286,420,34,19,25,99,158,479
1996,Kevin Willis,PF,33,GSW,28,18,778,130,300,0.433,1,4,0.25,129,296,0.436,0.435,54,77,0.701,74,144,218,19,13,16,62,95,315
1996,Trevor Wilson,PF,27,PHI,6,0,79,10,20,0.5,0,0,NA,10,20,0.5,0.5,3,4,0.75,7,7,14,4,3,0,1,9,23
1996,Joe Wolf,PF,31,CHH,1,0,18,0,1,0,0,0,NA,0,1,0,0,0,0,NA,0,2,2,0,2,0,2,2,0
1996,Joe Wolf,PF,31,ORL,63,8,1047,135,262,0.515,0,6,0,135,256,0.527,0.515,21,29,0.724,49,136,185,63,13,5,40,161,291
1996,David Wood,PF,31,GSW,21,0,96,7,14,0.5,1,3,0.333,6,11,0.545,0.536,7,8,0.875,7,9,16,5,2,1,3,23,22
1996,David Wood,PF,31,PHO,4,0,34,1,6,0.167,0,0,NA,1,6,0.167,0.167,2,2,1,2,3,5,2,1,0,2,9,4
1996,David Wood,PF,31,DAL,37,0,642,67,154,0.435,19,59,0.322,48,95,0.505,0.497,29,40,0.725,42,91,133,27,16,9,19,118,182
1996,Haywoode Workman,PG,30,IND,77,4,1164,101,259,0.39,23,71,0.324,78,188,0.415,0.434,54,73,0.74,27,97,124,213,65,4,93,152,279
1996,Sharone Wright,C,23,PHI,46,32,1136,183,384,0.477,0,0,NA,183,384,0.477,0.477,117,186,0.629,124,175,299,27,24,39,81,125,483
1996,Sharone Wright,C,23,TOR,11,6,298,65,128,0.508,1,3,0.333,64,125,0.512,0.512,50,73,0.685,24,33,57,11,6,10,28,38,181
1996,George Zídek,C,22,CHH,71,21,888,105,248,0.423,0,0,NA,105,248,0.423,0.423,71,93,0.763,69,114,183,16,9,7,38,170,281
1997,Shareef Abdur-Rahim,PF,20,VAN,80,71,2802,550,1214,0.453,7,27,0.259,543,1187,0.457,0.456,387,519,0.746,216,339,555,175,79,79,225,199,1494
1997,Cory Alexander,PG,23,SAS,80,6,1454,194,490,0.396,94,252,0.373,100,238,0.42,0.492,95,129,0.736,29,94,123,254,82,16,146,148,577
1997,Jerome Allen,SG,24,IND,51,1,692,57,147,0.388,23,59,0.39,34,88,0.386,0.466,27,47,0.574,13,52,65,109,27,0,56,67,164
1997,Jerome Allen,SG,24,DEN,25,0,251,21,74,0.284,7,34,0.206,14,40,0.35,0.331,15,25,0.6,12,21,33,43,4,4,13,17,64
1997,Ray Allen,SG,21,MIL,82,81,2532,390,908,0.43,117,298,0.393,273,610,0.448,0.494,205,249,0.823,97,229,326,210,75,10,149,218,1102
1997,Greg Anderson,C,32,SAS,82,48,1659,130,262,0.496,0,1,0,130,261,0.498,0.496,62,93,0.667,157,291,448,34,63,67,73,225,322
1997,Kenny Anderson,PG,26,POR,82,81,3081,485,1137,0.427,132,366,0.361,353,771,0.458,0.485,334,435,0.768,91,272,363,584,162,15,193,222,1436
1997,Shandon Anderson,SG,23,UTA,65,0,1066,147,318,0.462,24,47,0.511,123,271,0.454,0.5,68,99,0.687,52,127,179,49,27,8,73,113,386
1997,Willie Anderson,SG,30,MIA,28,1,303,29,64,0.453,8,19,0.421,21,45,0.467,0.516,17,20,0.85,15,27,42,34,14,4,19,36,83
1997,Greg Anthony,PG,29,VAN,65,44,1863,199,507,0.393,88,238,0.37,111,269,0.413,0.479,130,178,0.73,25,159,184,407,129,4,129,122,616
1997,B.J. Armstrong,PG,29,GSW,49,17,1020,148,327,0.453,25,90,0.278,123,237,0.519,0.491,68,79,0.861,7,67,74,126,25,2,53,56,389
1997,Darrell Armstrong,PG,28,ORL,67,0,1010,132,345,0.383,55,181,0.304,77,164,0.47,0.462,92,106,0.868,35,41,76,175,61,9,99,114,411
1997,Vincent Askew,SG,30,NJN,1,0,7,0,0,NA,0,0,NA,0,0,NA,NA,0,0,NA,0,0,0,0,0,0,0,1,0
1997,Vincent Askew,SG,30,IND,41,0,822,79,183,0.432,7,24,0.292,72,159,0.453,0.451,68,86,0.791,25,73,98,90,17,6,42,122,233
1997,Vincent Askew,SG,30,DEN,1,0,9,2,3,0.667,0,0,NA,2,3,0.667,0.667,2,2,1,0,0,0,0,0,0,4,0,6
1997,Stacey Augmon,SG,28,DET,20,3,292,31,77,0.403,0,0,NA,31,77,0.403,0.403,28,41,0.683,14,35,49,15,10,10,27,29,90
1997,Stacey Augmon,SG,28,POR,40,7,650,74,143,0.517,0,0,NA,74,143,0.517,0.517,41,56,0.732,33,56,89,41,32,7,37,58,189
1997,Isaac Austin,C,27,MIA,82,17,1881,321,639,0.502,0,3,0,321,636,0.505,0.502,150,226,0.664,136,342,478,101,45,43,161,244,792
1997,Vin Baker,PF,25,MIL,78,78,3159,632,1251,0.505,15,54,0.278,617,1197,0.515,0.511,358,521,0.687,267,537,804,211,81,112,245,275,1637
1997,Brent Barry,SG,25,LAC,59,0,1094,155,379,0.409,56,173,0.324,99,206,0.481,0.483,76,93,0.817,30,80,110,154,51,15,76,88,442
1997,Jon Barry,SG,27,ATL,58,8,965,100,246,0.407,48,124,0.387,52,122,0.426,0.504,37,46,0.804,26,73,99,115,55,3,59,56,285
1997,Benoit Benjamin,C,32,TOR,4,3,44,5,12,0.417,0,0,NA,5,12,0.417,0.417,3,4,0.75,3,6,9,1,1,0,2,5,13
1997,Elmer Bennett,PG,26,HOU,4,0,16,2,6,0.333,1,3,0.333,1,3,0.333,0.417,5,6,0.833,0,1,1,4,2,0,0,1,10
1997,Elmer Bennett,PG,26,DEN,5,0,59,4,13,0.308,2,6,0.333,2,7,0.286,0.385,2,4,0.5,0,3,3,7,2,0,10,6,12
1997,Travis Best,PG,24,IND,76,46,2064,274,620,0.442,57,155,0.368,217,465,0.467,0.488,149,197,0.756,36,130,166,318,98,5,153,221,754
1997,Corie Blount,PF,28,LAL,58,18,1009,92,179,0.514,1,3,0.333,91,176,0.517,0.517,56,83,0.675,113,163,276,35,22,26,50,121,241
1997,Muggsy Bogues,PG,32,CHH,65,65,1880,204,443,0.46,60,144,0.417,144,299,0.482,0.528,54,64,0.844,25,116,141,469,82,2,108,114,522
1997,Melvin Booker,PG,24,DEN,5,0,21,2,4,0.5,1,2,0.5,1,2,0.5,0.625,0,0,NA,0,1,1,3,0,0,7,0,5
1997,Melvin Booker,PG,24,GSW,16,4,409,44,101,0.436,11,35,0.314,33,66,0.5,0.49,18,20,0.9,7,21,28,50,3,2,20,28,117
1997,Bruce Bowen,SF,25,MIA,1,0,1,0,0,NA,0,0,NA,0,0,NA,NA,0,0,NA,0,0,0,0,0,1,0,0,0
1997,Shawn Bradley,C,24,NJN,40,38,1228,199,456,0.436,0,5,0,199,451,0.441,0.436,81,122,0.664,118,207,325,20,23,160,64,122,479
1997,Shawn Bradley,C,24,DAL,33,32,1060,207,449,0.461,0,3,0,207,446,0.464,0.461,68,106,0.642,103,183,286,32,17,88,70,115,482
1997,Terrell Brandon,PG,26,CLE,78,78,2868,575,1313,0.438,101,271,0.373,474,1042,0.455,0.476,268,297,0.902,48,253,301,490,138,30,178,177,1519
1997,Frank Brickowski,PF,37,BOS,17,2,255,32,73,0.438,7,20,0.35,25,53,0.472,0.486,10,14,0.714,6,28,34,15,5,4,19,42,81
1997,Scott Brooks,PG,31,NYK,38,0,251,19,39,0.487,5,12,0.417,14,27,0.519,0.551,14,15,0.933,6,12,18,29,21,0,17,35,57
1997,Chucky Brown,SF,28,PHO,10,0,83,13,26,0.5,0,0,NA,13,26,0.5,0.5,8,11,0.727,3,13,16,4,0,2,4,14,34
1997,Chucky Brown,SF,28,MIL,60,1,674,65,128,0.508,1,6,0.167,64,122,0.525,0.512,39,59,0.661,38,94,132,24,9,20,15,86,170
1997,Dee Brown,PG,28,BOS,21,2,522,61,166,0.367,20,65,0.308,41,101,0.406,0.428,18,22,0.818,8,40,48,67,31,7,24,45,160
1997,Mark Bryant,PF,31,PHO,41,18,1018,152,275,0.553,0,0,NA,152,275,0.553,0.553,76,108,0.704,67,145,212,47,22,5,46,136,380
1997,Jud Buechler,SF,28,CHI,76,0,703,58,158,0.367,18,54,0.333,40,104,0.385,0.424,5,14,0.357,45,81,126,60,23,21,27,50,139
1997,Scott Burrell,SF,26,CHH,28,2,482,45,131,0.344,19,55,0.345,26,76,0.342,0.416,42,53,0.792,24,55,79,39,14,11,25,60,151
1997,Scott Burrell,SF,26,GSW,29,0,457,53,140,0.379,22,61,0.361,31,79,0.392,0.457,15,23,0.652,25,54,79,35,14,8,28,60,143
1997,Jason Caffey,PF,23,CHI,75,19,1405,205,385,0.532,0,1,0,205,384,0.534,0.532,139,211,0.659,135,166,301,89,25,9,97,149,549
1997,Adrian Caldwell,PF,30,NJN,18,0,204,10,35,0.286,0,2,0,10,33,0.303,0.286,9,17,0.529,20,36,56,5,8,1,12,27,29
1997,Adrian Caldwell,PF,30,PHI,27,0,365,30,57,0.526,0,0,NA,30,57,0.526,0.526,12,33,0.364,38,73,111,7,8,7,16,60,72
1997,Marcus Camby,C,22,TOR,63,38,1897,375,778,0.482,2,14,0.143,373,764,0.488,0.483,183,264,0.693,131,263,394,97,66,130,134,214,935
1997,Elden Campbell,PF,28,LAL,77,77,2516,442,942,0.469,1,4,0.25,441,938,0.47,0.47,263,370,0.711,207,408,615,126,46,117,130,276,1148
1997,Antoine Carr,PF,35,UTA,82,0,1460,252,522,0.483,0,3,0,252,519,0.486,0.483,99,127,0.78,60,135,195,74,24,63,75,214,603
1997,Chris Carr,SG,22,MIN,55,10,830,125,271,0.461,31,88,0.352,94,183,0.514,0.518,56,73,0.767,31,82,113,48,24,10,37,93,337
1997,Sam Cassell,PG,27,PHO,22,9,539,100,241,0.415,19,62,0.306,81,179,0.453,0.454,106,124,0.855,12,38,50,99,23,6,60,66,325
1997,Sam Cassell,PG,27,DAL,16,13,398,70,165,0.424,15,49,0.306,55,116,0.474,0.47,42,50,0.84,14,36,50,57,17,6,41,48,197
1997,Sam Cassell,PG,27,NJN,23,22,777,167,377,0.443,47,120,0.392,120,257,0.467,0.505,64,77,0.831,21,61,82,149,37,7,67,86,445
1997,Cedric Ceballos,SF,27,LAL,8,8,279,34,83,0.41,5,21,0.238,29,62,0.468,0.44,13,15,0.867,11,42,53,15,5,6,17,19,86
1997,Cedric Ceballos,SF,27,PHO,42,32,1147,248,534,0.464,21,81,0.259,227,453,0.501,0.484,126,171,0.737,91,186,277,49,28,17,68,94,643
1997,Rex Chapman,SG,29,PHO,65,33,1833,332,749,0.443,110,314,0.35,222,435,0.51,0.517,124,149,0.832,25,156,181,182,52,7,96,108,898
1997,Pete Chilcutt,PF,28,VAN,54,1,662,72,165,0.436,25,69,0.362,47,96,0.49,0.512,13,22,0.591,67,89,156,47,26,17,28,52,182
1997,Randolph Childress,PG,24,POR,19,0,125,10,30,0.333,3,16,0.188,7,14,0.5,0.383,6,8,0.75,1,4,5,15,7,0,13,11,29
1997,Randolph Childress,PG,24,DET,4,0,30,4,10,0.4,2,3,0.667,2,7,0.286,0.5,0,0,NA,0,1,1,2,2,0,5,5,10
1997,Chris Childs,PG,29,NYK,65,61,2076,211,510,0.414,70,181,0.387,141,329,0.429,0.482,113,149,0.758,22,169,191,398,78,11,180,213,605
1997,Doug Christie,SG,26,TOR,81,81,3127,396,949,0.417,147,383,0.384,249,566,0.44,0.495,237,306,0.775,85,347,432,315,201,45,200,245,1176
1997,Bimbo Coles,PG,28,GSW,51,13,1183,122,314,0.389,30,102,0.294,92,212,0.434,0.436,37,49,0.755,39,79,118,149,35,7,59,96,311
1997,Marty Conlon,C,29,BOS,74,15,1614,214,454,0.471,2,10,0.2,212,444,0.477,0.474,144,171,0.842,128,195,323,104,46,18,109,154,574
1997,Tyrone Corbin,SF,34,ATL,70,65,2305,253,600,0.422,74,208,0.356,179,392,0.457,0.483,86,108,0.796,76,218,294,124,90,7,85,176,666
1997,Joe Courtney,PF,27,PHI,4,0,52,6,14,0.429,0,0,NA,6,14,0.429,0.429,0,0,NA,5,4,9,0,0,0,1,8,12
1997,Joe Courtney,PF,27,SAS,5,0,48,5,16,0.313,0,0,NA,5,16,0.313,0.313,3,5,0.6,4,3,7,0,0,0,2,6,13
1997,John Crotty,PG,27,MIA,48,0,659,79,154,0.513,20,49,0.408,59,105,0.562,0.578,54,64,0.844,15,32,47,102,18,0,42,79,232
1997,Terry Cummings,PF,35,SEA,45,3,828,155,319,0.486,3,5,0.6,152,314,0.484,0.491,57,82,0.695,70,113,183,39,33,7,45,113,370
1997,Michael Curry,SG,28,DET,81,2,1217,99,221,0.448,23,77,0.299,76,144,0.528,0.5,97,108,0.898,23,96,119,43,31,12,28,128,318
1997,Lloyd Daniels,SG,29,SAC,5,0,28,2,16,0.125,2,11,0.182,0,5,0,0.188,0,0,NA,1,3,4,1,1,0,3,4,6
1997,Lloyd Daniels,SG,29,NJN,17,0,282,34,103,0.33,19,59,0.322,15,44,0.341,0.422,5,6,0.833,18,21,39,25,9,3,11,29,92
1997,Sasha Danilović,SG,26,MIA,43,33,1351,175,396,0.442,63,176,0.358,112,220,0.509,0.521,73,94,0.777,21,81,102,77,39,8,94,123,486
1997,Sasha Danilović,SG,26,DAL,13,9,438,73,174,0.42,22,60,0.367,51,114,0.447,0.483,48,57,0.842,8,26,34,25,15,1,22,37,216
1997,Antonio Davis,PF,28,IND,82,28,2335,308,641,0.48,1,14,0.071,307,627,0.49,0.481,241,362,0.666,190,408,598,65,42,84,141,260,858
1997,Dale Davis,PF,27,IND,80,76,2589,370,688,0.538,0,0,NA,370,688,0.538,0.538,92,215,0.428,301,471,772,59,60,77,108,233,832
1997,Hubert Davis,SG,26,TOR,36,0,623,74,184,0.402,16,70,0.229,58,114,0.509,0.446,17,23,0.739,11,29,40,34,11,2,21,40,181
1997,Todd Day,SG,27,BOS,81,27,2277,398,999,0.398,126,348,0.362,272,651,0.418,0.461,256,331,0.773,109,221,330,117,108,48,127,208,1178
1997,Andrew DeClercq,C,23,GSW,71,1,1065,142,273,0.52,0,0,NA,142,273,0.52,0.52,91,151,0.603,122,176,298,32,33,27,76,229,375
1997,Terry Dehere,PG,25,LAC,73,3,1053,148,383,0.386,52,160,0.325,96,223,0.43,0.454,122,148,0.824,15,80,95,158,27,3,96,142,470
1997,Vinny Del Negro,SG,30,SAS,72,53,2243,365,781,0.467,44,140,0.314,321,641,0.501,0.496,112,129,0.868,39,171,210,231,59,7,92,131,886
1997,Tony Delk,PG,23,CHH,61,1,867,119,256,0.465,52,112,0.464,67,144,0.465,0.566,42,51,0.824,31,68,99,99,36,6,68,71,332
1997,Sherman Douglas,PG,30,MIL,79,79,2316,306,610,0.502,38,114,0.333,268,496,0.54,0.533,114,171,0.667,57,136,193,427,78,10,153,191,764
1997,Clyde Drexler,SG,34,HOU,62,62,2271,397,899,0.442,119,335,0.355,278,564,0.493,0.508,201,268,0.75,118,255,373,354,119,36,156,151,1114
1997,Chris Dudley,C,31,POR,81,14,1840,126,293,0.43,0,0,NA,126,293,0.43,0.43,65,137,0.474,204,389,593,41,39,96,80,247,317
1997,Tony Dumas,SG,24,DAL,18,0,227,27,77,0.351,3,24,0.125,24,53,0.453,0.37,15,23,0.652,3,11,14,22,10,1,15,36,72
1997,Tony Dumas,SG,24,PHO,6,1,51,6,19,0.316,1,4,0.25,5,15,0.333,0.342,1,2,0.5,0,2,2,3,0,1,1,9,14
1997,Acie Earl,C,26,TOR,38,0,457,59,157,0.376,0,5,0,59,152,0.388,0.376,44,70,0.629,33,52,85,18,12,27,33,54,162
1997,Acie Earl,C,26,MIL,9,0,43,8,23,0.348,0,0,NA,8,23,0.348,0.348,10,14,0.714,2,9,11,2,3,1,2,7,26
1997,Blue Edwards,SF,31,VAN,61,12,1439,182,458,0.397,25,89,0.281,157,369,0.425,0.425,89,109,0.817,49,140,189,114,38,20,81,135,478
1997,Kevin Edwards,PG,31,NJN,32,0,477,69,183,0.377,15,43,0.349,54,140,0.386,0.418,37,43,0.86,9,34,43,57,17,4,49,34,190
1997,Howard Eisley,PG,24,UTA,82,0,1083,139,308,0.451,20,72,0.278,119,236,0.504,0.484,70,89,0.787,20,64,84,198,44,10,110,141,368
1997,Mario Elie,SF,33,HOU,78,77,2687,291,585,0.497,120,286,0.42,171,299,0.572,0.6,207,231,0.896,60,175,235,310,92,12,135,200,909
1997,Dale Ellis,SF,36,DEN,82,51,2940,477,1151,0.414,192,528,0.364,285,623,0.457,0.498,215,263,0.817,99,194,293,165,60,7,146,178,1361
1997,Brian Evans,SF,23,ORL,14,0,59,8,22,0.364,4,8,0.5,4,14,0.286,0.455,0,0,NA,1,7,8,7,1,2,2,6,20
1997,Jamie Feick,C,22,CHH,3,0,10,2,4,0.5,1,1,1,1,3,0.333,0.625,0,2,0,1,2,3,0,0,1,0,3,5
1997,Jamie Feick,PF,22,SAS,38,0,614,54,153,0.353,4,13,0.308,50,140,0.357,0.366,34,65,0.523,81,130,211,26,16,13,31,75,146
1997,Michael Finley,SF,23,PHO,27,18,796,141,297,0.475,14,55,0.255,127,242,0.525,0.498,56,69,0.812,34,86,120,68,18,4,44,42,352
1997,Michael Finley,SF,23,DAL,56,36,1994,334,774,0.432,87,225,0.387,247,549,0.45,0.488,142,176,0.807,54,198,252,156,50,20,120,96,897
1997,Matt Fish,C,27,WSB,5,0,7,1,3,0.333,0,0,NA,1,3,0.333,0.333,0,0,NA,1,4,5,0,0,0,2,2,2
1997,Matt Fish,C,27,MIA,1,0,1,0,0,NA,0,0,NA,0,0,NA,NA,0,0,NA,0,0,0,0,0,0,0,0,0
1997,Derek Fisher,PG,22,LAL,80,3,921,104,262,0.397,22,73,0.301,82,189,0.434,0.439,79,120,0.658,25,72,97,119,41,5,71,87,309
1997,Greg Foster,C,28,UTA,79,12,920,111,245,0.453,2,3,0.667,109,242,0.45,0.457,54,65,0.831,56,131,187,31,10,20,54,145,278
1997,Kevin Gamble,SF,31,SAC,62,2,953,123,286,0.43,54,112,0.482,69,174,0.397,0.524,7,10,0.7,13,94,107,77,21,17,27,76,307
1997,Kevin Garnett,SF,20,MIN,77,77,2995,549,1100,0.499,6,21,0.286,543,1079,0.503,0.502,205,272,0.754,190,428,618,236,105,163,175,199,1309
1997,Dean Garrett,C,30,MIN,68,47,1665,223,389,0.573,0,0,NA,223,389,0.573,0.573,96,138,0.696,149,346,495,38,40,95,34,158,542
1997,Chris Gatling,PF,29,DAL,44,1,1191,309,580,0.533,1,6,0.167,308,574,0.537,0.534,221,313,0.706,126,222,348,25,35,31,114,125,840
1997,Chris Gatling,PF,29,NJN,3,0,92,18,43,0.419,0,0,NA,18,43,0.419,0.419,15,16,0.938,8,14,22,3,4,0,6,13,51
1997,Kendall Gill,SF,28,NJN,82,81,3199,644,1453,0.443,74,220,0.336,570,1233,0.462,0.469,427,536,0.797,183,316,499,326,154,46,218,225,1789
1997,Armen Gilliam,PF,32,MIL,80,25,2050,246,522,0.471,0,0,NA,246,522,0.471,0.471,199,259,0.768,136,361,497,53,61,40,105,206,691
1997,Anthony Goldwire,PG,25,CHH,33,9,576,62,154,0.403,36,82,0.439,26,72,0.361,0.519,30,40,0.75,3,35,38,94,19,1,41,58,190
1997,Anthony Goldwire,PG,25,DEN,27,21,612,69,176,0.392,28,71,0.394,41,105,0.39,0.472,31,38,0.816,9,37,46,125,14,1,35,46,197
1997,Greg Graham,SG,26,SEA,28,0,197,29,80,0.363,9,31,0.29,20,49,0.408,0.419,26,40,0.65,2,11,13,11,12,1,10,12,93
1997,Devin Gray,PF,24,SAC,3,0,25,3,11,0.273,0,0,NA,3,11,0.273,0.273,2,4,0.5,3,6,9,2,3,0,0,3,8
1997,Devin Gray,PF,24,SAS,3,0,24,5,15,0.333,0,0,NA,5,15,0.333,0.333,0,1,0,3,2,5,0,1,0,5,8,10
1997,Jeff Grayer,SG,31,SAC,25,0,316,38,83,0.458,4,11,0.364,34,72,0.472,0.482,11,20,0.55,21,17,38,25,8,7,15,42,91
1997,A.C. Green,PF,33,PHO,27,19,548,61,128,0.477,0,3,0,61,125,0.488,0.477,31,48,0.646,33,105,138,17,18,1,20,34,153
1997,A.C. Green,PF,33,DAL,56,54,1944,173,356,0.486,1,17,0.059,172,339,0.507,0.487,97,149,0.651,189,329,518,52,52,15,54,111,444
1997,Tom Gugliotta,PF,27,MIN,81,81,3131,592,1339,0.442,24,93,0.258,568,1246,0.456,0.451,464,566,0.82,187,515,702,335,130,89,293,237,1672
1997,Jack Haley,C,33,NJN,20,0,74,13,37,0.351,0,0,NA,13,37,0.351,0.351,14,19,0.737,13,19,32,5,1,1,2,14,40
1997,Darvin Ham,SF,23,DEN,35,3,313,32,61,0.525,0,0,NA,32,61,0.525,0.525,16,33,0.485,29,27,56,14,8,8,21,57,80
1997,Darvin Ham,SF,23,IND,1,0,5,1,1,1,0,0,NA,1,1,1,1,1,2,0.5,0,0,0,0,1,0,1,0,3
1997,Tom Hammonds,PF,29,DEN,81,8,1758,191,398,0.48,0,2,0,191,396,0.482,0.48,124,172,0.721,135,266,401,64,16,24,88,205,506
1997,Darrin Hancock,SF,25,MIL,9,0,39,2,6,0.333,0,0,NA,2,6,0.333,0.333,0,0,NA,1,4,5,4,2,0,4,7,4
1997,Darrin Hancock,SF,25,ATL,14,0,86,13,27,0.481,0,0,NA,13,27,0.481,0.481,8,12,0.667,3,10,13,7,7,1,7,6,34
1997,Darrin Hancock,SF,25,SAS,1,0,8,1,2,0.5,0,0,NA,1,2,0.5,0.5,2,2,1,0,0,0,1,0,0,0,2,4
1997,Anfernee Hardaway,PG,25,ORL,59,59,2221,421,941,0.447,85,267,0.318,336,674,0.499,0.493,283,345,0.82,82,181,263,332,93,35,145,123,1210
1997,Tim Hardaway,PG,30,MIA,81,81,3136,575,1384,0.415,203,590,0.344,372,794,0.469,0.489,291,364,0.799,49,228,277,695,151,9,230,165,1644
1997,Derek Harper,PG,35,DAL,75,29,2210,299,674,0.444,60,176,0.341,239,498,0.48,0.488,95,128,0.742,30,107,137,321,92,12,132,144,753
1997,Ron Harper,PG,33,CHI,76,74,1740,177,406,0.436,68,188,0.362,109,218,0.5,0.52,58,82,0.707,46,147,193,191,86,38,50,138,480
1997,Othella Harrington,PF,23,HOU,57,1,860,112,204,0.549,0,3,0,112,201,0.557,0.549,49,81,0.605,75,123,198,18,12,22,57,112,273
1997,Antonio Harvey,PF,26,SEA,6,0,26,5,11,0.455,0,0,NA,5,11,0.455,0.455,5,6,0.833,2,8,10,1,0,4,1,8,15
1997,Mark Hendrickson,PF,22,PHI,29,1,301,32,77,0.416,3,12,0.25,29,65,0.446,0.435,18,26,0.692,35,57,92,3,10,4,14,32,85
1997,Carl Herrera,PF,30,SAS,75,58,1837,257,593,0.433,2,6,0.333,255,587,0.434,0.435,81,118,0.686,118,222,340,50,62,53,95,217,597
1997,Tyrone Hill,C,28,CLE,74,70,2582,357,595,0.6,0,1,0,357,594,0.601,0.6,241,381,0.633,259,477,736,92,63,30,147,268,955
1997,Jeff Hornacek,SG,33,UTA,82,82,2592,413,856,0.482,72,195,0.369,341,661,0.516,0.525,293,326,0.899,60,181,241,361,124,26,134,188,1191
1997,Robert Horry,SF,26,PHO,32,15,719,82,195,0.421,24,78,0.308,58,117,0.496,0.482,32,50,0.64,40,79,119,54,28,26,46,81,220
1997,Robert Horry,SF,26,LAL,22,14,676,75,165,0.455,25,76,0.329,50,89,0.562,0.53,28,40,0.7,28,90,118,56,38,29,26,72,203
1997,Juwan Howard,SF,23,WSB,82,82,3324,638,1313,0.486,0,2,0,638,1311,0.487,0.486,294,389,0.756,202,450,652,311,93,23,246,259,1570
1997,Stephen Howard,SF,26,SAS,7,0,69,7,12,0.583,0,0,NA,7,12,0.583,0.583,12,14,0.857,4,5,9,1,8,2,5,7,26
1997,Stephen Howard,SF,26,UTA,42,0,349,55,96,0.573,0,0,NA,55,96,0.573,0.573,40,67,0.597,25,51,76,10,11,10,20,55,150
1997,Bobby Hurley,PG,25,SAC,49,12,632,46,125,0.368,14,45,0.311,32,80,0.4,0.424,37,53,0.698,9,29,38,146,27,3,55,53,143
1997,Allen Iverson,PG,21,PHI,76,74,3045,625,1504,0.416,155,455,0.341,470,1049,0.448,0.467,382,544,0.702,115,197,312,567,157,24,337,233,1787
1997,Jim Jackson,SG,26,DAL,46,46,1676,260,588,0.442,46,139,0.331,214,449,0.477,0.481,148,188,0.787,81,146,227,156,57,15,107,113,714
1997,Jim Jackson,SF,26,NJN,31,31,1155,184,441,0.417,40,108,0.37,144,333,0.432,0.463,104,122,0.852,51,133,184,160,29,17,101,81,512
1997,Mark Jackson,PG,31,DEN,52,52,2001,192,452,0.425,48,121,0.397,144,331,0.435,0.478,109,136,0.801,71,200,271,641,51,9,172,104,541
1997,Mark Jackson,PG,31,IND,30,30,1053,97,227,0.427,18,57,0.316,79,170,0.465,0.467,59,77,0.766,20,104,124,294,46,3,102,57,271
1997,Henry James,PF,31,ATL,53,15,945,125,306,0.408,76,181,0.42,49,125,0.392,0.533,30,36,0.833,27,54,81,21,11,1,29,98,356
1997,Avery Johnson,PG,31,SAS,76,76,2472,327,685,0.477,6,26,0.231,321,659,0.487,0.482,140,203,0.69,32,115,147,513,96,15,146,158,800
1997,Eddie Johnson,SF,37,IND,28,0,306,59,136,0.434,9,28,0.321,50,108,0.463,0.467,20,27,0.741,3,37,40,17,5,1,17,33,147
1997,Eddie Johnson,SF,37,HOU,24,2,607,101,226,0.447,40,103,0.388,61,123,0.496,0.535,35,41,0.854,24,74,98,35,10,1,30,48,277
1997,Eddie Jones,SG,25,LAL,80,80,2998,473,1081,0.438,152,389,0.391,321,692,0.464,0.508,276,337,0.819,90,236,326,270,189,49,169,226,1374
1997,Reggie Jordan,SG,29,POR,9,0,99,8,16,0.5,0,0,NA,8,16,0.5,0.5,4,10,0.4,11,12,23,11,5,3,6,13,20
1997,Reggie Jordan,SG,29,MIN,10,0,31,8,10,0.8,0,0,NA,8,10,0.8,0.8,4,7,0.571,0,4,4,1,2,0,2,2,20
1997,Tim Kempton,PF,33,SAS,10,0,59,1,5,0.2,0,0,NA,1,5,0.2,0.2,2,2,1,3,5,8,2,1,1,7,4,4
1997,Steve Kerr,PG,31,CHI,82,0,1861,249,467,0.533,110,237,0.464,139,230,0.604,0.651,54,67,0.806,29,101,130,175,67,3,43,98,662
1997,Jason Kidd,PG,23,DAL,22,22,791,75,203,0.369,21,65,0.323,54,138,0.391,0.421,46,69,0.667,30,60,90,200,45,8,66,42,217
1997,Jason Kidd,PG,23,PHO,33,23,1173,138,326,0.423,40,100,0.4,98,226,0.434,0.485,66,96,0.688,34,125,159,296,79,12,76,72,382
1997,Stacey King,C,30,BOS,5,0,33,5,7,0.714,0,0,NA,5,7,0.714,0.714,2,3,0.667,1,8,9,1,0,1,1,3,12
1997,Stacey King,C,30,DAL,6,0,70,6,15,0.4,0,0,NA,6,15,0.4,0.4,0,4,0,10,8,18,0,2,0,5,11,12
1997,Joe Kleine,C,35,PHO,23,10,365,32,80,0.4,1,1,1,31,79,0.392,0.406,13,18,0.722,21,59,80,12,9,6,20,47,78
1997,Joe Kleine,C,35,LAL,8,0,30,2,8,0.25,0,0,NA,2,8,0.25,0.25,2,2,1,2,7,9,0,0,0,0,6,6
1997,Joe Kleine,C,35,NJN,28,0,453,35,82,0.427,1,2,0.5,34,80,0.425,0.433,13,18,0.722,39,75,114,23,8,12,21,57,84
1997,Toni Kukoč,SF,28,CHI,57,15,1610,285,605,0.471,50,151,0.331,235,454,0.518,0.512,134,174,0.77,94,167,261,256,60,29,91,97,754
1997,Christian Laettner,PF,27,ATL,82,82,3140,548,1128,0.486,31,88,0.352,517,1040,0.497,0.5,359,440,0.816,212,508,720,223,102,64,218,277,1486
1997,Andrew Lang,C,30,MIL,52,52,1194,115,248,0.464,0,0,NA,115,248,0.464,0.464,44,61,0.721,94,184,278,25,26,47,39,140,274
1997,Antonio Lang,PF,24,CLE,64,1,843,68,162,0.42,0,6,0,68,156,0.436,0.42,35,48,0.729,52,75,127,33,33,30,50,111,171
1997,Eric Leckner,C,30,CHH,1,0,11,0,3,0,0,0,NA,0,3,0,0,0,0,NA,0,1,1,1,0,0,0,3,0
1997,Eric Leckner,C,30,VAN,19,1,115,14,30,0.467,0,0,NA,14,30,0.467,0.467,6,12,0.5,5,30,35,4,3,2,10,32,34
1997,Tim Legler,SG,30,WSB,15,0,182,15,48,0.313,8,29,0.276,7,19,0.368,0.396,6,7,0.857,0,21,21,7,3,5,9,21,44
1997,Voshon Lenard,SG,23,MIA,73,47,2111,314,684,0.459,183,442,0.414,131,242,0.541,0.593,86,105,0.819,38,179,217,161,50,18,109,168,897
1997,Alton Lister,C,38,BOS,53,2,516,32,77,0.416,0,0,NA,32,77,0.416,0.416,23,31,0.742,66,102,168,13,8,14,30,95,87
1997,Brad Lohaus,PF,32,TOR,6,0,45,4,15,0.267,2,7,0.286,2,8,0.25,0.333,0,0,NA,1,6,7,1,1,0,1,6,10
1997,Grant Long,PF,30,DET,65,24,1166,123,275,0.447,17,47,0.362,106,228,0.465,0.478,63,84,0.75,88,134,222,39,43,6,48,106,326
1997,Luc Longley,C,28,CHI,59,59,1472,221,485,0.456,0,2,0,221,483,0.458,0.456,95,120,0.792,121,211,332,141,23,66,111,191,537
1997,Sam Mack,SF,26,HOU,52,10,904,105,262,0.401,47,142,0.331,58,120,0.483,0.49,35,42,0.833,20,86,106,58,29,6,42,67,292
1997,Danny Manning,PF,30,PHO,77,17,2134,426,795,0.536,7,36,0.194,419,759,0.552,0.54,181,251,0.721,137,332,469,173,81,74,161,268,1040
1997,Rich Manning,PF,26,VAN,16,1,128,18,48,0.375,2,3,0.667,16,45,0.356,0.396,6,8,0.75,8,15,23,2,3,1,5,18,44
1997,Rich Manning,PF,26,LAC,10,1,73,14,34,0.412,0,1,0,14,33,0.424,0.412,3,6,0.5,8,8,16,1,1,1,2,11,31
1997,Stephon Marbury,PG,19,MIN,67,64,2324,355,871,0.408,102,288,0.354,253,583,0.434,0.466,245,337,0.727,54,130,184,522,67,19,210,159,1057
1997,Donyell Marshall,SF,23,GSW,61,20,1022,174,421,0.413,35,111,0.315,139,310,0.448,0.455,61,98,0.622,92,184,276,54,25,46,55,96,444
1997,Darrick Martin,PG,25,LAC,82,64,1820,292,718,0.407,91,234,0.389,201,484,0.415,0.47,218,250,0.872,26,87,113,339,57,2,127,165,893
1997,Jamal Mashburn,SF,24,DAL,37,21,975,140,376,0.372,42,131,0.321,98,245,0.4,0.428,72,111,0.649,28,87,115,93,35,5,57,69,394
1997,Jamal Mashburn,SF,24,MIA,32,30,1189,146,367,0.398,48,146,0.329,98,221,0.443,0.463,88,117,0.752,41,138,179,111,43,7,57,117,428
1997,Tony Massenburg,PF,29,NJN,79,49,1954,219,452,0.485,0,1,0,219,451,0.486,0.485,130,206,0.631,222,295,517,23,38,50,91,217,568
1997,Vernon Maxwell,SG,31,SAS,72,31,2068,340,906,0.375,115,372,0.309,225,534,0.421,0.439,134,180,0.744,27,132,159,153,87,19,121,168,929
1997,Walter McCarty,PF,22,NYK,35,0,192,26,68,0.382,4,14,0.286,22,54,0.407,0.412,8,14,0.571,8,15,23,13,7,9,17,38,64
1997,George McCloud,SF,29,DAL,41,26,1207,204,482,0.423,78,205,0.38,126,277,0.455,0.504,77,92,0.837,29,114,143,92,52,8,52,106,563
1997,George McCloud,SF,29,LAL,23,2,286,34,96,0.354,21,49,0.429,13,47,0.277,0.464,6,9,0.667,7,29,36,17,9,0,9,20,95
1997,Xavier McDaniel,PF,33,NJN,62,5,1170,138,355,0.389,5,25,0.2,133,330,0.403,0.396,65,89,0.73,124,194,318,65,36,17,70,144,346
1997,Antonio McDyess,PF,22,DEN,74,73,2565,536,1157,0.463,6,35,0.171,530,1122,0.472,0.466,274,387,0.708,155,382,537,106,62,126,199,276,1352
1997,Jeff McInnis,PG,22,DEN,13,0,117,23,49,0.469,12,26,0.462,11,23,0.478,0.592,7,10,0.7,2,4,6,18,2,1,13,16,65
1997,Aaron McKie,SG,24,POR,41,8,775,53,156,0.34,23,55,0.418,30,101,0.297,0.413,41,49,0.837,13,80,93,84,34,15,48,61,170
1997,Aaron McKie,SG,24,DET,42,3,850,97,209,0.464,18,48,0.375,79,161,0.491,0.507,51,61,0.836,27,101,128,77,43,7,42,69,263
1997,Loren Meyer,PF,24,DAL,19,16,259,34,78,0.436,1,2,0.5,33,76,0.434,0.442,9,12,0.75,14,35,49,7,6,3,27,52,78
1997,Loren Meyer,PF,24,PHO,35,17,449,74,166,0.446,3,5,0.6,71,161,0.441,0.455,37,52,0.712,39,57,96,12,5,12,35,73,188
1997,Anthony Miller,PF,25,ATL,1,0,14,0,5,0,0,0,NA,0,5,0,0,0,0,NA,2,5,7,0,0,0,0,2,0
1997,Oliver Miller,C,26,DAL,42,0,836,76,154,0.494,0,1,0,76,153,0.497,0.494,28,53,0.528,82,151,233,58,34,50,70,133,180
1997,Oliver Miller,C,26,TOR,19,8,316,47,84,0.56,0,1,0,47,83,0.566,0.56,20,26,0.769,23,50,73,29,13,13,20,48,114
1997,Terry Mills,PF,29,DET,79,5,1997,312,702,0.444,175,415,0.422,137,287,0.477,0.569,58,70,0.829,68,309,377,99,35,27,85,161,857
1997,Eric Mobley,C,26,VAN,28,8,307,28,63,0.444,0,0,NA,28,63,0.444,0.444,16,30,0.533,30,28,58,14,5,10,29,44,72
1997,Eric Montross,C,25,DAL,47,46,984,86,187,0.46,0,0,NA,86,187,0.46,0.46,10,34,0.294,66,170,236,32,9,34,51,150,182
1997,Eric Montross,C,25,NJN,31,31,844,73,162,0.451,0,0,NA,73,162,0.451,0.451,11,28,0.393,115,167,282,29,11,39,26,118,157
1997,Alonzo Mourning,C,26,MIA,66,65,2320,473,885,0.534,1,9,0.111,472,876,0.539,0.535,363,565,0.642,189,467,656,104,56,189,226,272,1310
1997,Eric Murdock,PG,28,DEN,12,0,114,15,33,0.455,4,10,0.4,11,23,0.478,0.515,11,12,0.917,1,10,11,24,9,2,11,9,45
1997,Tracy Murray,SF,25,WSB,82,1,1814,288,678,0.425,106,300,0.353,182,378,0.481,0.503,135,161,0.839,84,169,253,78,69,19,86,150,817
1997,Dikembe Mutombo,C,30,ATL,80,80,2973,380,721,0.527,0,0,NA,380,721,0.527,0.527,306,434,0.705,268,661,929,110,49,264,186,249,1066
1997,Martin Müürsepp,PF,22,MIA,10,0,27,5,14,0.357,1,4,0.25,4,10,0.4,0.393,6,14,0.429,2,3,5,3,0,1,3,3,17
1997,Martin Müürsepp,PF,22,DAL,32,0,321,49,117,0.419,3,20,0.15,46,97,0.474,0.432,38,56,0.679,33,29,62,17,12,10,15,55,139
1997,Ruben Nembhard,SG,24,UTA,8,0,94,12,29,0.414,0,4,0,12,25,0.48,0.414,8,10,0.8,3,5,8,12,6,0,3,9,32
1997,Ruben Nembhard,PG,24,POR,2,0,19,4,8,0.5,0,2,0,4,6,0.667,0.5,0,0,NA,0,0,0,5,3,0,5,3,8
1997,Johnny Newman,SF,33,MIL,82,4,2060,246,547,0.45,34,98,0.347,212,449,0.472,0.481,189,247,0.765,66,120,186,116,73,17,115,257,715
1997,Gaylon Nickerson,SG,27,SAS,3,0,36,3,9,0.333,0,1,0,3,8,0.375,0.333,7,7,1,1,3,4,1,0,1,0,1,13
1997,Gaylon Nickerson,SG,27,WSB,1,0,6,1,3,0.333,0,1,0,1,2,0.5,0.333,0,0,NA,0,1,1,0,1,0,1,0,2
1997,Moochie Norris,PG,23,VAN,8,0,89,4,22,0.182,2,10,0.2,2,12,0.167,0.227,2,5,0.4,3,9,12,23,4,0,5,5,12
1997,Ed O'Bannon,SF,24,NJN,45,5,634,76,207,0.367,17,60,0.283,59,147,0.401,0.408,20,23,0.87,41,71,112,28,24,10,14,78,189
1997,Ed O'Bannon,SF,24,DAL,19,0,175,17,72,0.236,1,10,0.1,16,62,0.258,0.243,11,12,0.917,9,27,36,11,5,2,6,19,46
1997,Jermaine O'Neal,PF,18,POR,45,0,458,69,153,0.451,0,1,0,69,152,0.454,0.451,47,78,0.603,39,85,124,8,2,26,27,46,185
1997,Shaquille O'Neal,C,24,LAL,51,51,1941,552,991,0.557,0,4,0,552,987,0.559,0.557,232,479,0.484,195,445,640,159,46,147,146,180,1336
1997,Bo Outlaw,PF,25,LAC,82,25,2195,254,417,0.609,0,8,0,254,409,0.621,0.609,117,232,0.504,174,280,454,157,94,142,107,227,625
1997,Doug Overton,PG,27,PHI,61,4,634,81,190,0.426,10,40,0.25,71,150,0.473,0.453,45,48,0.938,18,50,68,101,24,0,39,44,217
1997,Billy Owens,SF,27,SAC,66,56,1995,299,640,0.467,25,72,0.347,274,568,0.482,0.487,101,145,0.697,134,258,392,187,62,25,133,187,724
1997,Robert Pack,PG,27,NJN,34,31,1185,193,474,0.407,22,74,0.297,171,400,0.428,0.43,134,170,0.788,15,71,86,325,59,3,150,83,542
1997,Robert Pack,PG,27,DAL,20,11,597,79,219,0.361,9,38,0.237,70,181,0.387,0.381,62,73,0.849,13,47,60,127,35,3,67,56,229
1997,Cherokee Parks,PF,24,MIN,76,0,961,103,202,0.51,0,1,0,103,201,0.512,0.51,46,76,0.605,83,112,195,34,41,48,32,150,252
1997,Gary Payton,PG,28,SEA,82,82,3213,706,1482,0.476,119,380,0.313,587,1102,0.533,0.517,254,355,0.715,106,272,378,583,197,13,215,208,1785
1997,Anthony Peeler,SG,27,VAN,72,57,2291,402,1011,0.398,128,343,0.373,274,668,0.41,0.461,109,133,0.82,54,193,247,256,105,17,157,168,1041
1997,Sam Perkins,C,35,SEA,81,4,1976,290,661,0.439,122,309,0.395,168,352,0.477,0.531,187,229,0.817,74,226,300,103,69,49,77,134,889
1997,Elliot Perry,PG,27,MIL,82,3,1595,217,458,0.474,49,137,0.358,168,321,0.523,0.527,79,106,0.745,24,100,124,247,98,3,111,117,562
1997,Wesley Person,SG,25,PHO,80,42,2326,409,903,0.453,171,414,0.413,238,489,0.487,0.548,91,114,0.798,68,224,292,123,86,20,76,102,1080
1997,Ricky Pierce,SG,37,DEN,33,10,600,120,260,0.462,12,39,0.308,108,221,0.489,0.485,83,92,0.902,17,36,53,31,14,5,38,49,335
1997,Ricky Pierce,SG,37,CHH,27,17,650,119,237,0.502,30,56,0.536,89,181,0.492,0.565,56,63,0.889,19,49,68,49,14,4,30,48,324
1997,Ed Pinckney,PF,33,MIA,27,0,273,23,43,0.535,0,0,NA,23,43,0.535,0.535,20,25,0.8,25,40,65,6,8,9,19,30,66
1997,Olden Polynice,C,32,SAC,82,82,2893,442,967,0.457,0,6,0,442,961,0.46,0.457,141,251,0.562,272,500,772,178,46,80,166,298,1025
1997,Vitaly Potapenko,C,21,CLE,80,3,1238,186,423,0.44,1,2,0.5,185,421,0.439,0.441,92,125,0.736,105,112,217,40,26,34,109,216,465
1997,Theo Ratliff,C,23,DET,76,38,1292,179,337,0.531,0,0,NA,179,337,0.531,0.531,81,116,0.698,109,147,256,13,29,111,56,181,439
1997,Eldridge Recasner,SG,29,ATL,71,4,1207,148,350,0.423,58,140,0.414,90,210,0.429,0.506,51,58,0.879,35,80,115,94,38,4,65,97,405
1997,Khalid Reeves,PG,24,NJN,50,18,1048,141,359,0.393,76,192,0.396,65,167,0.389,0.499,56,75,0.747,22,66,88,170,23,7,82,119,414
1997,Khalid Reeves,PG,24,DAL,13,12,384,43,111,0.387,7,35,0.2,36,76,0.474,0.419,9,12,0.75,12,19,31,56,11,2,26,40,102
1997,Don Reid,PF,23,DET,47,14,462,54,112,0.482,0,1,0,54,111,0.486,0.482,24,32,0.75,36,65,101,14,16,15,23,105,132
1997,Shawn Respert,SG,24,MIL,14,0,83,6,19,0.316,1,9,0.111,5,10,0.5,0.342,7,7,1,3,4,7,8,0,0,8,5,20
1997,Shawn Respert,SG,24,TOR,27,0,412,53,120,0.442,19,48,0.396,34,72,0.472,0.521,27,32,0.844,11,21,32,32,20,2,22,35,152
1997,Chris Robinson,SG,22,VAN,41,6,681,69,182,0.379,34,89,0.382,35,93,0.376,0.473,16,26,0.615,23,48,71,65,28,9,34,85,188
1997,Clifford Robinson,SF,30,POR,81,79,3077,444,1043,0.426,121,350,0.346,323,693,0.466,0.484,215,309,0.696,90,231,321,261,99,66,172,251,1224
1997,James Robinson,PG,26,MIN,69,5,1309,196,482,0.407,102,267,0.382,94,215,0.437,0.512,78,114,0.684,24,88,112,126,30,8,69,125,572
1997,Rumeal Robinson,PG,30,LAL,15,3,126,17,48,0.354,6,23,0.261,11,25,0.44,0.417,5,8,0.625,2,8,10,13,5,2,11,12,45
1997,Rumeal Robinson,PG,30,PHO,12,0,87,16,34,0.471,3,10,0.3,13,24,0.542,0.515,1,4,0.25,1,6,7,8,1,0,5,8,36
1997,Rumeal Robinson,PG,30,POR,27,0,295,33,82,0.402,9,23,0.391,24,59,0.407,0.457,20,23,0.87,3,27,30,52,18,0,27,40,95
1997,Carlos Rogers,PF,25,TOR,56,3,1397,212,404,0.525,25,66,0.379,187,338,0.553,0.556,102,170,0.6,120,184,304,37,42,69,53,140,551
1997,Rodney Rogers,SF,25,LAC,81,62,2480,408,884,0.462,65,180,0.361,343,704,0.487,0.498,191,288,0.663,137,274,411,222,88,61,221,272,1072
1997,Roy Rogers,PF,23,VAN,82,50,1848,244,483,0.505,1,1,1,243,482,0.504,0.506,54,94,0.574,139,247,386,46,21,163,86,214,543
1997,Sean Rooks,C,27,LAL,69,3,735,87,185,0.47,0,1,0,87,184,0.473,0.47,91,130,0.7,56,107,163,42,17,38,51,123,265
1997,Jalen Rose,SF,24,IND,66,6,1188,172,377,0.456,21,72,0.292,151,305,0.495,0.484,117,156,0.75,27,94,121,155,57,18,107,136,482
1997,Malik Rose,PF,22,CHH,54,1,525,61,128,0.477,0,2,0,61,126,0.484,0.477,38,62,0.613,70,94,164,32,28,17,41,114,160
1997,Donald Royal,SF,30,ORL,1,1,29,4,10,0.4,0,0,NA,4,10,0.4,0.4,4,4,1,1,0,1,1,0,0,3,3,12
1997,Donald Royal,SF,30,GSW,36,1,509,37,96,0.385,0,2,0,37,94,0.394,0.385,62,78,0.795,33,62,95,14,11,9,22,55,136
1997,Donald Royal,SF,30,CHH,25,2,320,21,40,0.525,0,0,NA,21,40,0.525,0.525,28,35,0.8,18,40,58,10,12,2,22,42,70
1997,Clifford Rozier,C,24,GSW,1,0,5,0,1,0,0,0,NA,0,1,0,0,0,0,NA,0,0,0,0,0,0,0,0,0
1997,Clifford Rozier,C,24,TOR,41,29,732,79,173,0.457,0,2,0,79,171,0.462,0.457,31,61,0.508,102,132,234,31,24,44,29,97,189
1997,Jason Sasser,SF,23,SAS,6,0,62,8,19,0.421,1,2,0.5,7,17,0.412,0.447,0,0,NA,0,7,7,1,2,0,2,11,17
1997,Jason Sasser,SF,23,DAL,2,0,7,1,4,0.25,0,1,0,1,3,0.333,0.25,0,0,NA,1,0,1,1,1,0,0,0,2
1997,Danny Schayes,PF,37,ORL,45,6,540,47,120,0.392,0,1,0,47,119,0.395,0.392,39,52,0.75,41,84,125,14,15,16,27,74,133
1997,Steve Scheffler,C,29,SEA,7,0,29,6,7,0.857,0,0,NA,6,7,0.857,0.857,1,2,0.5,1,2,3,0,0,0,5,5,13
1997,Dennis Scott,SF,28,ORL,66,62,2166,298,749,0.398,147,373,0.394,151,376,0.402,0.496,80,101,0.792,40,163,203,139,74,19,81,138,823
1997,Rony Seikaly,C,31,ORL,74,68,2615,460,907,0.507,0,3,0,460,904,0.509,0.507,357,500,0.714,274,427,701,92,49,107,218,275,1277
1997,Brian Shaw,PG,30,ORL,77,31,1867,189,516,0.366,63,194,0.325,126,322,0.391,0.427,111,140,0.793,47,147,194,319,67,26,170,197,552
1997,Dickey Simpkins,PF,24,CHI,48,0,395,31,93,0.333,1,4,0.25,30,89,0.337,0.339,28,40,0.7,36,56,92,31,5,5,35,44,91
1997,Reggie Slater,PF,26,TOR,26,0,406,82,149,0.55,0,2,0,82,147,0.558,0.55,39,75,0.52,40,55,95,21,9,6,29,34,203
1997,Charles Smith,PF,31,SAS,19,7,329,34,84,0.405,0,1,0,34,83,0.41,0.405,20,26,0.769,18,47,65,14,13,22,22,44,88
1997,Joe Smith,PF,21,GSW,80,80,3086,587,1293,0.454,12,46,0.261,575,1247,0.461,0.459,307,377,0.814,261,418,679,125,74,86,192,244,1493
1997,Kenny Smith,PG,31,DET,9,0,64,8,20,0.4,5,10,0.5,3,10,0.3,0.525,2,2,1,0,5,5,10,1,0,3,2,23
1997,Kenny Smith,PG,31,ORL,6,0,47,6,13,0.462,3,5,0.6,3,8,0.375,0.577,2,2,1,1,1,2,4,0,0,6,3,17
1997,Kenny Smith,PG,31,DEN,33,3,654,87,206,0.422,51,120,0.425,36,86,0.419,0.546,35,41,0.854,3,34,37,102,18,0,62,25,260
1997,Michael Smith,PF,24,SAC,81,52,2526,202,375,0.539,0,0,NA,202,375,0.539,0.539,128,258,0.496,257,512,769,191,82,60,130,251,532
1997,Steve Smith,SG,27,ATL,72,72,2818,491,1145,0.429,130,388,0.335,361,757,0.477,0.486,333,393,0.847,90,148,238,305,62,23,176,173,1445
1997,Tony Smith,PG,28,CHH,69,39,1291,138,337,0.409,32,99,0.323,106,238,0.445,0.457,38,59,0.644,38,56,94,150,48,19,73,110,346
1997,Eric Snow,PG,23,SEA,67,0,775,74,164,0.451,4,15,0.267,70,149,0.47,0.463,47,66,0.712,17,53,70,159,37,3,48,94,199
1997,Elmore Spencer,C,27,SEA,1,0,5,0,1,0,0,0,NA,0,1,0,0,0,0,NA,0,0,0,0,1,0,1,0,0
1997,Felton Spencer,C,29,ORL,1,1,19,2,2,1,0,0,NA,2,2,1,1,0,0,NA,5,1,6,1,0,0,1,2,4
1997,Felton Spencer,C,29,GSW,72,64,1539,137,282,0.486,0,0,NA,137,282,0.486,0.486,94,161,0.584,152,258,410,21,34,50,87,273,368
1997,Jerry Stackhouse,SG,22,PHI,81,81,3166,533,1308,0.407,102,342,0.298,431,966,0.446,0.446,511,667,0.766,156,182,338,253,93,63,316,219,1679
1997,John Starks,SG,31,NYK,77,1,2042,369,856,0.431,150,407,0.369,219,449,0.488,0.519,173,225,0.769,36,169,205,217,90,11,158,196,1061
1997,Damon Stoudamire,PG,23,TOR,81,81,3311,564,1407,0.401,176,496,0.355,388,911,0.426,0.463,330,401,0.823,86,244,330,709,123,13,288,162,1634
1997,Erick Strickland,SG,23,DAL,28,15,759,102,256,0.398,28,92,0.304,74,164,0.451,0.453,65,80,0.813,21,69,90,68,27,5,66,75,297
1997,Mark Strickland,PF,26,MIA,31,0,153,25,60,0.417,0,1,0,25,59,0.424,0.417,12,21,0.571,16,21,37,1,4,10,15,17,62
1997,Rod Strickland,PG,30,WSB,82,81,2997,515,1105,0.466,13,77,0.169,502,1028,0.488,0.472,367,497,0.738,95,240,335,727,143,14,270,166,1410
1997,Bob Sura,SG,23,CLE,82,23,2269,253,587,0.431,53,164,0.323,200,423,0.473,0.476,196,319,0.614,76,232,308,390,90,33,181,218,755
1997,Žan Tabak,C,26,TOR,13,4,218,32,71,0.451,0,0,NA,32,71,0.451,0.451,20,29,0.69,20,29,49,14,6,11,21,35,84
1997,Carl Thomas,SG,27,CLE,19,0,77,9,24,0.375,2,12,0.167,7,12,0.583,0.417,1,1,1,3,10,13,8,2,1,6,7,21
1997,Kurt Thomas,PF,24,MIA,18,9,374,39,105,0.371,0,1,0,39,104,0.375,0.371,35,46,0.761,31,76,107,9,12,9,25,67,113
1997,Brooks Thompson,PG,26,UTA,2,0,8,0,1,0,0,0,NA,0,1,0,0,0,0,NA,0,0,0,1,0,0,1,1,0
1997,Brooks Thompson,PG,26,DEN,65,6,1047,162,405,0.4,97,244,0.398,65,161,0.404,0.52,24,38,0.632,18,78,96,179,55,2,86,125,445
1997,LaSalle Thompson,C,35,DEN,17,0,105,3,16,0.188,0,0,NA,3,16,0.188,0.188,1,2,0.5,5,21,26,0,3,6,7,26,7
1997,LaSalle Thompson,C,35,IND,9,0,35,0,3,0,0,0,NA,0,3,0,0,3,4,0.75,2,6,8,2,0,0,2,7,3
1997,Otis Thorpe,C,34,DET,79,79,2661,419,787,0.532,0,2,0,419,785,0.534,0.532,198,303,0.653,226,396,622,133,59,17,145,298,1036
1997,Gary Trent,PF,22,POR,82,28,1918,361,674,0.536,0,11,0,361,663,0.544,0.536,160,229,0.699,156,272,428,87,48,35,129,186,882
1997,Nick Van Exel,PG,25,LAL,79,79,2937,432,1075,0.402,177,468,0.378,255,607,0.42,0.484,165,200,0.825,44,182,226,672,75,10,212,110,1206
1997,David Vaughn,PF,23,ORL,35,6,298,31,72,0.431,0,0,NA,31,72,0.431,0.431,19,30,0.633,35,60,95,7,8,15,29,43,81
1997,Loy Vaught,PF,28,LAC,82,82,2838,542,1084,0.5,2,12,0.167,540,1072,0.504,0.501,134,191,0.702,222,595,817,110,85,25,137,241,1220
1997,Antoine Walker,PF,20,BOS,82,68,2970,576,1354,0.425,52,159,0.327,524,1195,0.438,0.445,231,366,0.631,288,453,741,262,105,53,230,271,1435
1997,Ben Wallace,PF,22,WSB,34,0,197,16,46,0.348,0,0,NA,16,46,0.348,0.348,6,20,0.3,25,33,58,2,8,11,18,27,38
1997,Rasheed Wallace,PF,22,POR,62,56,1892,380,681,0.558,9,33,0.273,371,648,0.573,0.565,169,265,0.638,122,297,419,74,48,59,114,198,938
1997,Rex Walters,SG,26,PHI,59,16,1041,148,325,0.455,57,148,0.385,91,177,0.514,0.543,49,62,0.79,21,86,107,113,28,3,61,75,402
1997,Charlie Ward,PG,26,NYK,79,21,1763,133,337,0.395,48,154,0.312,85,183,0.464,0.466,95,125,0.76,45,175,220,326,83,15,147,188,409
1997,Jamie Watson,SF,24,UTA,13,0,129,11,25,0.44,1,3,0.333,10,22,0.455,0.46,10,12,0.833,4,14,18,10,11,2,9,16,33
1997,Jamie Watson,SF,24,DAL,10,6,211,20,47,0.426,3,9,0.333,17,38,0.447,0.457,2,4,0.5,14,15,29,23,11,2,15,18,45
1997,Clarence Weatherspoon,SF,26,PHI,82,82,2949,398,811,0.491,1,6,0.167,397,805,0.493,0.491,206,279,0.738,219,460,679,140,74,86,137,187,1003
1997,Chris Webber,PF,23,WSB,72,72,2806,604,1167,0.518,60,151,0.397,544,1016,0.535,0.543,177,313,0.565,238,505,743,331,122,137,230,258,1445
1997,David Wesley,PG,26,BOS,74,73,2991,456,974,0.468,103,286,0.36,353,688,0.513,0.521,225,288,0.781,67,197,264,537,162,13,211,221,1240
1997,Chris Whitney,PG,25,WSB,82,1,1117,139,330,0.421,58,163,0.356,81,167,0.485,0.509,94,113,0.832,13,91,104,182,49,4,68,100,430
1997,Dominique Wilkins,SF,37,SAS,63,26,1945,397,953,0.417,70,239,0.293,327,714,0.458,0.453,281,350,0.803,169,233,402,119,39,31,135,100,1145
1997,Aaron Williams,C,25,DEN,1,0,10,3,5,0.6,0,0,NA,3,5,0.6,0.6,0,0,NA,2,3,5,0,0,3,4,0,6
1997,Aaron Williams,PF,25,VAN,32,1,553,82,143,0.573,0,1,0,82,142,0.577,0.573,33,49,0.673,60,78,138,15,16,26,28,72,197
1997,Eric Williams,SG,24,BOS,72,67,2435,374,820,0.456,2,8,0.25,372,812,0.458,0.457,328,436,0.752,126,203,329,129,72,13,139,213,1078
1997,Herb Williams,PF,38,NYK,21,2,184,18,46,0.391,0,1,0,18,45,0.4,0.391,3,4,0.75,9,22,31,5,4,5,5,18,39
1997,Jerome Williams,PF,23,DET,33,0,177,20,51,0.392,0,0,NA,20,51,0.392,0.392,9,17,0.529,22,28,50,7,13,1,13,18,49
1997,Lorenzo Williams,C,27,WSB,19,0,264,20,31,0.645,0,0,NA,20,31,0.645,0.645,5,7,0.714,28,41,69,4,6,8,18,49,45
1997,Monty Williams,SF,25,SAS,65,26,1345,234,460,0.509,0,1,0,234,459,0.51,0.509,120,186,0.645,98,108,206,91,55,52,116,161,588
1997,Reggie Williams,SF,32,IND,2,0,33,2,9,0.222,0,1,0,2,8,0.25,0.222,1,2,0.5,1,6,7,2,0,0,2,5,5
1997,Reggie Williams,SF,32,NJN,11,0,167,27,67,0.403,9,33,0.273,18,34,0.529,0.47,8,10,0.8,4,20,24,8,8,4,10,28,71
1997,Scott Williams,C,28,PHI,62,52,1317,162,318,0.509,0,2,0,162,316,0.513,0.509,38,55,0.691,155,242,397,41,44,41,50,206,362
1997,Walt Williams,SF,26,TOR,73,73,2647,419,982,0.427,175,437,0.4,244,545,0.448,0.516,186,243,0.765,103,264,367,197,97,62,174,282,1199
1997,Corliss Williamson,SF,23,SAC,79,31,1992,371,745,0.498,0,3,0,371,742,0.5,0.498,173,251,0.689,139,187,326,124,60,49,157,263,915
1997,Kevin Willis,PF,34,HOU,75,32,1964,350,728,0.481,2,14,0.143,348,714,0.487,0.482,140,202,0.693,146,415,561,71,42,32,119,216,842
1997,Joe Wolf,C,32,MIL,56,7,525,40,89,0.449,1,7,0.143,39,82,0.476,0.455,14,19,0.737,32,80,112,20,14,11,14,105,95
1997,David Wood,PF,32,MIL,46,0,240,20,38,0.526,5,15,0.333,15,23,0.652,0.592,12,18,0.667,5,22,27,13,7,6,6,36,57
1997,Haywoode Workman,PG,31,IND,4,2,81,11,20,0.55,0,3,0,11,17,0.647,0.55,0,1,0,4,3,7,11,3,0,5,10,22
1997,Lorenzen Wright,C,21,LAC,77,51,1936,236,491,0.481,1,4,0.25,235,487,0.483,0.482,88,150,0.587,206,265,471,49,48,60,79,211,561
1997,Sharone Wright,C,24,TOR,60,28,1009,161,403,0.4,0,1,0,161,402,0.4,0.4,68,133,0.511,79,107,186,28,15,50,93,146,390
1997,George Zídek,C,23,CHH,36,2,288,33,85,0.388,0,2,0,33,83,0.398,0.388,25,32,0.781,25,38,63,9,4,3,23,44,91
1997,George Zídek,C,23,DEN,16,0,88,16,33,0.485,0,0,NA,16,33,0.485,0.485,20,25,0.8,10,13,23,5,1,0,4,17,52
1998,Tariq Abdul-Wahad,SG,23,SAC,59,16,959,144,357,0.403,4,19,0.211,140,338,0.414,0.409,84,125,0.672,44,72,116,51,35,13,65,81,376
1998,Shareef Abdur-Rahim,SF,21,VAN,82,82,2950,653,1347,0.485,21,51,0.412,632,1296,0.488,0.493,502,640,0.784,227,354,581,213,89,76,257,201,1829
1998,Cory Alexander,PG,24,SAS,37,3,501,60,145,0.414,20,64,0.313,40,81,0.494,0.483,25,37,0.676,7,40,47,71,25,5,47,53,165
1998,Cory Alexander,PG,24,DEN,23,19,797,111,255,0.435,46,112,0.411,65,143,0.455,0.525,55,65,0.846,10,89,99,138,45,6,65,45,323
1998,Ray Allen,SG,22,MIL,82,82,3287,563,1315,0.428,134,368,0.364,429,947,0.453,0.479,342,391,0.875,127,278,405,356,111,12,263,244,1602
1998,Derek Anderson,SF,23,CLE,66,13,1839,239,586,0.408,17,84,0.202,222,502,0.442,0.422,275,315,0.873,55,132,187,227,86,13,128,136,770
1998,Greg Anderson,C,33,ATL,50,0,398,36,81,0.444,0,5,0,36,76,0.474,0.444,16,41,0.39,39,79,118,15,19,10,17,85,88
1998,Kenny Anderson,PG,27,POR,45,40,1472,204,527,0.387,47,133,0.353,157,394,0.398,0.432,112,145,0.772,36,98,134,245,61,1,114,99,567
1998,Kenny Anderson,PG,27,BOS,16,16,386,64,147,0.435,10,27,0.37,54,120,0.45,0.469,41,49,0.837,3,36,39,100,26,0,29,36,179
1998,Shandon Anderson,SG,24,UTA,82,2,1602,269,500,0.538,7,32,0.219,262,468,0.56,0.545,136,185,0.735,86,141,227,89,66,18,91,145,681
1998,Greg Anthony,PG,30,SEA,80,0,1021,150,349,0.43,66,159,0.415,84,190,0.442,0.524,53,80,0.663,18,93,111,205,64,3,91,97,419
1998,B.J. Armstrong,PG,30,GSW,4,0,59,6,19,0.316,0,1,0,6,18,0.333,0.316,5,7,0.714,4,3,7,6,4,0,7,6,17
1998,B.J. Armstrong,PG,30,CHH,62,0,772,99,194,0.51,9,34,0.265,90,160,0.563,0.534,37,43,0.86,12,57,69,144,25,0,35,68,244
1998,Darrell Armstrong,PG,29,ORL,48,17,1236,156,380,0.411,25,68,0.368,131,312,0.42,0.443,105,123,0.854,65,94,159,236,58,5,112,96,442
1998,Vincent Askew,SG,31,POR,30,5,443,19,54,0.352,0,2,0,19,52,0.365,0.352,28,39,0.718,21,47,68,38,19,5,35,39,66
1998,Stacey Augmon,SG,29,POR,71,23,1445,154,372,0.414,1,7,0.143,153,365,0.419,0.415,94,156,0.603,104,131,235,88,57,32,81,144,403
1998,Isaac Austin,C,28,MIA,52,25,1371,252,532,0.474,0,3,0,252,529,0.476,0.474,155,228,0.68,119,211,330,87,43,34,117,162,659
1998,Isaac Austin,C,28,LAC,26,25,895,154,339,0.454,0,5,0,154,334,0.461,0.454,88,135,0.652,80,147,227,88,18,22,89,69,396
1998,Vin Baker,C,26,SEA,82,82,2944,631,1164,0.542,1,7,0.143,630,1157,0.545,0.543,311,526,0.591,286,370,656,152,91,86,174,278,1574
1998,Brent Barry,SG,26,LAC,41,36,1341,190,444,0.428,78,195,0.4,112,249,0.45,0.516,103,122,0.844,27,116,143,132,50,23,95,88,561
1998,Brent Barry,SG,26,MIA,17,0,259,23,62,0.371,12,34,0.353,11,28,0.393,0.468,12,12,1,2,26,28,21,14,4,9,30,70
1998,Drew Barry,PG,24,ATL,27,0,256,18,38,0.474,9,21,0.429,9,17,0.529,0.592,11,13,0.846,5,30,35,49,10,1,30,28,56
1998,Jon Barry,SG,28,LAL,49,1,374,38,104,0.365,18,61,0.295,20,43,0.465,0.452,27,29,0.931,8,29,37,51,24,3,22,33,121
1998,Tony Battie,PF,21,DEN,65,49,1506,234,525,0.446,3,14,0.214,231,511,0.452,0.449,73,104,0.702,138,213,351,60,54,69,98,199,544
1998,Corey Beck,PG,26,CHH,59,14,738,73,159,0.459,2,4,0.5,71,155,0.458,0.465,43,59,0.729,27,63,90,98,33,7,70,100,191
1998,Benoit Benjamin,C,33,PHI,14,0,197,22,41,0.537,0,0,NA,22,41,0.537,0.537,19,30,0.633,18,35,53,3,4,4,12,26,63
1998,David Benoit,SF,29,NJN,53,0,799,102,269,0.379,41,119,0.345,61,150,0.407,0.455,37,44,0.841,42,99,141,17,26,16,39,120,282
1998,David Benoit,SF,29,ORL,24,0,324,50,139,0.36,14,51,0.275,36,88,0.409,0.41,24,30,0.8,18,44,62,8,9,4,13,37,138
1998,Travis Best,PG,25,IND,82,0,1547,201,480,0.419,21,70,0.3,180,410,0.439,0.441,112,131,0.855,28,94,122,281,85,5,111,193,535
1998,Chauncey Billups,PG,21,BOS,51,44,1296,177,454,0.39,64,189,0.339,113,265,0.426,0.46,147,180,0.817,40,73,113,217,77,2,118,118,565
1998,Chauncey Billups,PG,21,TOR,29,26,920,103,295,0.349,43,136,0.316,60,159,0.377,0.422,79,86,0.919,22,55,77,97,30,2,56,54,328
1998,Corie Blount,PF,29,LAL,70,3,1029,107,187,0.572,0,4,0,107,183,0.585,0.572,39,78,0.5,114,184,298,37,29,25,51,157,253
1998,Muggsy Bogues,PG,33,CHH,2,0,16,2,5,0.4,0,0,NA,2,5,0.4,0.4,2,2,1,0,1,1,4,2,0,1,2,6
1998,Muggsy Bogues,PG,33,GSW,59,31,1554,139,318,0.437,4,16,0.25,135,302,0.447,0.443,59,66,0.894,30,101,131,327,65,3,104,56,341
1998,Etdrick Bohannon,PF,24,IND,5,0,11,0,4,0,0,0,NA,0,4,0,0,0,0,NA,2,4,6,1,0,2,3,3,0
1998,Bruce Bowen,SF,26,BOS,61,9,1305,122,298,0.409,20,59,0.339,102,239,0.427,0.443,76,122,0.623,79,95,174,81,87,29,52,174,340
1998,Shawn Bradley,C,25,DAL,64,46,1822,300,711,0.422,1,3,0.333,299,708,0.422,0.423,130,180,0.722,164,354,518,60,51,214,96,214,731
1998,Terrell Brandon,PG,27,MIL,50,48,1784,339,731,0.464,31,93,0.333,308,638,0.483,0.485,132,156,0.846,23,153,176,387,111,17,145,120,841
1998,Scott Brooks,PG,32,CLE,43,0,312,28,66,0.424,5,11,0.455,23,55,0.418,0.462,18,20,0.9,6,24,30,49,18,3,12,25,79
1998,Chucky Brown,SF,29,ATL,77,8,1202,161,372,0.433,2,8,0.25,159,364,0.437,0.435,63,87,0.724,57,126,183,55,23,13,51,100,387
1998,Dee Brown,SG,29,BOS,41,10,811,109,255,0.427,43,113,0.381,66,142,0.465,0.512,19,28,0.679,10,52,62,53,44,6,32,76,280
1998,Dee Brown,SG,29,TOR,31,2,908,137,307,0.446,65,158,0.411,72,149,0.483,0.552,39,43,0.907,14,76,90,101,38,17,41,47,378
1998,Rick Brunson,PG,25,POR,38,10,622,49,141,0.348,22,61,0.361,27,80,0.338,0.426,42,62,0.677,14,42,56,100,25,3,52,55,162
1998,Mark Bryant,C,32,PHO,70,22,1110,109,225,0.484,0,1,0,109,224,0.487,0.484,73,95,0.768,92,152,244,46,36,15,58,180,291
1998,Jud Buechler,SF,29,CHI,74,0,608,85,176,0.483,25,65,0.385,60,111,0.541,0.554,3,6,0.5,24,53,77,49,22,15,21,47,198
1998,Scott Burrell,SF,27,CHI,80,3,1096,159,375,0.424,51,144,0.354,108,231,0.468,0.492,47,64,0.734,80,118,198,65,64,37,50,131,416
1998,Jason Caffey,PF,24,CHI,51,8,710,100,199,0.503,0,1,0,100,198,0.505,0.503,68,103,0.66,76,97,173,36,13,17,48,92,268
1998,Jason Caffey,PF,24,GSW,29,6,713,126,267,0.472,0,1,0,126,266,0.474,0.472,63,97,0.649,84,87,171,31,12,3,57,89,315
1998,Adrian Caldwell,PF,31,DAL,1,0,3,0,0,NA,0,0,NA,0,0,NA,NA,0,0,NA,0,0,0,0,0,0,0,0,0
1998,Marcus Camby,C,23,TOR,63,58,2002,308,747,0.412,0,2,0,308,745,0.413,0.412,149,244,0.611,203,263,466,111,68,230,134,200,765
1998,Elden Campbell,PF,29,LAL,81,28,1784,289,624,0.463,1,2,0.5,288,622,0.463,0.464,237,342,0.693,143,312,455,78,35,102,115,209,816
1998,Antoine Carr,PF,36,UTA,66,8,1086,151,325,0.465,0,0,NA,151,325,0.465,0.465,76,98,0.776,42,89,131,48,11,53,48,195,378
1998,Chris Carr,SG,23,MIN,51,40,1165,190,452,0.42,40,127,0.315,150,325,0.462,0.465,84,99,0.848,43,112,155,85,17,11,69,129,504
1998,Sam Cassell,PG,28,NJN,75,72,2606,510,1156,0.441,15,80,0.188,495,1076,0.46,0.448,436,507,0.86,73,155,228,603,121,20,269,262,1471
1998,Kelvin Cato,C,23,POR,74,8,1007,98,229,0.428,0,3,0,98,226,0.434,0.428,86,125,0.688,91,161,252,23,29,94,44,164,282
1998,Cedric Ceballos,SF,28,PHO,35,16,626,129,258,0.5,15,50,0.3,114,208,0.548,0.529,60,84,0.714,51,98,149,35,22,8,39,59,333
1998,Cedric Ceballos,SF,28,DAL,12,9,364,75,157,0.478,6,20,0.3,69,137,0.504,0.497,47,61,0.77,24,48,72,25,11,8,33,29,203
1998,Rex Chapman,SG,30,PHO,68,67,2263,408,956,0.427,120,311,0.386,288,645,0.447,0.49,146,187,0.781,30,143,173,203,71,14,116,102,1082
1998,Pete Chilcutt,PF,29,VAN,82,0,1420,156,359,0.435,54,130,0.415,102,229,0.445,0.51,39,59,0.661,77,229,306,104,53,37,62,158,405
1998,Chris Childs,PG,30,NYK,68,0,1599,149,354,0.421,27,87,0.31,122,267,0.457,0.459,104,126,0.825,29,133,162,268,56,6,103,179,429
1998,Doug Christie,SG,27,TOR,78,78,2939,458,1071,0.428,100,307,0.326,358,764,0.469,0.474,271,327,0.829,94,310,404,282,190,57,228,198,1287
1998,Bimbo Coles,PG,29,GSW,53,44,1471,166,438,0.379,13,57,0.228,153,381,0.402,0.394,78,88,0.886,17,106,123,248,51,13,89,135,423
1998,Marty Conlon,C,30,MIA,18,0,209,28,62,0.452,0,0,NA,28,62,0.452,0.452,32,44,0.727,16,30,46,12,9,5,11,27,88
1998,Tyrone Corbin,SF,35,ATL,79,79,2699,328,747,0.439,49,141,0.348,279,606,0.46,0.472,101,128,0.789,78,284,362,173,105,7,86,197,806
1998,Austin Croshere,PF,22,IND,26,0,243,32,86,0.372,4,13,0.308,28,73,0.384,0.395,8,14,0.571,10,35,45,8,9,5,13,32,76
1998,John Crotty,PG,28,POR,26,2,379,29,90,0.322,6,20,0.3,23,70,0.329,0.356,32,34,0.941,4,28,32,63,10,1,42,28,96
1998,Terry Cummings,PF,36,PHI,44,2,656,97,212,0.458,0,1,0,97,211,0.46,0.458,39,58,0.672,55,93,148,21,22,5,17,102,233
1998,Terry Cummings,PF,36,NYK,30,1,529,103,216,0.477,0,0,NA,103,216,0.477,0.477,28,40,0.7,42,93,135,26,16,5,34,79,234
1998,William Cunningham,C,23,UTA,6,2,38,4,9,0.444,0,0,NA,4,9,0.444,0.444,0,0,NA,4,4,8,1,2,0,0,10,8
1998,William Cunningham,C,23,PHI,1,0,1,0,0,NA,0,0,NA,0,0,NA,NA,0,0,NA,0,2,2,0,0,0,0,0,0
1998,Bill Curley,PF,25,MIN,11,1,146,16,33,0.485,0,1,0,16,32,0.5,0.485,2,3,0.667,11,17,28,4,3,1,3,28,34
1998,Michael Curry,SG,29,MIL,82,27,1978,196,418,0.469,4,9,0.444,192,409,0.469,0.474,147,176,0.835,26,72,98,137,56,14,77,218,543
1998,Antonio Daniels,SG,22,VAN,74,50,1956,228,548,0.416,11,52,0.212,217,496,0.438,0.426,112,170,0.659,22,121,143,334,55,10,164,88,579
1998,Lloyd Daniels,SG,30,TOR,6,0,82,12,29,0.414,2,9,0.222,10,20,0.5,0.448,8,10,0.8,4,3,7,4,3,2,4,4,34
1998,Antonio Davis,PF,29,IND,82,12,2191,254,528,0.481,0,3,0,254,525,0.484,0.481,277,398,0.696,192,368,560,61,45,72,103,234,785
1998,Dale Davis,C,28,IND,78,78,2174,273,498,0.548,0,0,NA,273,498,0.548,0.548,80,172,0.465,233,378,611,70,51,87,73,209,626
1998,Hubert Davis,SG,27,DAL,81,30,2378,350,767,0.456,101,230,0.439,249,537,0.464,0.522,97,116,0.836,34,135,169,157,43,5,88,117,898
1998,Todd Day,SG,28,MIA,5,0,69,11,31,0.355,2,12,0.167,9,19,0.474,0.387,6,9,0.667,4,2,6,7,7,0,3,10,30
1998,Andrew DeClercq,C,24,BOS,81,49,1523,169,340,0.497,0,1,0,169,339,0.499,0.497,101,168,0.601,180,212,392,59,85,49,84,277,439
1998,Terry Dehere,PG,26,SAC,77,18,1410,180,451,0.399,50,132,0.379,130,319,0.408,0.455,79,99,0.798,21,85,106,196,52,4,96,150,489
1998,Vinny Del Negro,SG,31,SAS,54,38,1721,211,479,0.441,17,39,0.436,194,440,0.441,0.458,74,93,0.796,13,139,152,183,39,6,53,113,513
1998,Tony Delk,PG,24,CHH,3,0,34,3,4,0.75,1,1,1,2,3,0.667,0.875,1,2,0.5,0,2,2,3,0,0,4,8,8
1998,Tony Delk,PG,24,GSW,74,9,1647,311,794,0.392,41,156,0.263,270,638,0.423,0.418,110,149,0.738,38,132,170,169,73,12,105,88,773
1998,Sherman Douglas,PG,31,NJN,80,11,1699,255,515,0.495,14,46,0.304,241,469,0.514,0.509,115,172,0.669,52,83,135,319,55,7,110,156,639
1998,Clyde Drexler,SG,35,HOU,70,70,2473,452,1059,0.427,106,334,0.317,346,725,0.477,0.477,277,346,0.801,105,241,346,382,126,42,189,193,1287
1998,Chris Dudley,C,32,NYK,51,22,858,58,143,0.406,0,0,NA,58,143,0.406,0.406,41,92,0.446,108,167,275,21,13,51,44,139,157
1998,Tony Dumas,SG,25,CLE,7,0,47,6,12,0.5,2,4,0.5,4,8,0.5,0.583,0,3,0,1,4,5,5,0,0,5,5,14
1998,Blue Edwards,SG,32,VAN,81,20,1968,326,742,0.439,40,120,0.333,286,622,0.46,0.466,180,215,0.837,61,156,217,201,86,27,134,183,872
1998,Kevin Edwards,SG,32,NJN,27,5,352,37,106,0.349,4,11,0.364,33,95,0.347,0.368,13,15,0.867,11,23,34,26,21,0,20,20,91
1998,Kevin Edwards,SG,32,ORL,12,0,135,20,59,0.339,2,4,0.5,18,55,0.327,0.356,17,20,0.85,9,11,20,13,5,1,10,8,59
1998,Howard Eisley,PG,25,UTA,82,18,1726,229,519,0.441,48,118,0.407,181,401,0.451,0.487,127,149,0.852,25,141,166,346,54,13,160,182,633
1998,Mario Elie,SF,34,HOU,73,59,1988,206,456,0.452,55,189,0.291,151,267,0.566,0.512,145,174,0.833,39,117,156,221,81,8,100,115,612
1998,Dale Ellis,SF,37,SEA,79,0,1939,348,700,0.497,127,274,0.464,221,426,0.519,0.588,111,142,0.782,51,133,184,89,60,5,74,128,934
1998,Brian Evans,SF,24,ORL,44,0,561,77,206,0.374,12,45,0.267,65,161,0.404,0.403,40,48,0.833,31,54,85,31,22,8,24,57,206
1998,Brian Evans,SF,24,NJN,28,1,332,46,106,0.434,17,42,0.405,29,64,0.453,0.514,6,9,0.667,18,34,52,24,7,5,14,44,115
1998,Jamie Feick,PF,23,MIL,45,2,450,39,90,0.433,4,13,0.308,35,77,0.455,0.456,20,41,0.488,45,79,124,16,25,17,21,67,102
1998,Michael Finley,SF,24,DAL,82,82,3394,675,1505,0.449,87,244,0.357,588,1261,0.466,0.477,326,416,0.784,150,288,438,405,132,30,219,163,1763
1998,Derek Fisher,PG,23,LAL,82,36,1760,164,378,0.434,31,81,0.383,133,297,0.448,0.475,115,152,0.757,38,155,193,333,75,5,119,126,474
1998,Greg Foster,C,29,UTA,78,49,1446,186,418,0.445,2,9,0.222,184,409,0.45,0.447,67,87,0.77,85,188,273,51,15,28,68,187,441
1998,Adonal Foyle,C,22,GSW,55,1,656,69,170,0.406,0,1,0,69,169,0.408,0.406,27,62,0.435,73,111,184,14,13,52,50,94,165
1998,Kevin Garnett,PF,21,MIN,82,82,3222,635,1293,0.491,3,16,0.188,632,1277,0.495,0.492,245,332,0.738,222,564,786,348,139,150,192,224,1518
1998,Dean Garrett,C,31,DEN,82,82,2632,242,565,0.428,0,0,NA,242,565,0.428,0.428,114,176,0.648,227,417,644,90,57,133,84,197,598
1998,Chris Gatling,PF,30,NJN,57,16,1359,248,545,0.455,1,4,0.25,247,541,0.457,0.456,159,265,0.6,118,216,334,53,52,29,99,152,656
1998,Kendall Gill,SF,29,NJN,81,81,2733,418,974,0.429,26,101,0.257,392,873,0.449,0.443,225,327,0.688,112,279,391,200,156,64,124,268,1087
1998,Armen Gilliam,PF,33,MIL,82,25,2114,327,676,0.484,0,4,0,327,672,0.487,0.484,267,333,0.802,146,293,439,104,65,37,148,177,921
1998,Anthony Goldwire,PG,26,DEN,82,32,2212,269,636,0.423,63,164,0.384,206,472,0.436,0.472,150,186,0.806,40,107,147,277,86,7,85,149,751
1998,Greg Graham,SG,27,CLE,6,0,56,7,12,0.583,0,3,0,7,9,0.778,0.583,2,2,1,0,1,1,6,1,0,10,7,16
1998,Jeff Grayer,SG,32,CHH,1,0,11,0,4,0,0,3,0,0,1,0,0,0,0,NA,0,0,0,1,0,0,2,0,0
1998,Jeff Grayer,SG,32,GSW,4,0,23,4,7,0.571,2,3,0.667,2,4,0.5,0.714,0,0,NA,0,4,4,1,2,0,2,7,10
1998,A.C. Green,PF,34,DAL,82,68,2649,242,534,0.453,0,4,0,242,530,0.457,0.453,116,162,0.716,219,449,668,123,78,27,68,157,600
1998,Tom Gugliotta,SF,28,MIN,41,41,1582,319,635,0.502,2,17,0.118,317,618,0.513,0.504,183,223,0.821,106,250,356,167,61,22,109,102,823
1998,Jack Haley,C,34,NJN,16,0,51,5,18,0.278,0,1,0,5,17,0.294,0.278,12,21,0.571,5,10,15,0,0,1,4,9,22
1998,Darvin Ham,SF,24,WAS,71,3,635,55,104,0.529,0,0,NA,55,104,0.529,0.529,35,74,0.473,72,59,131,16,21,25,37,118,145
1998,Tom Hammonds,PF,30,MIN,57,2,1140,127,246,0.516,0,1,0,127,245,0.518,0.516,92,132,0.697,100,171,271,36,15,17,48,127,346
1998,Anfernee Hardaway,SG,26,ORL,19,15,625,103,273,0.377,15,50,0.3,88,223,0.395,0.405,90,118,0.763,8,68,76,68,28,15,46,45,311
1998,Tim Hardaway,PG,31,MIA,81,81,3031,558,1296,0.431,155,442,0.351,403,854,0.472,0.49,257,329,0.781,48,251,299,672,136,16,224,200,1528
1998,Derek Harper,SG,36,ORL,66,45,1761,226,542,0.417,59,164,0.36,167,378,0.442,0.471,55,79,0.696,23,80,103,233,72,10,101,140,566
1998,Ron Harper,PG,34,CHI,82,82,2284,293,665,0.441,16,84,0.19,277,581,0.477,0.453,162,216,0.75,107,183,290,241,108,48,91,181,764
1998,Othella Harrington,PF,24,HOU,58,3,903,129,266,0.485,0,1,0,129,265,0.487,0.485,92,122,0.754,73,134,207,24,10,27,47,112,350
1998,Mark Hendrickson,PF,23,SAC,48,1,737,58,149,0.389,0,5,0,58,144,0.403,0.389,47,57,0.825,33,110,143,41,26,9,31,60,163
1998,Carl Herrera,PF,31,SAS,58,1,516,76,175,0.434,0,1,0,76,174,0.437,0.434,18,44,0.409,24,67,91,22,19,12,38,71,170
1998,Sean Higgins,SF,29,POR,2,0,12,0,5,0,0,2,0,0,3,0,0,0,0,NA,0,0,0,0,2,0,1,3,0
1998,Tyrone Hill,PF,29,MIL,57,56,2064,208,418,0.498,0,1,0,208,417,0.499,0.498,155,255,0.608,212,396,608,88,67,30,106,230,571
1998,Jerald Honeycutt,PF,23,MIL,38,0,530,90,221,0.407,29,77,0.377,61,144,0.424,0.473,36,58,0.621,27,66,93,33,20,6,49,83,245
1998,Jeff Hornacek,SG,34,UTA,80,80,2460,399,828,0.482,56,127,0.441,343,701,0.489,0.516,285,322,0.885,65,205,270,349,109,15,132,175,1139
1998,Robert Horry,PF,27,LAL,72,71,2192,200,420,0.476,19,93,0.204,181,327,0.554,0.499,117,169,0.692,186,356,542,163,112,94,99,238,536
1998,Juwan Howard,PF,24,WAS,64,64,2559,463,991,0.467,0,2,0,463,989,0.468,0.467,258,358,0.721,161,288,449,208,82,23,185,225,1184
1998,Stephen Howard,SF,27,SEA,13,0,53,8,21,0.381,0,0,NA,8,21,0.381,0.381,9,18,0.5,6,6,12,3,3,1,6,13,25
1998,Bobby Hurley,PG,26,SAC,34,3,417,47,115,0.409,4,15,0.267,43,100,0.43,0.426,30,37,0.811,7,29,36,80,13,0,42,36,128
1998,Bobby Hurley,PG,26,VAN,27,0,458,46,123,0.374,1,7,0.143,45,116,0.388,0.378,29,39,0.744,5,25,30,97,10,0,44,43,122
1998,Allen Iverson,PG,22,PHI,80,80,3150,649,1407,0.461,70,235,0.298,579,1172,0.494,0.486,390,535,0.729,86,210,296,494,176,25,244,200,1758
1998,Bobby Jackson,PG,24,DEN,68,53,2042,310,791,0.392,21,81,0.259,289,710,0.407,0.405,149,183,0.814,78,224,302,317,105,11,184,160,790
1998,Jim Jackson,SG,27,PHI,48,47,1788,246,535,0.46,39,112,0.348,207,423,0.489,0.496,126,154,0.818,69,158,227,223,41,6,145,112,657
1998,Jim Jackson,SG,27,GSW,31,31,1258,230,572,0.402,22,79,0.278,208,493,0.422,0.421,103,128,0.805,61,112,173,158,38,2,118,74,585
1998,Mark Jackson,PG,32,IND,82,82,2413,249,598,0.416,43,137,0.314,206,461,0.447,0.452,137,180,0.761,67,255,322,713,84,2,174,132,678
1998,Henry James,PF,32,CLE,28,0,166,24,59,0.407,11,25,0.44,13,34,0.382,0.5,21,22,0.955,2,13,15,5,1,1,12,24,80
1998,Anthony Johnson,PG,23,SAC,77,62,2266,226,609,0.371,42,128,0.328,184,481,0.383,0.406,80,110,0.727,51,120,171,329,64,6,120,188,574
1998,Avery Johnson,PG,32,SAS,75,73,2674,321,671,0.478,2,13,0.154,319,658,0.485,0.48,122,168,0.726,30,120,150,591,84,18,165,140,766
1998,Eddie Johnson,SF,38,HOU,75,1,1490,227,544,0.417,66,198,0.333,161,346,0.465,0.478,113,136,0.831,50,103,153,88,32,3,62,89,633
1998,Eddie Jones,SG,26,LAL,80,80,2910,486,1005,0.484,143,368,0.389,343,637,0.538,0.555,234,306,0.765,85,217,302,246,160,55,146,164,1349
1998,Reggie Jordan,SG,30,MIN,57,1,487,54,113,0.478,0,1,0,54,112,0.482,0.478,41,72,0.569,57,40,97,50,35,9,30,63,149
1998,Tim Kempton,PF,34,ORL,3,0,15,0,2,0,0,0,NA,0,2,0,0,0,0,NA,0,1,1,1,0,0,0,3,0
1998,Tim Kempton,PF,34,TOR,5,0,32,2,7,0.286,0,0,NA,2,7,0.286,0.286,0,0,NA,4,1,5,2,1,2,4,7,4
1998,Steve Kerr,PG,32,CHI,50,0,1119,137,302,0.454,57,130,0.438,80,172,0.465,0.548,45,49,0.918,14,63,77,96,26,5,27,71,376
1998,Jason Kidd,PG,24,PHO,82,82,3118,357,859,0.416,73,233,0.313,284,626,0.454,0.458,167,209,0.799,108,402,510,745,162,26,261,142,954
1998,Joe Kleine,C,36,CHI,46,1,397,39,106,0.368,0,0,NA,39,106,0.368,0.368,15,18,0.833,27,50,77,30,4,5,28,63,93
1998,Brevin Knight,PG,22,CLE,80,76,2483,261,592,0.441,0,7,0,261,585,0.446,0.441,201,251,0.801,67,186,253,656,196,18,194,271,723
1998,Toni Kukoč,SF,29,CHI,74,52,2235,383,841,0.455,63,174,0.362,320,667,0.48,0.493,155,219,0.708,121,206,327,314,76,37,154,149,984
1998,Christian Laettner,PF,28,ATL,74,49,2282,354,730,0.485,6,27,0.222,348,703,0.495,0.489,306,354,0.864,142,345,487,190,71,73,183,246,1020
1998,Andrew Lang,C,31,MIL,57,0,692,54,143,0.378,0,1,0,54,142,0.38,0.378,44,57,0.772,56,97,153,16,18,27,33,101,152
1998,Antonio Lang,SF,25,MIA,6,0,29,3,5,0.6,0,0,NA,3,5,0.6,0.6,6,8,0.75,2,3,5,1,2,0,4,3,12
1998,Tim Legler,SG,31,WAS,8,0,76,3,19,0.158,0,6,0,3,13,0.231,0.158,3,4,0.75,2,2,4,3,1,0,4,11,9
1998,Voshon Lenard,SG,24,MIA,81,81,2621,363,854,0.425,153,378,0.405,210,476,0.441,0.515,141,179,0.788,72,220,292,180,58,16,99,219,1020
1998,Alton Lister,C,39,POR,7,0,44,3,8,0.375,0,0,NA,3,8,0.375,0.375,0,0,NA,2,9,11,1,1,1,2,12,6
1998,Brad Lohaus,PF,33,SAS,9,0,102,7,21,0.333,4,14,0.286,3,7,0.429,0.429,1,3,0.333,3,9,12,5,1,2,3,10,19
1998,Grant Long,PF,31,DET,40,17,739,50,117,0.427,0,4,0,50,113,0.442,0.427,41,57,0.719,57,93,150,25,29,12,22,91,141
1998,Luc Longley,C,29,CHI,58,58,1703,277,609,0.455,0,0,NA,277,609,0.455,0.455,109,148,0.736,113,228,341,161,34,62,130,206,663
1998,Sam Mack,SF,27,VAN,57,54,1414,222,559,0.397,110,269,0.409,112,290,0.386,0.496,62,77,0.805,30,103,133,101,41,11,69,117,616
1998,Danny Manning,PF,31,PHO,70,11,1794,390,756,0.516,0,7,0,390,749,0.521,0.516,167,226,0.739,110,282,392,139,71,46,100,201,947
1998,Stephon Marbury,PG,20,MIN,82,81,3112,513,1237,0.415,95,304,0.313,418,933,0.448,0.453,329,450,0.731,58,172,230,704,104,7,256,222,1450
1998,Donyell Marshall,SF,24,GSW,73,73,2611,451,1090,0.414,63,201,0.313,388,889,0.436,0.443,158,216,0.731,210,418,628,159,95,73,147,226,1123
1998,Darrick Martin,PG,26,LAC,82,63,2299,275,730,0.377,107,293,0.365,168,437,0.384,0.45,184,217,0.848,19,145,164,331,82,10,154,198,841
1998,Jamal Mashburn,SF,25,MIA,48,48,1729,251,577,0.435,37,122,0.303,214,455,0.47,0.467,184,231,0.797,72,164,236,132,43,14,108,137,723
1998,Tony Massenburg,C,30,VAN,61,13,894,148,309,0.479,0,0,NA,148,309,0.479,0.479,100,137,0.73,80,152,232,21,25,24,60,123,396
1998,Vernon Maxwell,SG,32,ORL,11,0,169,26,78,0.333,6,26,0.231,20,52,0.385,0.372,23,26,0.885,5,8,13,12,2,1,12,20,81
1998,Vernon Maxwell,SG,32,CHH,31,0,467,77,180,0.428,31,86,0.36,46,94,0.489,0.514,25,34,0.735,9,35,44,40,14,3,28,51,210
1998,Walter McCarty,SF,23,BOS,82,64,2340,295,730,0.404,54,175,0.309,241,555,0.434,0.441,144,194,0.742,141,223,364,177,110,44,141,274,788
1998,George McCloud,SF,30,PHO,63,13,1213,173,427,0.405,71,208,0.341,102,219,0.466,0.488,39,51,0.765,45,173,218,84,54,13,63,132,456
1998,Xavier McDaniel,SF,34,NJN,20,0,180,10,30,0.333,0,0,NA,10,30,0.333,0.333,5,8,0.625,12,19,31,9,3,2,8,23,25
1998,Antonio McDyess,PF,23,PHO,81,81,2441,497,927,0.536,0,2,0,497,925,0.537,0.536,231,329,0.702,206,407,613,106,100,135,142,292,1225
1998,Tracy McGrady,SF,18,TOR,64,17,1179,179,398,0.45,14,41,0.341,165,357,0.462,0.467,79,111,0.712,105,164,269,98,49,61,66,86,451
1998,Aaron McKie,SF,25,DET,24,1,472,43,104,0.413,3,17,0.176,40,87,0.46,0.428,20,23,0.87,24,44,68,38,23,1,24,47,109
1998,Aaron McKie,SG,25,PHI,57,31,1341,96,277,0.347,9,46,0.196,87,231,0.377,0.363,22,32,0.688,34,129,163,137,78,12,52,117,223
1998,Ron Mercer,SG,21,BOS,80,62,2662,515,1145,0.45,3,28,0.107,512,1117,0.458,0.451,188,224,0.839,109,171,280,176,125,17,132,213,1221
1998,Anthony Miller,PF,26,ATL,37,0,228,29,52,0.558,0,0,NA,29,52,0.558,0.558,21,39,0.538,30,40,70,3,15,3,14,41,79
1998,Oliver Miller,C,27,TOR,64,53,1628,170,369,0.461,0,4,0,170,365,0.466,0.461,61,101,0.604,146,254,400,196,58,72,131,184,401
1998,Terry Mills,PF,30,MIA,50,0,782,81,206,0.393,25,81,0.309,56,125,0.448,0.454,25,33,0.758,34,118,152,39,19,9,45,129,212
1998,Eric Montross,C,26,PHI,20,20,337,30,76,0.395,0,0,NA,30,76,0.395,0.395,7,19,0.368,28,64,92,7,7,12,15,61,67
1998,Eric Montross,C,26,DET,28,10,354,31,68,0.456,0,0,NA,31,68,0.456,0.456,9,21,0.429,41,66,107,4,6,15,14,66,71
1998,Alonzo Mourning,C,27,MIA,58,56,1939,403,732,0.551,0,0,NA,403,732,0.551,0.551,309,465,0.665,193,365,558,52,40,130,179,208,1115
1998,Eric Murdock,PG,29,MIA,82,1,1395,177,419,0.422,28,91,0.308,149,328,0.454,0.456,125,156,0.801,39,117,156,219,103,13,104,173,507
1998,Tracy Murray,SF,26,WAS,82,12,2227,449,1007,0.446,158,403,0.392,291,604,0.482,0.524,182,209,0.871,75,202,277,84,67,25,102,167,1238
1998,Dikembe Mutombo,C,31,ATL,82,82,2917,399,743,0.537,0,0,NA,399,743,0.537,0.537,303,452,0.67,276,656,932,82,34,277,168,254,1101
1998,Martin Müürsepp,PF,23,DAL,41,7,603,83,191,0.435,16,38,0.421,67,153,0.438,0.476,51,67,0.761,46,68,114,30,29,14,29,96,233
1998,Pete Myers,SG,34,NYK,9,0,40,5,10,0.5,0,0,NA,5,10,0.5,0.5,4,6,0.667,5,5,10,3,4,0,4,7,14
1998,Johnny Newman,SF,34,DEN,74,15,2176,344,799,0.431,36,105,0.343,308,694,0.444,0.453,365,445,0.82,50,91,141,138,77,24,147,208,1089
1998,Jermaine O'Neal,PF,19,POR,60,9,808,112,231,0.485,0,2,0,112,229,0.489,0.485,45,89,0.506,80,121,201,17,15,58,55,101,269
1998,Shaquille O'Neal,C,25,LAL,60,57,2175,670,1147,0.584,0,0,NA,670,1147,0.584,0.584,359,681,0.527,208,473,681,142,39,144,175,193,1699
1998,Kevin Ollie,PG,25,DAL,16,0,214,14,42,0.333,0,0,NA,14,42,0.333,0.333,18,25,0.72,6,15,21,32,6,0,16,16,46
1998,Kevin Ollie,PG,25,ORL,19,0,216,23,56,0.411,0,1,0,23,55,0.418,0.411,31,45,0.689,3,15,18,33,7,0,28,15,77
1998,Bo Outlaw,PF,26,ORL,82,76,2953,301,543,0.554,1,4,0.25,300,539,0.557,0.555,180,313,0.575,255,382,637,216,107,181,175,260,783
1998,Doug Overton,PG,28,PHI,23,2,277,24,63,0.381,0,3,0,24,60,0.4,0.381,14,16,0.875,2,12,14,37,8,1,23,34,62
1998,Billy Owens,SF,28,SAC,78,78,2348,338,728,0.464,26,70,0.371,312,658,0.474,0.482,116,197,0.589,170,412,582,219,93,38,153,231,818
1998,Robert Pack,PG,28,DAL,12,10,292,33,98,0.337,3,6,0.5,30,92,0.326,0.352,25,36,0.694,8,26,34,42,20,1,38,17,94
1998,Cherokee Parks,C,25,MIN,79,43,1703,224,449,0.499,0,1,0,224,448,0.5,0.499,110,169,0.651,140,297,437,53,36,86,66,237,558
1998,Gary Payton,PG,29,SEA,82,82,3145,579,1278,0.453,134,397,0.338,445,881,0.505,0.505,279,375,0.744,77,299,376,679,185,18,229,195,1571
1998,Anthony Peeler,SG,28,VAN,8,8,202,35,72,0.486,5,19,0.263,30,53,0.566,0.521,4,6,0.667,6,14,20,23,9,0,6,16,79
1998,Anthony Peeler,SG,28,MIN,30,24,991,155,348,0.445,48,106,0.453,107,242,0.442,0.514,32,41,0.78,31,72,103,114,52,6,45,81,390
1998,Sam Perkins,PF,36,SEA,81,0,1675,196,471,0.416,87,222,0.392,109,249,0.438,0.508,101,128,0.789,53,202,255,113,62,29,62,158,580
1998,Elliot Perry,PG,28,MIL,81,33,1752,241,561,0.43,17,50,0.34,224,511,0.438,0.445,92,109,0.844,21,87,108,230,90,2,128,129,591
1998,Wesley Person,SG,26,CLE,82,82,3198,440,957,0.46,192,447,0.43,248,510,0.486,0.56,132,170,0.776,65,298,363,188,129,49,110,108,1204
1998,Ricky Pierce,SG,38,MIL,39,0,442,52,143,0.364,4,13,0.308,48,130,0.369,0.378,43,52,0.827,19,26,45,34,9,0,21,35,151
1998,Olden Polynice,C,33,SAC,70,25,1458,249,542,0.459,0,1,0,249,541,0.46,0.459,52,115,0.452,173,266,439,107,37,45,98,158,550
1998,Vitaly Potapenko,C,22,CLE,80,0,1412,234,488,0.48,0,1,0,234,487,0.48,0.48,102,144,0.708,110,203,313,57,27,28,132,198,570
1998,Theo Ratliff,C,24,DET,24,12,586,57,111,0.514,0,0,NA,57,111,0.514,0.514,43,63,0.683,46,75,121,15,12,55,34,83,157
1998,Theo Ratliff,C,24,PHI,58,55,1861,249,486,0.512,0,0,NA,249,486,0.512,0.512,154,218,0.706,175,251,426,42,38,203,82,209,652
1998,Eldridge Recasner,SG,30,ATL,59,14,1454,206,452,0.456,62,148,0.419,144,304,0.474,0.524,74,79,0.937,32,110,142,117,41,1,91,94,548
1998,Khalid Reeves,PG,25,DAL,82,54,1950,248,593,0.418,56,152,0.368,192,441,0.435,0.465,165,213,0.775,54,131,185,230,80,10,130,195,717
1998,Don Reid,PF,24,DET,68,44,994,94,176,0.534,0,0,NA,94,176,0.534,0.534,50,71,0.704,77,98,175,26,25,55,28,183,238
1998,J.R. Reid,PF,29,CHH,79,1,1109,146,318,0.459,3,8,0.375,143,310,0.461,0.464,89,122,0.73,72,138,210,51,35,19,65,172,384
1998,Shawn Respert,SG,25,TOR,47,4,696,94,209,0.45,25,67,0.373,69,142,0.486,0.51,44,54,0.815,30,43,73,44,29,1,33,58,257
1998,Shawn Respert,SG,25,DAL,10,0,215,36,84,0.429,6,26,0.231,30,58,0.517,0.464,4,7,0.571,7,20,27,17,5,0,15,17,82
1998,Rodrick Rhodes,SF,24,HOU,58,13,1070,112,305,0.367,2,8,0.25,110,297,0.37,0.37,111,180,0.617,28,42,70,110,62,10,97,125,337
1998,Chris Robinson,SG,23,VAN,16,0,143,23,63,0.365,7,24,0.292,16,39,0.41,0.421,1,2,0.5,0,13,13,10,7,1,15,21,54
1998,Chris Robinson,SG,23,SAC,19,0,271,42,111,0.378,17,42,0.405,25,69,0.362,0.455,7,14,0.5,9,24,33,29,12,3,18,29,108
1998,Clifford Robinson,SF,31,PHO,80,64,2359,429,895,0.479,27,84,0.321,402,811,0.496,0.494,248,360,0.689,152,258,410,170,92,90,140,249,1133
1998,James Robinson,PG,27,LAC,70,13,1231,195,501,0.389,74,225,0.329,121,276,0.438,0.463,77,107,0.72,37,74,111,135,37,10,97,101,541
1998,Larry Robinson,SF,30,VAN,6,0,41,6,19,0.316,3,6,0.5,3,13,0.231,0.395,2,2,1,2,10,12,1,4,0,2,0,17
1998,Carlos Rogers,PF,26,TOR,18,0,351,45,87,0.517,0,1,0,45,86,0.523,0.517,18,32,0.563,34,31,65,16,9,8,13,34,108
1998,Carlos Rogers,PF,26,POR,3,0,25,2,4,0.5,0,1,0,2,3,0.667,0.5,0,0,NA,1,1,2,2,1,0,1,1,4
1998,Rodney Rogers,SF,26,LAC,76,70,2499,426,935,0.456,72,212,0.34,354,723,0.49,0.494,225,328,0.686,155,269,424,202,93,38,193,242,1149
1998,Roy Rogers,PF,24,BOS,9,0,37,3,8,0.375,0,0,NA,3,8,0.375,0.375,1,2,0.5,0,5,5,1,2,4,1,6,7
1998,Roy Rogers,PF,24,TOR,6,0,69,6,17,0.353,0,0,NA,6,17,0.353,0.353,1,4,0.25,8,4,12,1,1,4,4,12,13
1998,Sean Rooks,C,28,LAL,41,1,425,46,101,0.455,0,0,NA,46,101,0.455,0.455,47,79,0.595,46,72,118,24,2,23,19,68,139
1998,Jalen Rose,SF,25,IND,82,0,1706,290,607,0.478,25,73,0.342,265,534,0.496,0.498,166,228,0.728,28,167,195,155,56,14,132,171,771
1998,Malik Rose,PF,23,SAS,53,0,429,59,136,0.434,1,3,0.333,58,133,0.436,0.438,39,61,0.639,40,50,90,19,21,7,44,79,158
1998,Donald Royal,SF,31,ORL,2,0,18,1,6,0.167,0,0,NA,1,6,0.167,0.167,3,4,0.75,2,2,4,1,1,0,3,5,5
1998,Donald Royal,SF,31,CHH,29,5,305,24,63,0.381,0,0,NA,24,63,0.381,0.381,26,29,0.897,16,21,37,16,6,1,7,30,74
1998,Clifford Rozier,C,25,MIN,6,0,30,3,6,0.5,0,0,NA,3,6,0.5,0.5,0,1,0,3,3,6,0,0,0,4,7,6
1998,Danny Schayes,C,38,ORL,74,33,1272,155,371,0.418,0,0,NA,155,371,0.418,0.418,96,119,0.807,97,145,242,44,34,33,61,182,406
1998,Dennis Scott,SF,29,DAL,52,42,1797,258,666,0.387,94,273,0.344,164,393,0.417,0.458,97,118,0.822,39,158,197,129,43,32,92,121,707
1998,Dennis Scott,SF,29,PHO,29,3,493,71,162,0.438,31,69,0.449,40,93,0.43,0.534,8,12,0.667,8,42,50,24,10,7,12,31,181
1998,Rony Seikaly,C,32,ORL,47,47,1484,237,538,0.441,0,2,0,237,536,0.442,0.441,230,305,0.754,130,227,357,69,25,39,134,137,704
1998,Rony Seikaly,C,32,NJN,9,2,152,13,41,0.317,0,0,NA,13,41,0.317,0.317,16,27,0.593,16,20,36,8,3,4,12,27,42
1998,Brian Shaw,PG,31,GSW,39,32,1028,103,307,0.336,21,67,0.313,82,240,0.342,0.37,24,33,0.727,20,131,151,173,35,14,75,93,251
1998,Brian Shaw,PG,31,PHI,20,2,502,51,139,0.367,7,28,0.25,44,111,0.396,0.392,12,19,0.632,17,47,64,88,14,3,24,55,121
1998,Dickey Simpkins,PF,25,GSW,19,0,196,22,48,0.458,0,1,0,22,47,0.468,0.458,10,26,0.385,19,27,46,16,5,2,19,19,54
1998,Dickey Simpkins,PF,25,CHI,21,0,237,26,41,0.634,0,1,0,26,40,0.65,0.634,26,44,0.591,8,23,31,17,4,3,13,35,78
1998,Reggie Slater,PF,27,TOR,78,28,1662,211,459,0.46,0,0,NA,211,459,0.46,0.46,203,322,0.63,134,171,305,74,45,30,102,201,625
1998,Charles Smith,SG,22,MIA,11,0,32,4,18,0.222,1,3,0.333,3,15,0.2,0.25,1,2,0.5,5,3,8,2,2,1,6,3,10
1998,Charles Smith,SG,22,LAC,23,0,260,45,107,0.421,14,44,0.318,31,63,0.492,0.486,5,9,0.556,8,11,19,19,10,5,21,21,109
1998,Joe Smith,PF,22,GSW,49,49,1645,343,800,0.429,0,7,0,343,793,0.433,0.429,160,208,0.769,141,197,338,67,44,38,106,169,846
1998,Joe Smith,PF,22,PHI,30,6,699,121,270,0.448,0,1,0,121,269,0.45,0.448,67,85,0.788,58,75,133,27,18,13,52,94,309
1998,Michael Smith,PF,25,SAC,18,4,347,26,61,0.426,0,0,NA,26,61,0.426,0.426,17,30,0.567,35,65,100,29,15,9,15,35,69
1998,Michael Smith,PF,25,VAN,30,29,706,67,133,0.504,0,1,0,67,132,0.508,0.504,48,73,0.658,85,121,206,59,26,6,36,60,182
1998,Steve Smith,SG,28,ATL,73,73,2857,489,1101,0.444,97,276,0.351,392,825,0.475,0.488,389,455,0.855,133,176,309,292,75,29,176,219,1464
1998,Tony Smith,PG,29,MIL,7,0,80,8,24,0.333,0,4,0,8,20,0.4,0.333,3,4,0.75,4,3,7,10,5,2,9,7,19
1998,Eric Snow,PG,24,SEA,17,0,74,10,23,0.435,0,1,0,10,22,0.455,0.435,5,10,0.5,0,4,4,13,0,1,12,15,25
1998,Eric Snow,PG,24,PHI,47,0,844,69,161,0.429,2,16,0.125,67,145,0.462,0.435,44,61,0.721,19,58,77,164,60,4,51,99,184
1998,Felton Spencer,C,30,GSW,68,0,813,59,129,0.457,0,0,NA,59,129,0.457,0.457,44,79,0.557,93,133,226,17,23,37,49,175,162
1998,Jerry Stackhouse,SF,23,PHI,22,22,748,128,283,0.452,16,46,0.348,112,237,0.473,0.481,81,101,0.802,28,48,76,67,31,21,74,56,353
1998,Jerry Stackhouse,SG,23,DET,57,15,1797,296,692,0.428,31,149,0.208,265,543,0.488,0.45,273,349,0.782,77,113,190,174,58,38,150,119,896
1998,John Starks,SG,32,NYK,82,10,2188,372,947,0.393,130,398,0.327,242,549,0.441,0.461,185,235,0.787,48,182,230,219,78,5,143,205,1059
1998,Michael Stewart,C,22,SAC,81,37,1761,155,323,0.48,0,0,NA,155,323,0.48,0.48,65,142,0.458,197,339,536,61,29,195,85,251,375
1998,Damon Stoudamire,PG,24,TOR,49,49,2033,354,833,0.425,65,205,0.317,289,628,0.46,0.464,179,212,0.844,63,154,217,399,80,5,159,112,952
1998,Damon Stoudamire,PG,24,POR,22,22,806,94,258,0.364,26,99,0.263,68,159,0.428,0.415,59,75,0.787,24,57,81,181,33,2,64,38,273
1998,Erick Strickland,SG,24,DAL,67,19,1505,199,558,0.357,48,163,0.294,151,395,0.382,0.4,65,84,0.774,35,126,161,167,56,8,106,140,511
1998,Mark Strickland,PF,27,MIA,51,8,847,145,269,0.539,0,1,0,145,268,0.541,0.539,59,82,0.72,80,133,213,26,18,34,47,87,349
1998,Rod Strickland,PG,31,WAS,76,76,3020,490,1130,0.434,12,48,0.25,478,1082,0.442,0.439,357,492,0.726,112,293,405,801,126,25,266,182,1349
1998,Bob Sura,SG,24,CLE,46,4,942,87,231,0.377,19,60,0.317,68,171,0.398,0.418,74,131,0.565,25,69,94,171,44,7,93,113,267
1998,Žan Tabak,C,27,TOR,39,29,752,116,249,0.466,0,1,0,116,248,0.468,0.466,16,48,0.333,59,95,154,36,15,27,44,117,248
1998,Žan Tabak,C,27,BOS,18,5,232,26,55,0.473,0,0,NA,26,55,0.473,0.473,7,13,0.538,25,33,58,12,5,11,17,46,59
1998,Johnny Taylor,SF,23,ORL,12,0,108,13,37,0.351,1,2,0.5,12,35,0.343,0.365,11,16,0.688,4,9,13,1,3,2,8,22,38
1998,Maurice Taylor,PF,21,LAC,71,3,1513,321,675,0.476,0,1,0,321,674,0.476,0.476,173,244,0.709,118,178,296,53,34,40,107,222,815
1998,Carl Thomas,SG,28,GSW,10,0,139,25,65,0.385,5,21,0.238,20,44,0.455,0.423,7,10,0.7,4,6,10,9,5,1,6,12,62
1998,Carl Thomas,SG,28,ORL,4,0,15,4,5,0.8,0,0,NA,4,5,0.8,0.8,1,2,0.5,0,0,0,1,0,1,0,0,9
1998,Carl Thomas,SG,28,CLE,29,0,272,27,70,0.386,15,38,0.395,12,32,0.375,0.493,8,13,0.615,6,31,37,9,16,5,12,27,77
1998,John Thomas,PF,22,BOS,33,2,368,41,80,0.513,0,0,NA,41,80,0.513,0.513,26,33,0.788,32,38,70,13,19,9,33,65,108
1998,John Thomas,PF,22,TOR,21,0,167,14,33,0.424,0,0,NA,14,33,0.424,0.424,15,21,0.714,16,20,36,4,3,3,13,32,43
1998,Kurt Thomas,PF,25,DAL,5,0,73,17,45,0.378,0,0,NA,17,45,0.378,0.378,3,3,1,8,16,24,3,1,0,10,19,37
1998,Tim Thomas,SF,20,PHI,77,48,1779,306,684,0.447,62,171,0.363,244,513,0.476,0.493,171,231,0.74,107,181,288,90,54,17,118,185,845
1998,Brooks Thompson,PG,27,PHO,13,0,46,10,27,0.37,5,16,0.313,5,11,0.455,0.463,1,3,0.333,1,4,5,3,4,0,5,6,26
1998,Brooks Thompson,PG,27,NYK,17,0,121,13,29,0.448,4,14,0.286,9,15,0.6,0.517,3,5,0.6,0,10,10,24,6,1,11,16,33
1998,Otis Thorpe,PF,35,VAN,47,46,1574,205,430,0.477,0,4,0,205,426,0.481,0.477,118,170,0.694,100,271,371,161,30,23,115,158,528
1998,Otis Thorpe,PF,35,SAC,27,20,623,89,194,0.459,0,1,0,89,193,0.461,0.459,46,70,0.657,51,115,166,61,18,7,37,80,224
1998,Gary Trent,PF,23,POR,41,13,1005,177,359,0.493,4,9,0.444,173,350,0.494,0.499,113,163,0.693,80,154,234,58,27,19,72,115,471
1998,Gary Trent,PF,23,TOR,13,7,355,64,146,0.438,0,3,0,64,143,0.448,0.438,31,49,0.633,43,61,104,14,8,8,22,46,159
1998,Nick Van Exel,PG,26,LAL,64,46,2053,311,743,0.419,123,316,0.389,188,427,0.44,0.501,136,172,0.791,31,163,194,442,64,6,104,120,881
1998,Keith Van Horn,PF,22,NJN,62,62,2325,446,1047,0.426,69,224,0.308,377,823,0.458,0.459,258,305,0.846,142,266,408,106,64,25,164,216,1219
1998,David Vaughn,PF,24,GSW,22,0,322,46,114,0.404,0,1,0,46,113,0.407,0.404,22,34,0.647,34,68,102,18,10,6,31,48,114
1998,David Vaughn,PF,24,CHI,3,0,6,1,1,1,0,0,NA,1,1,1,1,2,4,0.5,0,1,1,0,0,0,0,1,4
1998,David Vaughn,PF,24,NJN,15,2,161,19,33,0.576,0,0,NA,19,33,0.576,0.576,6,9,0.667,19,30,49,2,5,4,9,34,44
1998,Loy Vaught,PF,29,LAC,10,6,265,36,84,0.429,0,2,0,36,82,0.439,0.429,3,8,0.375,16,49,65,7,4,2,13,33,75
1998,Antoine Walker,PF,21,BOS,82,82,3268,722,1705,0.423,91,292,0.312,631,1413,0.447,0.45,305,473,0.645,270,566,836,273,142,60,292,262,1840
1998,Ben Wallace,C,23,WAS,67,16,1124,85,164,0.518,0,0,NA,85,164,0.518,0.518,35,98,0.357,112,212,324,18,61,72,28,116,205
1998,Rasheed Wallace,PF,23,POR,77,77,2896,466,875,0.533,8,39,0.205,458,836,0.548,0.537,184,278,0.662,132,346,478,195,75,88,167,268,1124
1998,Rex Walters,SG,27,PHI,19,0,127,11,29,0.379,3,14,0.214,8,15,0.533,0.431,17,17,1,3,6,9,21,5,0,17,17,42
1998,Rex Walters,SG,27,MIA,19,0,108,13,24,0.542,3,8,0.375,10,16,0.625,0.604,9,11,0.818,2,13,15,14,3,1,10,11,38
1998,Charlie Ward,PG,27,NYK,82,82,2317,235,516,0.455,81,215,0.377,154,301,0.512,0.534,91,113,0.805,32,242,274,466,144,37,175,195,642
1998,Clarence Weatherspoon,PF,27,PHI,48,18,1290,141,331,0.426,0,0,NA,141,331,0.426,0.426,123,174,0.707,109,227,336,40,43,52,69,108,405
1998,Clarence Weatherspoon,PF,27,GSW,31,31,1035,127,277,0.458,0,0,NA,127,277,0.458,0.458,77,103,0.748,89,169,258,49,42,22,50,86,331
1998,Spud Webb,PG,34,ORL,4,0,34,5,12,0.417,0,1,0,5,11,0.455,0.417,2,2,1,2,1,3,5,1,0,7,6,12
1998,Chris Webber,C,24,WAS,71,71,2809,647,1341,0.482,65,205,0.317,582,1136,0.512,0.507,196,333,0.589,176,498,674,273,111,124,185,269,1555
1998,David Wesley,PG,27,CHH,81,81,2845,383,864,0.443,59,170,0.347,324,694,0.467,0.477,229,288,0.795,49,164,213,529,140,30,226,229,1054
1998,Chris Whitney,PG,26,WAS,82,6,1073,126,355,0.355,52,169,0.308,74,186,0.398,0.428,118,129,0.915,16,99,115,196,34,6,65,106,422
1998,Aaron Williams,PF,26,SEA,65,9,757,115,220,0.523,0,1,0,115,219,0.525,0.523,66,85,0.776,48,99,147,14,19,38,50,119,296
1998,Alvin Williams,SG,23,POR,41,10,864,109,238,0.458,7,24,0.292,102,214,0.477,0.473,58,79,0.734,19,41,60,83,30,2,50,60,283
1998,Alvin Williams,SG,23,TOR,13,3,207,16,44,0.364,2,4,0.5,14,40,0.35,0.386,7,11,0.636,5,16,21,20,8,1,8,19,41
1998,Eric Williams,SF,25,DEN,4,4,145,24,61,0.393,0,0,NA,24,61,0.393,0.393,31,45,0.689,10,11,21,12,4,0,9,9,79
1998,Herb Williams,PF,39,NYK,27,0,178,18,43,0.419,0,0,NA,18,43,0.419,0.419,1,8,0.125,6,23,29,4,6,9,5,34,37
1998,Jerome Williams,PF,24,DET,77,3,1305,151,288,0.524,0,1,0,151,287,0.526,0.524,108,166,0.651,170,209,379,48,51,10,60,144,410
1998,Lorenzo Williams,PF,28,WAS,14,6,111,13,17,0.765,0,0,NA,13,17,0.765,0.765,0,2,0,16,10,26,3,2,3,2,17,26
1998,Micheal Williams,PG,31,MIN,25,0,161,16,48,0.333,0,4,0,16,44,0.364,0.333,32,33,0.97,2,12,14,32,9,2,16,24,64
1998,Monty Williams,SF,26,SAS,72,16,1314,165,368,0.448,1,2,0.5,164,366,0.448,0.45,122,182,0.67,67,112,179,89,34,24,82,133,453
1998,Scott Williams,C,29,PHI,58,7,801,93,213,0.437,0,5,0,93,208,0.447,0.437,51,63,0.81,87,124,211,29,17,21,30,132,237
1998,Walt Williams,SF,27,TOR,28,16,876,125,319,0.392,49,129,0.38,76,190,0.4,0.469,49,60,0.817,27,91,118,69,40,23,52,100,348
1998,Walt Williams,SF,27,POR,31,1,594,85,225,0.378,31,90,0.344,54,135,0.4,0.447,59,65,0.908,23,59,82,53,19,12,40,61,260
1998,Corliss Williamson,SF,24,SAC,79,75,2819,561,1134,0.495,0,9,0,561,1125,0.499,0.495,279,443,0.63,162,284,446,230,76,48,199,252,1401
1998,Kevin Willis,PF,35,HOU,81,74,2528,531,1041,0.51,1,7,0.143,530,1034,0.513,0.511,242,305,0.793,232,447,679,78,55,38,170,235,1305
1998,Joe Wolf,PF,33,DEN,57,8,621,40,121,0.331,2,10,0.2,38,111,0.342,0.339,5,10,0.5,36,90,126,30,20,7,22,92,87
1998,Lorenzen Wright,C,22,LAC,69,38,2067,241,542,0.445,0,2,0,241,540,0.446,0.445,141,214,0.659,180,426,606,55,55,87,81,237,623
1998,Sharone Wright,C,25,TOR,7,0,44,7,14,0.5,0,0,NA,7,14,0.5,0.5,2,4,0.5,1,8,9,4,0,0,2,7,16
1998,George Zídek,C,24,DEN,6,0,42,4,15,0.267,0,0,NA,4,15,0.267,0.267,10,12,0.833,4,9,13,1,0,2,3,5,18
1998,George Zídek,C,24,SEA,6,0,22,3,14,0.214,1,2,0.5,2,12,0.167,0.25,4,4,1,0,4,4,1,0,0,1,5,11
1999,Tariq Abdul-Wahad,SG,24,SAC,49,49,1205,177,407,0.435,6,21,0.286,171,386,0.443,0.442,94,136,0.691,72,114,186,50,50,16,70,121,454
1999,Shareef Abdur-Rahim,SF,22,VAN,50,50,2021,386,893,0.432,11,36,0.306,375,857,0.438,0.438,369,439,0.841,114,260,374,172,69,55,186,137,1152
1999,Cory Alexander,PG,25,DEN,36,4,778,97,260,0.373,30,105,0.286,67,155,0.432,0.431,37,44,0.841,7,67,74,119,35,5,69,77,261
1999,Ray Allen,SG,23,MIL,50,50,1719,303,673,0.45,74,208,0.356,229,465,0.492,0.505,176,195,0.903,57,155,212,178,53,7,122,117,856
1999,Derek Anderson,SG,24,CLE,38,13,978,125,314,0.398,21,69,0.304,104,245,0.424,0.432,138,165,0.836,20,89,109,145,48,4,82,73,409
1999,Kenny Anderson,PG,28,BOS,34,33,1010,161,357,0.451,6,24,0.25,155,333,0.465,0.459,84,101,0.832,24,79,103,193,33,2,71,78,412
1999,Shandon Anderson,SG,25,UTA,50,2,1072,162,363,0.446,14,41,0.341,148,322,0.46,0.466,89,125,0.712,49,83,132,56,39,10,66,89,427
1999,Greg Anthony,PG,31,POR,50,0,806,104,251,0.414,49,125,0.392,55,126,0.437,0.512,62,89,0.697,14,49,63,100,66,3,55,75,319
1999,B.J. Armstrong,PG,31,CHH,10,1,178,21,43,0.488,6,8,0.75,15,35,0.429,0.558,9,10,0.9,1,15,16,27,3,0,10,16,57
1999,B.J. Armstrong,PG,31,ORL,22,0,180,19,45,0.422,1,7,0.143,18,38,0.474,0.433,9,11,0.818,1,22,23,34,9,0,15,15,48
1999,Darrell Armstrong,PG,30,ORL,50,15,1502,230,522,0.441,69,189,0.365,161,333,0.483,0.507,161,178,0.904,53,127,180,335,108,4,158,90,690
1999,Stacey Augmon,SF,30,POR,48,21,874,78,174,0.448,0,2,0,78,172,0.453,0.448,52,76,0.684,47,78,125,58,57,18,30,81,208
1999,Isaac Austin,C,29,ORL,49,49,1259,185,453,0.408,2,7,0.286,183,446,0.41,0.411,105,157,0.669,83,154,237,89,47,35,114,125,477
1999,Anthony Avent,PF,29,UTA,5,0,44,4,13,0.308,0,0,NA,4,13,0.308,0.308,1,2,0.5,8,4,12,1,2,0,7,6,9
1999,Thurl Bailey,PF,37,UTA,43,0,543,78,175,0.446,0,2,0,78,173,0.451,0.446,25,34,0.735,36,58,94,26,9,28,27,78,181
1999,Vin Baker,PF,27,SEA,34,31,1162,198,437,0.453,0,3,0,198,434,0.456,0.453,72,160,0.45,86,125,211,56,32,34,76,121,468
1999,Brent Barry,SG,27,CHI,37,30,1181,141,356,0.396,52,172,0.302,89,184,0.484,0.469,78,101,0.772,39,105,144,116,42,11,72,98,412
1999,Drew Barry,SG,25,SEA,17,0,183,10,32,0.313,8,24,0.333,2,8,0.25,0.438,9,13,0.692,3,17,20,29,7,1,12,24,37
1999,Jon Barry,SG,29,SAC,43,0,736,59,138,0.428,24,79,0.304,35,59,0.593,0.514,71,84,0.845,25,71,96,112,53,5,47,61,213
1999,Tony Battie,C,22,BOS,50,15,1121,147,283,0.519,0,3,0,147,280,0.525,0.519,41,61,0.672,96,204,300,53,29,71,45,159,335
1999,Corey Beck,PG,27,DET,8,0,30,4,8,0.5,0,0,NA,4,8,0.5,0.5,2,2,1,3,2,5,0,2,0,2,5,10
1999,Corey Beck,PG,27,CHH,16,0,150,14,31,0.452,1,1,1,13,30,0.433,0.468,6,13,0.462,3,20,23,20,7,2,11,21,35
1999,Benoit Benjamin,C,34,PHI,6,0,33,2,7,0.286,0,0,NA,2,7,0.286,0.286,0,0,NA,3,5,8,1,0,0,3,6,4
1999,Travis Best,PG,26,IND,49,0,1043,127,305,0.416,22,59,0.373,105,246,0.427,0.452,70,83,0.843,19,61,80,169,42,4,62,111,346
1999,Mike Bibby,PG,20,VAN,50,50,1758,260,605,0.43,15,74,0.203,245,531,0.461,0.442,127,169,0.751,30,106,136,325,78,5,146,122,662
1999,Chauncey Billups,SG,22,DEN,45,41,1488,191,495,0.386,85,235,0.362,106,260,0.408,0.472,157,172,0.913,24,72,96,173,58,14,98,115,624
1999,Corie Blount,PF,30,LAL,14,3,162,13,33,0.394,0,1,0,13,32,0.406,0.394,6,12,0.5,24,22,46,2,1,4,6,27,32
1999,Corie Blount,PF,30,CLE,20,0,368,23,67,0.343,0,0,NA,23,67,0.343,0.343,22,42,0.524,34,71,105,10,18,12,15,47,68
1999,Muggsy Bogues,PG,34,GSW,36,5,714,76,154,0.494,0,6,0,76,148,0.514,0.494,31,36,0.861,16,57,73,134,43,1,47,44,183
1999,Etdrick Bohannon,SF,25,WAS,2,0,4,0,0,NA,0,0,NA,0,0,NA,NA,0,0,NA,0,0,0,0,0,0,0,0,0
1999,Bruce Bowen,SF,27,BOS,30,1,494,26,93,0.28,7,26,0.269,19,67,0.284,0.317,11,24,0.458,15,37,52,28,21,9,13,51,70
1999,Earl Boykins,PG,22,NJN,5,0,51,10,21,0.476,1,5,0.2,9,16,0.563,0.5,0,0,NA,1,3,4,6,1,0,7,3,21
1999,Earl Boykins,PG,22,CLE,17,0,170,20,58,0.345,2,13,0.154,18,45,0.4,0.362,2,3,0.667,6,7,13,27,5,0,13,17,44
1999,Shawn Bradley,C,26,DAL,49,33,1294,167,348,0.48,0,4,0,167,344,0.485,0.48,86,115,0.748,130,262,392,40,35,159,56,153,420
1999,Terrell Brandon,PG,28,MIL,15,14,505,85,208,0.409,7,28,0.25,78,180,0.433,0.425,26,31,0.839,11,42,53,104,24,3,36,25,203
1999,Terrell Brandon,PG,28,MIN,21,20,712,127,299,0.425,5,19,0.263,122,280,0.436,0.433,39,47,0.83,16,65,81,205,39,7,38,57,298
1999,Chucky Brown,PF,30,CHH,48,21,1192,176,373,0.472,15,40,0.375,161,333,0.483,0.492,40,59,0.678,36,138,174,57,16,19,38,106,407
1999,Dee Brown,PG,30,TOR,49,0,1377,187,495,0.378,135,349,0.387,52,146,0.356,0.514,40,55,0.727,15,88,103,143,56,8,80,75,549
1999,Rick Brunson,PG,26,NYK,17,0,95,6,21,0.286,0,5,0,6,16,0.375,0.286,5,18,0.278,3,7,10,19,9,0,12,8,17
1999,Mark Bryant,PF,33,CHI,45,29,1204,168,348,0.483,0,1,0,168,347,0.484,0.483,71,110,0.645,92,140,232,48,34,16,68,149,407
1999,Jud Buechler,SF,30,DET,50,0,1056,100,240,0.417,61,148,0.412,39,92,0.424,0.544,13,18,0.722,29,104,133,57,37,13,21,83,274
1999,Scott Burrell,SF,28,NJN,32,10,706,75,208,0.361,28,72,0.389,47,136,0.346,0.428,34,42,0.81,32,87,119,45,40,11,23,82,212
1999,Jason Caffey,PF,25,GSW,35,32,876,123,277,0.444,0,1,0,123,276,0.446,0.444,62,98,0.633,79,126,205,18,24,9,75,113,308
1999,Marcus Camby,C,24,NYK,46,0,945,136,261,0.521,0,0,NA,136,261,0.521,0.521,57,103,0.553,102,151,253,12,29,74,39,131,329
1999,Elden Campbell,C,30,LAL,17,1,325,44,101,0.436,0,0,NA,44,101,0.436,0.436,38,62,0.613,38,58,96,8,1,16,22,51,126
1999,Elden Campbell,C,30,CHH,32,32,1134,178,364,0.489,0,1,0,178,363,0.49,0.489,134,207,0.647,88,213,301,61,38,57,58,108,490
1999,Antoine Carr,PF,37,HOU,18,0,152,21,52,0.404,0,1,0,21,51,0.412,0.404,5,7,0.714,9,22,31,9,1,10,9,31,47
1999,Chris Carr,SG,24,MIN,11,2,81,9,26,0.346,3,9,0.333,6,17,0.353,0.404,2,4,0.5,0,12,12,7,1,1,4,9,23
1999,Chris Carr,SG,24,NJN,28,2,364,67,179,0.374,25,66,0.379,42,113,0.372,0.444,25,36,0.694,23,36,59,16,7,1,24,36,184
1999,Vince Carter,SF,22,TOR,50,49,1760,345,766,0.45,19,66,0.288,326,700,0.466,0.463,204,268,0.761,94,189,283,149,55,77,110,140,913
1999,Sam Cassell,PG,29,NJN,4,3,100,21,49,0.429,1,7,0.143,20,42,0.476,0.439,29,31,0.935,1,5,6,19,3,0,12,13,72
1999,Sam Cassell,PG,29,MIL,4,0,99,18,44,0.409,1,3,0.333,17,41,0.415,0.42,18,19,0.947,4,5,9,17,6,0,8,9,55
1999,Kelvin Cato,C,24,POR,43,0,545,58,129,0.45,1,1,1,57,128,0.445,0.453,34,67,0.507,49,101,150,19,23,56,27,100,151
1999,Cedric Ceballos,SF,29,DAL,13,5,352,59,140,0.421,11,28,0.393,48,112,0.429,0.461,34,49,0.694,23,62,85,12,7,5,28,23,163
1999,Rex Chapman,SG,31,PHO,38,35,1183,165,459,0.359,53,151,0.351,112,308,0.364,0.417,76,91,0.835,12,92,104,109,34,9,54,46,459
1999,Pete Chilcutt,PF,30,VAN,46,0,697,63,172,0.366,26,68,0.382,37,104,0.356,0.442,14,17,0.824,29,88,117,30,22,12,28,52,166
1999,Chris Childs,PG,31,NYK,48,0,1297,114,267,0.427,36,94,0.383,78,173,0.451,0.494,64,78,0.821,18,115,133,193,44,1,85,156,328
1999,Doug Christie,SG,28,TOR,50,50,1768,252,650,0.388,49,161,0.304,203,489,0.415,0.425,207,246,0.841,59,148,207,187,113,26,119,111,760
1999,Keon Clark,C,23,DEN,28,0,409,36,80,0.45,0,1,0,36,79,0.456,0.45,21,37,0.568,36,60,96,10,10,31,21,52,93
1999,Bimbo Coles,PG,30,GSW,48,32,1272,183,414,0.442,6,25,0.24,177,389,0.455,0.449,83,101,0.822,21,96,117,222,45,11,82,113,455
1999,Marty Conlon,C,31,MIA,7,0,35,3,13,0.231,0,0,NA,3,13,0.231,0.231,2,2,1,1,4,5,1,0,1,3,6,8
1999,Tyrone Corbin,SF,36,ATL,47,6,1066,131,335,0.391,38,119,0.319,93,216,0.431,0.448,52,80,0.65,37,108,145,43,31,7,43,74,352
1999,Austin Croshere,PF,23,IND,27,0,249,32,75,0.427,8,29,0.276,24,46,0.522,0.48,20,23,0.87,16,29,45,10,7,8,23,32,92
1999,John Crotty,PG,29,POR,3,0,19,4,8,0.5,1,1,1,3,7,0.429,0.563,3,3,1,0,1,1,5,2,0,0,1,12
1999,John Crotty,PG,29,SEA,24,0,363,47,116,0.405,13,35,0.371,34,81,0.42,0.461,40,47,0.851,8,22,30,58,9,0,33,30,147
1999,Terry Cummings,PF,37,GSW,50,0,1011,186,424,0.439,1,1,1,185,423,0.437,0.44,81,114,0.711,95,160,255,58,46,10,58,168,454
1999,William Cunningham,C,24,TOR,1,0,1,0,0,NA,0,0,NA,0,0,NA,NA,0,0,NA,0,0,0,0,0,0,0,0,0
1999,William Cunningham,C,24,NJN,15,6,161,3,18,0.167,0,0,NA,3,18,0.167,0.167,0,2,0,13,15,28,1,1,11,5,30,6
1999,Bill Curley,PF,26,MIN,35,7,372,29,72,0.403,1,5,0.2,28,67,0.418,0.41,19,22,0.864,20,31,51,14,17,9,10,83,78
1999,Michael Curry,SF,30,MIL,50,4,1146,90,206,0.437,1,15,0.067,89,191,0.466,0.439,63,79,0.797,19,89,108,78,42,7,37,135,244
1999,Antonio Daniels,PG,23,SAS,47,0,614,83,183,0.454,5,17,0.294,78,166,0.47,0.467,49,65,0.754,13,41,54,106,30,6,44,39,220
1999,Kornél Dávid,SF,27,CHI,50,6,902,109,243,0.449,0,1,0,109,242,0.45,0.449,90,111,0.811,70,103,173,40,23,17,48,88,308
1999,Antonio Davis,PF,30,IND,49,1,1271,164,348,0.471,0,0,NA,164,348,0.471,0.471,135,192,0.703,116,228,344,33,22,42,50,136,463
1999,Dale Davis,PF,29,IND,50,50,1374,161,302,0.533,0,0,NA,161,302,0.533,0.533,76,123,0.618,155,261,416,22,20,57,43,115,398
1999,Hubert Davis,SG,28,DAL,50,21,1378,174,397,0.438,65,144,0.451,109,253,0.431,0.52,44,50,0.88,3,83,86,89,21,3,57,76,457
1999,Ricky Davis,SG,19,CHH,46,1,557,81,200,0.405,2,12,0.167,79,188,0.42,0.41,45,59,0.763,40,44,84,58,30,7,54,46,209
1999,Andrew DeClercq,C,25,BOS,14,1,258,28,57,0.491,0,0,NA,28,57,0.491,0.491,19,29,0.655,33,30,63,10,13,9,22,51,75
1999,Andrew DeClercq,C,25,CLE,33,31,844,110,219,0.502,0,0,NA,110,219,0.502,0.502,76,112,0.679,71,121,192,21,37,20,32,110,296
1999,Terry Dehere,PG,27,SAC,4,0,20,4,11,0.364,1,5,0.2,3,6,0.5,0.409,0,0,NA,2,0,2,1,2,0,2,2,9
1999,Terry Dehere,SG,27,VAN,22,0,271,27,74,0.365,15,34,0.441,12,40,0.3,0.466,5,7,0.714,5,17,22,26,5,3,14,28,74
1999,Vinny Del Negro,PG,32,MIL,48,7,1093,114,270,0.422,13,30,0.433,101,240,0.421,0.446,40,50,0.8,14,88,102,174,33,3,55,62,281
1999,Tony Delk,PG,25,GSW,36,13,630,92,253,0.364,16,66,0.242,76,187,0.406,0.395,46,71,0.648,11,43,54,95,16,6,45,47,246
1999,Michael Doleac,C,21,ORL,49,0,780,125,267,0.468,0,0,NA,125,267,0.468,0.468,54,80,0.675,66,82,148,20,19,17,26,117,304
1999,Sherman Douglas,PG,32,LAC,30,19,842,96,219,0.438,0,11,0,96,208,0.462,0.438,55,87,0.632,16,42,58,124,27,3,61,54,247
1999,Chris Dudley,C,33,NYK,46,16,685,48,109,0.44,0,0,NA,48,109,0.44,0.44,19,40,0.475,79,114,193,7,13,38,24,116,115
1999,Blue Edwards,SF,33,MIA,24,0,283,32,72,0.444,4,10,0.4,28,62,0.452,0.472,9,13,0.692,7,26,33,30,17,5,21,23,77
1999,Howard Eisley,PG,26,UTA,50,0,1038,140,314,0.446,21,50,0.42,119,264,0.451,0.479,67,80,0.838,12,82,94,185,30,2,109,122,368
1999,Mario Elie,SG,35,SAS,47,37,1291,156,331,0.471,40,107,0.374,116,224,0.518,0.532,103,119,0.866,36,101,137,89,46,12,61,91,455
1999,Dale Ellis,SF,38,SEA,48,5,1232,174,395,0.441,94,217,0.433,80,178,0.449,0.559,53,70,0.757,25,90,115,38,25,3,45,77,495
1999,Brian Evans,SF,25,NJN,11,0,121,11,34,0.324,4,11,0.364,7,23,0.304,0.382,4,4,1,4,13,17,14,3,3,2,7,30
1999,Brian Evans,SF,25,MIN,5,0,24,2,10,0.2,0,2,0,2,8,0.25,0.2,0,0,NA,2,0,2,1,2,0,0,1,4
1999,Jamie Feick,C,24,MIL,2,0,3,0,1,0,0,0,NA,0,1,0,0,0,0,NA,0,2,2,0,0,0,0,0,0
1999,Jamie Feick,PF,24,NJN,26,16,849,67,133,0.504,0,0,NA,67,133,0.504,0.504,43,60,0.717,112,174,286,24,25,18,34,73,177
1999,Michael Finley,SF,25,DAL,50,50,2051,389,876,0.444,45,136,0.331,344,740,0.465,0.47,186,226,0.823,69,194,263,218,66,15,107,96,1009
1999,Derek Fisher,PG,24,LAL,50,21,1131,99,263,0.376,38,97,0.392,61,166,0.367,0.449,60,79,0.759,21,70,91,197,61,1,77,95,296
1999,Greg Foster,PF,30,UTA,42,1,458,52,138,0.377,1,4,0.25,51,134,0.381,0.38,13,21,0.619,28,55,83,25,6,8,24,63,118
1999,Adonal Foyle,C,23,GSW,44,0,614,52,121,0.43,0,0,NA,52,121,0.43,0.43,25,51,0.49,79,115,194,18,15,43,31,90,129
1999,Kevin Garnett,PF,22,MIN,47,47,1780,414,900,0.46,4,14,0.286,410,886,0.463,0.462,145,206,0.704,166,323,489,202,78,83,135,152,977
1999,Dean Garrett,C,32,MIN,49,37,1054,116,231,0.502,0,0,NA,116,231,0.502,0.502,38,51,0.745,99,158,257,28,30,45,29,113,270
1999,Chris Gatling,C,31,NJN,18,2,281,36,97,0.371,0,1,0,36,96,0.375,0.371,12,24,0.5,21,44,65,12,8,4,29,40,84
1999,Chris Gatling,C,31,MIL,30,1,494,81,168,0.482,1,7,0.143,80,161,0.497,0.485,25,69,0.362,31,83,114,20,24,6,33,78,188
1999,Kendall Gill,SF,30,NJN,50,47,1606,236,593,0.398,2,17,0.118,234,576,0.406,0.4,114,167,0.683,61,183,244,123,134,26,71,162,588
1999,Armen Gilliam,PF,34,MIL,34,5,668,101,223,0.453,0,1,0,101,222,0.455,0.453,79,101,0.782,33,93,126,19,22,12,36,48,281
1999,Paul Grant,C,25,MIN,4,0,8,1,4,0.25,0,0,NA,1,4,0.25,0.25,0,0,NA,1,0,1,0,0,0,1,4,2
1999,Paul Grant,C,25,MIL,2,0,5,1,2,0.5,0,0,NA,1,2,0.5,0.5,0,0,NA,0,0,0,0,1,0,1,0,2
1999,A.C. Green,PF,35,DAL,50,35,924,108,256,0.422,0,8,0,108,248,0.435,0.422,30,52,0.577,82,146,228,25,28,8,19,69,246
1999,Tom Gugliotta,PF,29,PHO,43,43,1563,277,573,0.483,2,7,0.286,275,566,0.486,0.485,173,218,0.794,131,250,381,121,59,21,88,110,729
1999,Tom Hammonds,PF,31,MIN,49,0,716,82,179,0.458,0,0,NA,82,179,0.458,0.458,48,75,0.64,54,82,136,20,8,7,32,88,212
1999,Anfernee Hardaway,SG,27,ORL,50,50,1944,301,717,0.42,40,140,0.286,261,577,0.452,0.448,149,211,0.706,74,210,284,266,111,23,150,111,791
1999,Tim Hardaway,PG,32,MIA,48,48,1772,301,752,0.4,112,311,0.36,189,441,0.429,0.475,121,149,0.812,15,137,152,352,57,6,131,102,835
1999,Derek Harper,PG,37,LAL,45,29,1120,120,291,0.412,43,117,0.368,77,174,0.443,0.486,26,32,0.813,13,54,67,187,44,4,52,66,309
1999,Ron Harper,SG,35,CHI,35,35,1107,147,390,0.377,27,85,0.318,120,305,0.393,0.412,71,101,0.703,49,131,180,115,60,35,65,80,392
1999,Al Harrington,PF,18,IND,21,0,160,18,56,0.321,0,5,0,18,51,0.353,0.321,9,15,0.6,20,19,39,5,4,2,11,26,45
1999,Othella Harrington,PF,25,HOU,41,10,903,156,304,0.513,0,0,NA,156,304,0.513,0.513,88,122,0.721,72,174,246,15,6,25,61,103,400
1999,Mark Hendrickson,PF,24,NJN,22,6,399,39,88,0.443,0,1,0,39,87,0.448,0.443,42,50,0.84,27,41,68,13,12,1,15,39,120
1999,Carl Herrera,PF,32,VAN,4,0,42,3,13,0.231,0,0,NA,3,13,0.231,0.231,0,2,0,5,3,8,3,0,0,4,3,6
1999,Carl Herrera,PF,32,DEN,24,0,265,27,63,0.429,0,1,0,27,62,0.435,0.429,5,9,0.556,20,34,54,1,12,7,12,38,59
1999,Tyrone Hill,PF,30,MIL,17,17,517,50,118,0.424,0,0,NA,50,118,0.424,0.424,46,81,0.568,51,83,134,17,18,8,24,68,146
1999,Tyrone Hill,PF,30,PHI,21,6,587,72,150,0.48,0,0,NA,72,150,0.48,0.48,35,69,0.507,64,89,153,18,16,8,35,77,179
1999,Jerald Honeycutt,PF,24,MIL,3,0,12,2,5,0.4,0,3,0,2,2,1,0.4,1,2,0.5,0,1,1,0,1,0,1,6,5
1999,Jerald Honeycutt,PF,24,PHI,13,0,90,7,27,0.259,5,14,0.357,2,13,0.154,0.352,6,8,0.75,3,8,11,3,4,2,8,10,25
1999,Jeff Hornacek,SG,35,UTA,48,48,1435,214,449,0.477,34,81,0.42,180,368,0.489,0.514,125,140,0.893,33,127,160,192,52,14,82,95,587
1999,Robert Horry,PF,28,LAL,38,5,744,67,146,0.459,20,45,0.444,47,101,0.465,0.527,34,46,0.739,56,96,152,56,36,39,49,103,188
1999,Juwan Howard,SF,25,WAS,36,36,1430,286,604,0.474,0,3,0,286,601,0.476,0.474,110,146,0.753,90,203,293,107,42,14,95,130,682
1999,Larry Hughes,PG,20,PHI,50,1,988,170,414,0.411,8,52,0.154,162,362,0.448,0.42,107,151,0.709,83,106,189,77,44,14,68,97,455
1999,Allen Iverson,SG,23,PHI,48,48,1990,435,1056,0.412,58,199,0.291,377,857,0.44,0.439,356,474,0.751,66,170,236,223,110,7,167,98,1284
1999,Bobby Jackson,PG,25,MIN,50,12,941,141,348,0.405,10,27,0.37,131,321,0.408,0.42,61,79,0.772,43,92,135,167,39,3,75,75,353
1999,Jim Jackson,SG,28,POR,49,9,1175,152,370,0.411,25,90,0.278,127,280,0.454,0.445,85,101,0.842,36,123,159,128,43,6,82,80,414
1999,Mark Jackson,PG,33,IND,49,49,1382,138,329,0.419,32,103,0.311,106,226,0.469,0.468,65,79,0.823,33,151,184,386,42,3,99,58,373
1999,Sam Jacobson,PG,23,LAL,2,0,12,3,5,0.6,0,1,0,3,4,0.75,0.6,2,2,1,0,3,3,0,0,0,1,2,8
1999,Antawn Jamison,SF,22,GSW,47,24,1058,178,394,0.452,3,10,0.3,175,384,0.456,0.456,90,153,0.588,131,170,301,34,38,16,68,102,449
1999,Anthony Johnson,PG,24,ATL,49,2,885,91,225,0.404,5,19,0.263,86,206,0.417,0.416,57,82,0.695,16,59,75,107,35,7,65,67,244
1999,Avery Johnson,PG,33,SAS,50,50,1672,218,461,0.473,1,12,0.083,217,449,0.483,0.474,50,88,0.568,22,96,118,369,51,11,112,101,487
1999,Eddie Johnson,SF,39,HOU,3,0,18,6,13,0.462,0,1,0,6,12,0.5,0.462,0,0,NA,0,2,2,1,0,0,2,3,12
1999,Damon Jones,PG,22,NJN,11,0,131,14,44,0.318,10,29,0.345,4,15,0.267,0.432,11,13,0.846,2,11,13,13,7,0,5,7,49
1999,Damon Jones,PG,22,BOS,13,0,213,29,75,0.387,15,33,0.455,14,42,0.333,0.487,3,4,0.75,4,27,31,29,6,0,12,16,76
1999,Eddie Jones,SG,27,LAL,20,20,724,96,227,0.423,20,64,0.313,76,163,0.466,0.467,59,80,0.738,20,56,76,61,35,24,21,42,271
1999,Eddie Jones,SF,27,CHH,30,30,1157,164,368,0.446,28,78,0.359,136,290,0.469,0.484,153,191,0.801,30,88,118,125,90,34,72,86,509
1999,Reggie Jordan,SG,31,MIN,27,1,296,15,54,0.278,0,0,NA,15,54,0.278,0.278,21,38,0.553,27,32,59,41,12,5,14,38,51
1999,Steve Kerr,PG,33,SAS,44,0,734,68,174,0.391,25,80,0.313,43,94,0.457,0.463,31,35,0.886,6,38,44,49,23,3,22,28,192
1999,Jason Kidd,PG,25,PHO,50,50,2060,310,698,0.444,45,123,0.366,265,575,0.461,0.476,181,239,0.757,87,252,339,539,114,19,150,108,846
1999,Joe Kleine,C,37,PHO,31,5,374,30,74,0.405,0,2,0,30,72,0.417,0.405,8,12,0.667,27,40,67,12,8,1,10,46,68
1999,Brevin Knight,PG,23,CLE,39,38,1186,134,315,0.425,0,5,0,134,310,0.432,0.425,105,141,0.745,16,115,131,302,70,7,105,115,373
1999,Negele Knight,PG,31,TOR,6,0,56,3,8,0.375,0,1,0,3,7,0.429,0.375,2,4,0.5,1,5,6,8,1,0,7,5,8
1999,Toni Kukoč,SF,30,CHI,44,44,1654,315,750,0.42,39,137,0.285,276,613,0.45,0.446,159,215,0.74,65,245,310,235,49,11,121,82,828
1999,Christian Laettner,PF,29,DET,16,0,337,38,106,0.358,1,3,0.333,37,103,0.359,0.363,44,57,0.772,21,33,54,24,15,12,19,30,121
1999,Raef LaFrentz,C,22,DEN,12,12,387,59,129,0.457,12,31,0.387,47,98,0.48,0.504,36,48,0.75,33,58,91,8,9,17,9,38,166
1999,Andrew Lang,C,32,CHI,21,13,386,32,99,0.323,0,0,NA,32,99,0.323,0.323,16,23,0.696,33,60,93,13,5,12,17,43,80
1999,Antonio Lang,PF,26,CLE,10,0,65,4,6,0.667,0,0,NA,4,6,0.667,0.667,5,9,0.556,6,10,16,1,2,1,4,13,13
1999,Tim Legler,SG,32,WAS,30,0,377,51,115,0.443,14,35,0.4,37,80,0.463,0.504,3,6,0.5,8,32,40,21,4,3,14,42,119
1999,Voshon Lenard,SG,25,MIA,12,2,190,31,79,0.392,12,35,0.343,19,44,0.432,0.468,8,11,0.727,4,12,16,10,3,1,7,18,82
1999,Rashard Lewis,SF,19,SEA,20,7,145,19,52,0.365,1,6,0.167,18,46,0.391,0.375,8,14,0.571,13,12,25,4,8,1,20,19,47
1999,Grant Long,PF,32,ATL,50,13,1380,151,359,0.421,3,18,0.167,148,341,0.434,0.425,184,235,0.783,100,196,296,53,57,16,74,143,489
1999,Luc Longley,C,30,PHO,39,39,933,140,290,0.483,0,0,NA,140,290,0.483,0.483,59,76,0.776,59,162,221,45,23,21,53,119,339
1999,Felipe López,SG,24,VAN,47,32,1218,169,379,0.446,12,44,0.273,157,335,0.469,0.462,87,135,0.644,69,97,166,62,49,14,82,128,437
1999,Tyronn Lue,PG,21,LAL,15,0,188,28,65,0.431,7,16,0.438,21,49,0.429,0.485,12,21,0.571,2,4,6,25,5,0,11,28,75
1999,Sam Mack,SF,28,VAN,19,15,577,86,212,0.406,42,108,0.389,44,104,0.423,0.505,28,30,0.933,7,46,53,23,20,1,20,53,242
1999,Sam Mack,SF,28,HOU,25,0,506,81,172,0.471,45,111,0.405,36,61,0.59,0.602,23,28,0.821,7,35,42,32,15,3,13,41,230
1999,Mark Macon,SG,29,DET,7,3,69,4,20,0.2,1,3,0.333,3,17,0.176,0.225,0,0,NA,3,2,5,4,5,1,6,6,9
1999,Danny Manning,PF,32,PHO,50,5,1184,187,386,0.484,1,9,0.111,186,377,0.493,0.486,78,112,0.696,62,157,219,113,36,38,69,129,453
1999,Stephon Marbury,PG,21,MIN,18,18,661,124,304,0.408,8,39,0.205,116,265,0.438,0.421,63,87,0.724,17,45,62,167,29,5,55,44,319
1999,Stephon Marbury,PG,21,NJN,31,31,1234,254,579,0.439,58,158,0.367,196,421,0.466,0.489,159,191,0.832,20,60,80,270,30,3,109,81,725
1999,Donyell Marshall,SF,25,GSW,48,20,1250,208,494,0.421,26,72,0.361,182,422,0.431,0.447,88,121,0.727,115,227,342,66,47,37,80,123,530
1999,Darrick Martin,PG,27,LAC,37,25,941,102,278,0.367,31,106,0.292,71,172,0.413,0.423,61,76,0.803,5,43,48,144,43,4,67,82,296
1999,Jamal Mashburn,SF,26,MIA,24,23,855,134,297,0.451,13,30,0.433,121,267,0.453,0.473,75,104,0.721,24,122,146,75,20,3,60,58,356
1999,Tony Massenburg,PF,31,VAN,43,35,1143,189,388,0.487,0,2,0,189,386,0.49,0.487,103,155,0.665,83,174,257,23,26,39,64,108,481
1999,Vernon Maxwell,SG,33,SAC,46,1,1007,164,421,0.39,80,231,0.346,84,190,0.442,0.485,84,114,0.737,13,72,85,76,30,3,67,111,492
1999,Walter McCarty,PF,24,BOS,32,4,659,64,177,0.362,13,50,0.26,51,127,0.402,0.398,40,57,0.702,36,79,115,40,24,13,40,88,181
1999,George McCloud,SF,31,PHO,48,16,1245,142,324,0.438,69,166,0.416,73,158,0.462,0.545,75,87,0.862,34,128,162,79,45,14,49,128,428
1999,Antonio McDyess,C,24,DEN,50,50,1937,415,882,0.471,1,9,0.111,414,873,0.474,0.471,230,338,0.68,168,369,537,82,73,115,138,175,1061
1999,Tracy McGrady,SF,19,TOR,49,2,1106,168,385,0.436,8,35,0.229,160,350,0.457,0.447,114,157,0.726,120,158,278,113,52,66,80,94,458
1999,Jeff McInnis,PG,24,WAS,35,6,427,50,134,0.373,9,35,0.257,41,99,0.414,0.407,21,28,0.75,9,12,21,73,19,1,30,36,130
1999,Aaron McKie,SG,26,PHI,50,4,959,95,237,0.401,6,31,0.194,89,206,0.432,0.414,44,62,0.71,27,113,140,100,63,3,57,90,240
1999,Roshown McLeod,SF,23,ATL,34,0,348,62,163,0.38,1,10,0.1,61,153,0.399,0.383,37,45,0.822,12,38,50,14,2,1,23,24,162
1999,Ron Mercer,SG,22,BOS,41,40,1551,305,707,0.431,5,30,0.167,300,677,0.443,0.435,83,105,0.79,37,118,155,104,67,12,89,81,698
1999,Loren Meyer,C,26,DEN,14,0,70,7,28,0.25,1,5,0.2,6,23,0.261,0.268,1,2,0.5,4,12,16,1,0,3,4,22,16
1999,Anthony Miller,PF,27,HOU,29,0,249,28,60,0.467,0,1,0,28,59,0.475,0.467,14,22,0.636,26,41,67,7,7,5,9,34,70
1999,Brad Miller,C,22,CHH,38,0,469,78,138,0.565,1,2,0.5,77,136,0.566,0.569,81,102,0.794,35,82,117,22,9,18,32,65,238
1999,Oliver Miller,C,28,SAC,4,0,35,5,11,0.455,0,0,NA,5,11,0.455,0.455,0,0,NA,7,1,8,0,0,2,4,3,10
1999,Terry Mills,PF,31,MIA,1,0,29,3,8,0.375,2,4,0.5,1,4,0.25,0.5,1,2,0.5,3,1,4,0,1,0,3,3,9
1999,Cuttino Mobley,PG,23,HOU,49,37,1456,172,405,0.425,53,148,0.358,119,257,0.463,0.49,90,110,0.818,22,89,111,121,44,23,79,98,487
1999,Nazr Mohammed,C,21,PHI,26,0,121,15,42,0.357,0,0,NA,15,42,0.357,0.357,12,21,0.571,18,19,37,2,5,4,12,22,42
1999,Eric Montross,C,27,DET,46,2,577,42,80,0.525,0,1,0,42,79,0.532,0.525,11,32,0.344,45,94,139,14,12,27,16,107,95
1999,Mikki Moore,C,23,DET,2,0,6,1,1,1,0,0,NA,1,1,1,1,2,2,1,0,1,1,0,0,0,0,0,4
1999,Alonzo Mourning,C,28,MIA,46,46,1753,324,634,0.511,0,2,0,324,632,0.513,0.511,276,423,0.652,166,341,507,74,34,180,139,161,924
1999,Eric Murdock,PG,30,NJN,15,8,401,45,114,0.395,8,22,0.364,37,92,0.402,0.43,21,26,0.808,3,32,35,66,22,2,29,35,119
1999,Tracy Murray,SF,27,WAS,36,0,653,83,237,0.35,33,103,0.32,50,134,0.373,0.42,34,42,0.81,18,63,81,27,21,6,29,65,233
1999,Dikembe Mutombo,C,32,ATL,50,50,1829,173,338,0.512,0,0,NA,173,338,0.512,0.512,195,285,0.684,192,418,610,57,16,147,94,145,541
1999,Tyrone Nesby,SF,23,LAC,50,36,1288,182,405,0.449,35,96,0.365,147,309,0.476,0.493,104,133,0.782,57,118,175,82,77,20,53,143,503
1999,Johnny Newman,SF,35,CLE,50,2,949,106,251,0.422,23,61,0.377,83,190,0.437,0.468,68,84,0.81,15,60,75,41,28,12,41,126,303
1999,Moochie Norris,PG,25,SEA,12,0,140,13,40,0.325,6,15,0.4,7,25,0.28,0.4,6,16,0.375,4,16,20,24,7,0,16,17,38
1999,Jermaine O'Neal,PF,20,POR,36,1,311,36,83,0.434,0,1,0,36,82,0.439,0.434,18,35,0.514,42,55,97,13,4,14,14,41,90
1999,Shaquille O'Neal,C,26,LAL,49,49,1705,510,885,0.576,0,1,0,510,884,0.577,0.576,269,498,0.54,187,338,525,114,36,82,122,155,1289
1999,Kevin Ollie,PG,26,SAC,7,0,68,4,13,0.308,0,0,NA,4,13,0.308,0.308,4,5,0.8,0,6,6,3,3,1,3,8,12
1999,Kevin Ollie,PG,26,ORL,1,0,4,0,1,0,0,0,NA,0,1,0,0,1,2,0.5,0,1,1,0,0,0,0,1,1
1999,Michael Olowokandi,C,23,LAC,45,36,1279,172,399,0.431,0,0,NA,172,399,0.431,0.431,57,118,0.483,120,237,357,25,27,55,85,137,401
1999,Bo Outlaw,PF,27,ORL,31,22,851,84,154,0.545,0,3,0,84,151,0.556,0.545,35,81,0.432,54,113,167,56,40,43,58,79,203
1999,Doug Overton,PG,29,ORL,6,0,33,6,12,0.5,0,2,0,6,10,0.6,0.5,6,6,1,1,1,2,3,1,0,3,2,18
1999,Doug Overton,PG,29,NJN,8,1,174,25,57,0.439,2,4,0.5,23,53,0.434,0.456,12,14,0.857,6,11,17,16,3,1,15,14,64
1999,Doug Overton,PG,29,PHI,10,0,37,5,15,0.333,0,1,0,5,14,0.357,0.333,0,0,NA,0,2,2,4,1,0,2,2,10
1999,Billy Owens,SF,29,SEA,21,19,451,65,165,0.394,5,11,0.455,60,154,0.39,0.409,28,35,0.8,35,45,80,38,12,4,33,37,163
1999,Robert Pack,PG,29,DAL,25,0,468,75,174,0.431,0,4,0,75,170,0.441,0.431,72,88,0.818,9,27,36,81,20,1,49,41,222
1999,Cherokee Parks,C,26,VAN,48,41,1118,118,275,0.429,0,1,0,118,274,0.431,0.429,30,55,0.545,75,168,243,36,28,28,49,114,266
1999,Ruben Patterson,SF,23,LAL,24,2,144,21,51,0.412,1,6,0.167,20,45,0.444,0.422,22,31,0.71,17,13,30,2,5,3,12,16,65
1999,Gary Payton,PG,30,SEA,50,50,2008,401,923,0.434,83,281,0.295,318,642,0.495,0.479,199,276,0.721,62,182,244,436,109,12,154,115,1084
1999,Anthony Peeler,SG,29,MIN,28,28,810,103,272,0.379,34,114,0.298,69,158,0.437,0.441,30,41,0.732,30,54,84,78,35,6,38,60,270
1999,Sam Perkins,PF,37,IND,48,0,789,80,200,0.4,35,90,0.389,45,110,0.409,0.488,43,60,0.717,36,102,138,25,15,14,22,74,238
1999,Elliot Perry,PG,29,MIL,5,0,47,9,17,0.529,1,1,1,8,16,0.5,0.559,1,2,0.5,1,7,8,12,4,0,2,3,20
1999,Elliot Perry,PG,29,NJN,30,0,243,30,86,0.349,9,23,0.391,21,63,0.333,0.401,9,12,0.75,6,20,26,35,16,0,32,22,78
1999,Wesley Person,SG,27,CLE,45,42,1342,198,437,0.453,75,200,0.375,123,237,0.519,0.539,32,53,0.604,19,123,142,80,37,16,41,52,503
1999,Olden Polynice,C,34,SEA,48,47,1481,169,358,0.472,1,1,1,168,357,0.471,0.473,29,94,0.309,184,241,425,43,20,30,49,150,368
1999,Vitaly Potapenko,C,23,CLE,17,12,467,55,126,0.437,0,1,0,55,125,0.44,0.437,33,49,0.673,23,71,94,16,11,16,28,53,143
1999,Vitaly Potapenko,C,23,BOS,33,32,927,149,286,0.521,0,0,NA,149,286,0.521,0.521,58,106,0.547,91,147,238,59,24,20,72,116,356
1999,Theo Ratliff,PF,25,PHI,50,50,1627,197,419,0.47,0,0,NA,197,419,0.47,0.47,166,229,0.725,139,268,407,30,45,149,92,180,560
1999,Eldridge Recasner,PG,31,CHH,44,2,708,82,184,0.446,24,60,0.4,58,124,0.468,0.511,34,39,0.872,20,57,77,91,17,1,58,66,222
1999,Khalid Reeves,PG,26,DET,11,0,112,8,21,0.381,1,3,0.333,7,18,0.389,0.405,8,14,0.571,3,4,7,11,4,0,7,13,25
1999,Don Reid,PF,25,DET,47,30,935,97,174,0.557,0,0,NA,97,174,0.557,0.557,48,79,0.608,66,104,170,33,27,43,36,156,242
1999,J.R. Reid,PF,30,CHH,16,16,556,88,169,0.521,0,0,NA,88,169,0.521,0.521,67,84,0.798,21,92,113,25,22,10,28,63,243
1999,J.R. Reid,PF,30,LAL,25,10,473,44,108,0.407,0,1,0,44,107,0.411,0.407,38,53,0.717,24,75,99,23,15,0,23,72,126
1999,Shawn Respert,SG,26,PHO,12,1,99,13,36,0.361,4,13,0.308,9,23,0.391,0.417,7,10,0.7,2,11,13,8,5,0,5,10,37
1999,Rodrick Rhodes,SF,25,HOU,3,0,33,2,8,0.25,0,0,NA,2,8,0.25,0.25,5,6,0.833,2,2,4,1,1,0,5,5,9
1999,Rodrick Rhodes,SG,25,VAN,10,1,123,11,44,0.25,1,7,0.143,10,37,0.27,0.261,11,19,0.579,7,6,13,10,4,2,15,16,34
1999,Clifford Robinson,SF,32,PHO,50,35,1740,299,629,0.475,58,139,0.417,241,490,0.492,0.521,163,234,0.697,69,158,227,128,75,59,88,153,819
1999,James Robinson,PG,28,LAC,14,0,280,39,98,0.398,8,30,0.267,31,68,0.456,0.439,20,27,0.741,10,17,27,18,14,3,16,29,106
1999,James Robinson,PG,28,MIN,17,0,226,28,87,0.322,13,44,0.295,15,43,0.349,0.397,8,14,0.571,8,27,35,38,8,5,28,31,77
1999,Carlos Rogers,PF,27,POR,2,0,8,2,2,1,0,0,NA,2,2,1,1,1,4,0.25,0,1,1,1,0,0,0,2,5
1999,Rodney Rogers,SF,27,LAC,47,7,968,131,297,0.441,18,63,0.286,113,234,0.483,0.471,68,101,0.673,65,114,179,77,47,22,66,140,348
1999,Sean Rooks,C,29,LAL,36,0,315,32,79,0.405,0,2,0,32,77,0.416,0.405,34,48,0.708,33,39,72,9,2,9,21,61,98
1999,Jalen Rose,SF,26,IND,49,1,1238,200,496,0.403,17,65,0.262,183,431,0.425,0.42,125,158,0.791,34,120,154,93,50,15,72,128,542
1999,Malik Rose,PF,24,SAS,47,0,608,93,201,0.463,0,1,0,93,200,0.465,0.463,98,146,0.671,90,92,182,29,40,22,56,120,284
1999,Jason Sasser,SF,25,VAN,6,0,39,5,11,0.455,0,0,NA,5,11,0.455,0.455,1,2,0.5,2,5,7,2,2,0,2,4,11
1999,Danny Schayes,C,39,ORL,19,1,143,11,29,0.379,0,0,NA,11,29,0.379,0.379,6,8,0.75,3,11,14,4,1,2,8,23,28
1999,Dennis Scott,SF,30,NYK,15,0,206,17,56,0.304,8,29,0.276,9,27,0.333,0.375,1,4,0.25,3,17,20,8,3,1,5,17,43
1999,Dennis Scott,SF,30,MIN,21,9,532,70,157,0.446,29,68,0.426,41,89,0.461,0.538,22,27,0.815,5,33,38,32,12,2,14,32,191
1999,Rony Seikaly,C,33,NJN,9,0,88,4,20,0.2,0,0,NA,4,20,0.2,0.2,7,18,0.389,5,16,21,2,4,6,10,15,15
1999,Brian Shaw,PG,32,POR,1,0,5,0,1,0,0,0,NA,0,1,0,0,0,0,NA,0,1,1,1,0,0,1,1,0
1999,Dickey Simpkins,C,26,CHI,50,35,1448,150,324,0.463,0,1,0,150,323,0.464,0.463,156,242,0.645,110,229,339,65,36,13,72,128,456
1999,Brian Skinner,PF,22,LAC,21,0,258,33,71,0.465,0,0,NA,33,71,0.465,0.465,20,33,0.606,20,33,53,1,10,13,19,20,86
1999,Reggie Slater,PF,28,TOR,30,0,263,31,81,0.383,0,0,NA,31,81,0.383,0.383,53,85,0.624,36,34,70,5,3,3,25,50,115
1999,Charles Smith,SG,23,LAC,23,10,317,35,97,0.361,7,33,0.212,28,64,0.438,0.397,7,16,0.438,7,17,24,13,17,14,20,35,84
1999,Joe Smith,C,23,MIN,43,42,1418,223,522,0.427,0,3,0,223,519,0.43,0.427,142,188,0.755,154,200,354,68,32,66,66,147,588
1999,Michael Smith,PF,26,VAN,48,10,1098,77,144,0.535,0,1,0,77,143,0.538,0.535,76,128,0.594,135,215,350,48,46,18,60,107,230
1999,Steve Smith,SG,29,ATL,36,36,1314,217,540,0.402,47,139,0.338,170,401,0.424,0.445,191,225,0.849,50,101,151,118,36,11,99,100,672
1999,Eric Snow,PG,25,PHI,48,48,1716,149,348,0.428,5,21,0.238,144,327,0.44,0.435,110,150,0.733,25,137,162,301,100,1,111,149,413
1999,Felton Spencer,C,31,GSW,26,0,159,15,33,0.455,0,0,NA,15,33,0.455,0.455,12,26,0.462,18,28,46,0,5,10,9,41,42
1999,Jerry Stackhouse,SG,24,DET,42,9,1188,181,488,0.371,35,126,0.278,146,362,0.403,0.407,210,247,0.85,26,81,107,118,34,19,121,79,607
1999,John Starks,SG,33,GSW,50,50,1686,269,728,0.37,78,269,0.29,191,459,0.416,0.423,74,100,0.74,33,130,163,235,69,5,83,135,690
1999,Michael Stewart,C,23,TOR,42,2,394,22,53,0.415,0,0,NA,22,53,0.415,0.415,17,25,0.68,43,56,99,5,4,28,12,76,61
1999,Peja Stojaković,SF,21,SAC,48,1,1025,141,373,0.378,57,178,0.32,84,195,0.431,0.454,63,74,0.851,43,100,143,72,41,7,53,43,402
1999,Damon Stoudamire,PG,25,POR,50,50,1673,249,629,0.396,44,142,0.31,205,487,0.421,0.431,89,122,0.73,41,126,167,312,49,4,110,81,631
1999,Erick Strickland,SG,25,DAL,33,2,567,89,221,0.403,18,59,0.305,71,162,0.438,0.443,53,65,0.815,12,71,83,64,40,2,36,44,249
1999,Mark Strickland,PF,28,MIA,32,1,357,50,101,0.495,0,1,0,50,100,0.5,0.495,19,26,0.731,26,52,78,9,7,8,13,28,119
1999,Rod Strickland,PG,32,WAS,44,43,1632,251,603,0.416,12,42,0.286,239,561,0.426,0.426,176,236,0.746,56,156,212,434,76,5,142,91,690
1999,Bruno Šundov,C,18,DAL,3,0,11,2,7,0.286,0,0,NA,2,7,0.286,0.286,0,0,NA,0,0,0,1,0,0,1,4,4
1999,Bob Sura,PG,25,CLE,50,6,841,70,210,0.333,9,45,0.2,61,165,0.37,0.355,65,103,0.631,21,81,102,152,46,14,67,98,214
1999,Johnny Taylor,SF,24,DEN,36,9,724,82,198,0.414,26,68,0.382,56,130,0.431,0.48,17,23,0.739,30,71,101,24,28,17,34,97,207
1999,Maurice Taylor,PF,22,LAC,46,45,1505,311,675,0.461,1,6,0.167,310,669,0.463,0.461,150,206,0.728,100,142,242,67,16,29,120,179,773
1999,John Thomas,C,23,TOR,39,11,593,71,123,0.577,0,1,0,71,122,0.582,0.577,27,48,0.563,65,69,134,15,17,9,21,82,169
1999,Kurt Thomas,PF,26,NYK,50,44,1182,170,368,0.462,0,1,0,170,367,0.463,0.462,66,108,0.611,82,204,286,55,45,17,73,159,406
1999,Tim Thomas,SF,21,PHI,17,0,188,27,67,0.403,5,19,0.263,22,48,0.458,0.44,19,24,0.792,7,26,33,15,3,3,15,21,78
1999,Tim Thomas,SF,21,MIL,33,26,624,105,212,0.495,16,49,0.327,89,163,0.546,0.533,54,88,0.614,42,51,93,31,23,9,31,86,280
1999,Otis Thorpe,PF,36,WAS,49,38,1539,240,440,0.545,0,2,0,240,438,0.548,0.545,74,106,0.698,96,238,334,101,42,19,88,196,554
1999,Gary Trent,PF,24,DAL,45,23,1362,287,602,0.477,0,5,0,287,597,0.481,0.477,145,235,0.617,127,224,351,77,29,23,66,122,719
1999,Nick Van Exel,PG,27,DEN,50,50,1802,306,769,0.398,72,234,0.308,234,535,0.437,0.445,142,175,0.811,14,99,113,368,40,3,121,90,826
1999,Keith Van Horn,PF,23,NJN,42,42,1576,322,752,0.428,16,53,0.302,306,699,0.438,0.439,256,298,0.859,114,244,358,65,43,53,133,134,916
1999,David Vaughn,PF,25,NJN,10,0,103,13,24,0.542,0,0,NA,13,24,0.542,0.542,8,10,0.8,13,21,34,1,2,8,11,22,34
1999,Loy Vaught,PF,30,DET,37,10,481,59,155,0.381,0,1,0,59,154,0.383,0.381,9,14,0.643,36,110,146,11,15,6,17,54,127
1999,Antoine Walker,PF,22,BOS,42,41,1549,303,735,0.412,65,176,0.369,238,559,0.426,0.456,113,202,0.559,106,253,359,130,63,28,119,142,784
1999,Ben Wallace,C,24,WAS,46,16,1231,115,199,0.578,0,0,NA,115,199,0.578,0.578,47,132,0.356,137,247,384,18,50,90,36,111,277
1999,Rasheed Wallace,PF,24,POR,49,18,1414,242,476,0.508,13,31,0.419,229,445,0.515,0.522,131,179,0.732,57,184,241,60,48,54,80,175,628
1999,Rex Walters,SG,28,MIA,33,13,506,35,95,0.368,12,38,0.316,23,57,0.404,0.432,19,23,0.826,10,40,50,58,10,3,32,63,101
1999,Charlie Ward,PG,28,NYK,50,50,1556,135,334,0.404,53,149,0.356,82,185,0.443,0.484,55,78,0.705,23,149,172,271,103,8,131,105,378
1999,Jamie Watson,SF,26,MIA,3,0,18,1,2,0.5,0,0,NA,1,2,0.5,0.5,0,0,NA,0,1,1,1,0,0,1,1,2
1999,Clarence Weatherspoon,SF,28,MIA,49,3,1040,141,264,0.534,0,0,NA,141,264,0.534,0.534,115,143,0.804,72,171,243,34,28,17,61,107,397
1999,Chris Webber,PF,25,SAC,42,42,1719,378,778,0.486,4,34,0.118,374,744,0.503,0.488,79,174,0.454,149,396,545,173,60,89,148,145,839
1999,Bonzi Wells,SF,22,POR,7,0,35,11,20,0.55,1,3,0.333,10,17,0.588,0.575,8,18,0.444,4,5,9,3,1,1,6,5,31
1999,David Wesley,PG,28,CHH,50,50,1848,243,545,0.446,61,170,0.359,182,375,0.485,0.502,159,191,0.832,23,138,161,322,100,10,142,130,706
1999,Jahidi White,PF,22,WAS,20,0,191,17,32,0.531,0,0,NA,17,32,0.531,0.531,15,35,0.429,23,35,58,1,3,11,16,39,49
1999,Chris Whitney,PG,27,WAS,39,1,441,64,156,0.41,32,95,0.337,32,61,0.525,0.513,27,31,0.871,8,39,47,69,18,2,36,49,187
1999,Dominique Wilkins,SF,39,ORL,27,2,252,50,132,0.379,5,19,0.263,45,113,0.398,0.398,29,42,0.69,30,41,71,16,4,1,23,19,134
1999,Aaron Williams,PF,27,SEA,40,2,458,52,123,0.423,0,1,0,52,122,0.426,0.423,54,74,0.73,54,74,128,22,14,24,30,75,158
1999,Alvin Williams,PG,24,TOR,50,45,1051,95,237,0.401,14,42,0.333,81,195,0.415,0.43,44,52,0.846,19,63,82,130,51,12,56,94,248
1999,Eric Williams,SF,26,DEN,38,8,780,80,219,0.365,6,26,0.231,74,193,0.383,0.379,111,139,0.799,34,47,81,37,27,8,49,76,277
1999,Herb Williams,C,40,NYK,6,0,34,4,8,0.5,0,0,NA,4,8,0.5,0.5,2,2,1,3,3,6,0,0,2,2,2,10
1999,Jason Williams,PG,23,SAC,50,50,1805,231,617,0.374,100,323,0.31,131,294,0.446,0.455,79,105,0.752,14,139,153,299,95,1,143,91,641
1999,Jerome Williams,PF,25,DET,50,10,1154,124,248,0.5,0,0,NA,124,248,0.5,0.5,107,159,0.673,158,191,349,23,63,7,41,108,355
1999,Micheal Williams,PG,32,TOR,2,0,15,1,5,0.2,0,0,NA,1,5,0.2,0.2,0,0,NA,1,0,1,0,0,0,1,1,2
1999,Monty Williams,SF,27,DEN,1,0,6,0,2,0,0,0,NA,0,2,0,0,1,2,0.5,0,0,0,0,0,0,0,0,1
1999,Scott Williams,C,30,PHI,2,0,17,0,2,0,0,0,NA,0,2,0,0,0,0,NA,1,1,2,1,2,1,2,4,0
1999,Scott Williams,C,30,MIL,5,0,29,5,15,0.333,0,0,NA,5,15,0.333,0.333,4,7,0.571,2,10,12,0,1,1,2,5,14
1999,Shammond Williams,PG,23,ATL,2,0,4,0,1,0,0,0,NA,0,1,0,0,3,4,0.75,0,0,0,1,0,0,0,0,3
1999,Walt Williams,SF,28,POR,48,16,1044,147,347,0.424,63,144,0.438,84,203,0.414,0.514,89,107,0.832,36,107,143,80,37,28,63,101,446
1999,Corliss Williamson,SF,25,SAC,50,50,1374,269,555,0.485,1,5,0.2,268,550,0.487,0.486,120,188,0.638,85,121,206,66,30,8,75,118,659
1999,Kevin Willis,C,36,TOR,42,38,1216,187,447,0.418,0,2,0,187,445,0.42,0.418,130,155,0.839,109,241,350,67,28,28,86,134,504
1999,Joe Wolf,PF,34,CHH,3,0,12,0,1,0,0,0,NA,0,1,0,0,0,2,0,0,1,1,0,0,0,0,6,0
1999,Haywoode Workman,PG,33,MIL,29,29,815,73,170,0.429,17,47,0.362,56,123,0.455,0.479,37,47,0.787,14,88,102,172,32,1,63,53,200
1999,Lorenzen Wright,C,23,LAC,48,15,1135,119,260,0.458,0,1,0,119,259,0.459,0.458,81,117,0.692,142,219,361,33,26,36,48,162,319
2000,Tariq Abdul-Wahad,SG,25,ORL,46,46,1205,223,515,0.433,2,21,0.095,221,494,0.447,0.435,115,151,0.762,77,162,239,72,53,16,87,116,563
2000,Tariq Abdul-Wahad,SG,25,DEN,15,10,373,51,131,0.389,1,2,0.5,50,129,0.388,0.393,31,42,0.738,24,28,52,26,6,12,19,31,134
2000,Shareef Abdur-Rahim,SF,23,VAN,82,82,3223,594,1277,0.465,29,96,0.302,565,1181,0.478,0.477,446,551,0.809,218,607,825,271,89,87,249,244,1663
2000,Cory Alexander,PG,26,DEN,29,2,329,28,98,0.286,9,35,0.257,19,63,0.302,0.332,17,22,0.773,8,34,42,58,24,2,28,39,82
2000,Ray Allen,SG,24,MIL,82,82,3070,642,1411,0.455,172,407,0.423,470,1004,0.468,0.516,353,398,0.887,83,276,359,308,110,19,183,187,1809
2000,Rafer Alston,PG,23,MIL,27,0,361,27,95,0.284,3,14,0.214,24,81,0.296,0.3,3,4,0.75,5,18,23,70,12,0,29,29,60
2000,Derek Anderson,SG,25,LAC,64,58,2201,377,860,0.438,55,178,0.309,322,682,0.472,0.47,271,309,0.877,80,178,258,220,90,11,167,149,1080
2000,Kenny Anderson,PG,29,BOS,82,82,2593,434,986,0.44,85,220,0.386,349,766,0.456,0.483,196,253,0.775,55,170,225,420,139,8,130,230,1149
2000,Shandon Anderson,SF,26,HOU,82,82,2700,368,778,0.473,79,225,0.351,289,553,0.523,0.524,194,253,0.767,91,293,384,239,96,32,194,182,1009
2000,Greg Anthony,PG,32,POR,82,3,1548,169,416,0.406,88,233,0.378,81,183,0.443,0.512,88,114,0.772,17,116,133,208,59,9,85,143,514
2000,B.J. Armstrong,PG,32,CHI,27,18,583,83,186,0.446,13,29,0.448,70,157,0.446,0.481,22,25,0.88,2,45,47,78,7,1,40,34,201
2000,Darrell Armstrong,PG,31,ORL,82,82,2590,484,1119,0.433,137,403,0.34,347,716,0.485,0.494,225,247,0.911,65,205,270,501,169,9,248,137,1330
2000,Chucky Atkins,PG,25,ORL,82,0,1626,314,741,0.424,57,163,0.35,257,578,0.445,0.462,97,133,0.729,20,106,126,306,52,3,142,137,782
2000,Stacey Augmon,SG,31,POR,59,0,692,83,175,0.474,0,2,0,83,173,0.48,0.474,37,55,0.673,42,74,116,53,27,11,38,69,203
2000,Isaac Austin,C,30,WAS,59,23,1173,151,352,0.429,1,4,0.25,150,348,0.431,0.43,94,137,0.686,64,218,282,74,17,38,107,128,397
2000,Anthony Avent,PF,30,LAC,49,3,377,29,96,0.302,0,0,NA,29,96,0.302,0.302,23,32,0.719,23,51,74,11,16,15,24,62,81
2000,Vin Baker,C,28,SEA,79,75,2849,514,1129,0.455,2,8,0.25,512,1121,0.457,0.456,281,412,0.682,227,378,605,148,47,66,213,288,1311
2000,Brent Barry,SG,28,SEA,80,74,2726,327,707,0.463,164,399,0.411,163,308,0.529,0.579,127,157,0.809,50,322,372,291,103,31,142,228,945
2000,Drew Barry,PG,26,GSW,8,0,85,9,18,0.5,3,9,0.333,6,9,0.667,0.583,1,2,0.5,0,8,8,17,2,0,6,14,22
2000,Drew Barry,PG,26,ATL,8,0,74,6,15,0.4,4,9,0.444,2,6,0.333,0.533,3,3,1,0,4,4,16,0,0,7,9,19
2000,Jon Barry,SG,30,SAC,62,1,1281,161,346,0.465,66,154,0.429,95,192,0.495,0.561,107,116,0.922,38,121,159,150,75,7,85,104,495
2000,Tony Battie,C,23,BOS,82,4,1505,219,459,0.477,1,8,0.125,218,451,0.483,0.478,102,151,0.675,152,258,410,63,47,70,67,249,541
2000,Benoit Benjamin,C,35,CLE,3,0,8,1,3,0.333,0,0,NA,1,3,0.333,0.333,0,0,NA,0,1,1,0,0,1,0,1,2
2000,Travis Best,PG,27,IND,82,0,1691,271,561,0.483,35,93,0.376,236,468,0.504,0.514,156,190,0.821,16,126,142,272,76,5,107,204,733
2000,Mike Bibby,PG,21,VAN,82,82,3155,459,1031,0.445,77,212,0.363,382,819,0.466,0.483,195,250,0.78,73,233,306,665,132,15,247,171,1190
2000,Chauncey Billups,SG,23,DEN,13,5,305,34,101,0.337,7,41,0.171,27,60,0.45,0.371,37,44,0.841,8,26,34,39,10,2,24,27,112
2000,Corie Blount,PF,31,PHO,38,1,446,44,89,0.494,0,2,0,44,87,0.506,0.494,19,33,0.576,52,61,113,10,15,7,28,78,107
2000,Muggsy Bogues,PG,35,TOR,80,5,1731,157,358,0.439,17,51,0.333,140,307,0.456,0.462,79,87,0.908,25,110,135,299,65,4,59,119,410
2000,Etdrick Bohannon,PF,26,NYK,2,0,5,0,0,NA,0,0,NA,0,0,NA,NA,3,4,0.75,1,0,1,0,0,0,2,1,3
2000,Etdrick Bohannon,PF,26,LAC,11,0,113,7,13,0.538,0,0,NA,7,13,0.538,0.538,12,20,0.6,12,18,30,5,2,6,8,24,26
2000,Calvin Booth,C,23,WAS,11,0,143,16,46,0.348,0,0,NA,16,46,0.348,0.348,10,14,0.714,15,17,32,7,3,14,6,23,42
2000,Bruce Bowen,SF,28,PHI,42,0,311,26,73,0.356,1,2,0.5,25,71,0.352,0.363,6,12,0.5,14,22,36,16,9,5,5,37,59
2000,Bruce Bowen,SF,28,MIA,27,2,567,46,121,0.38,26,56,0.464,20,65,0.308,0.488,19,31,0.613,13,47,60,18,14,10,14,81,137
2000,Earl Boykins,PG,23,ORL,1,0,8,3,4,0.75,0,0,NA,3,4,0.75,0.75,0,0,NA,1,0,1,3,0,0,0,0,6
2000,Earl Boykins,PG,23,CLE,25,0,253,53,112,0.473,8,20,0.4,45,92,0.489,0.509,18,23,0.783,11,14,25,45,12,1,17,23,132
2000,Shawn Bradley,C,27,DAL,77,54,1901,266,555,0.479,1,5,0.2,265,550,0.482,0.48,114,149,0.765,160,337,497,60,71,190,74,260,647
2000,Terrell Brandon,PG,29,MIN,71,71,2587,486,1042,0.466,53,132,0.402,433,910,0.476,0.492,187,208,0.899,44,194,238,629,134,30,184,158,1212
2000,Chucky Brown,PF,31,SAS,30,27,602,82,176,0.466,1,3,0.333,81,173,0.468,0.469,25,31,0.806,11,66,77,41,8,10,28,53,190
2000,Chucky Brown,PF,31,CHH,33,2,494,66,152,0.434,1,7,0.143,65,145,0.448,0.438,11,21,0.524,24,66,90,25,12,8,17,61,144
2000,Dee Brown,PG,31,TOR,38,12,673,93,258,0.36,67,187,0.358,26,71,0.366,0.49,11,16,0.688,9,45,54,86,24,5,39,62,264
2000,Rick Brunson,PG,27,NYK,37,0,289,29,70,0.414,2,13,0.154,27,57,0.474,0.429,11,18,0.611,3,24,27,49,9,1,31,35,71
2000,Mark Bryant,PF,34,CLE,75,50,1712,174,346,0.503,0,0,NA,174,346,0.503,0.503,76,94,0.809,126,226,352,61,31,31,87,250,424
2000,Jud Buechler,SF,31,DET,58,5,657,55,156,0.353,18,83,0.217,37,73,0.507,0.41,2,7,0.286,30,61,91,33,25,16,13,50,130
2000,Scott Burrell,SF,29,NJN,74,9,1336,165,419,0.394,82,232,0.353,83,187,0.444,0.492,39,50,0.78,65,191,256,72,67,44,38,173,451
2000,Jason Caffey,PF,26,GSW,71,56,2159,323,675,0.479,0,2,0,323,673,0.48,0.479,206,345,0.597,189,293,482,119,62,20,170,269,852
2000,Marcus Camby,C,25,NYK,59,11,1548,226,471,0.48,1,2,0.5,225,469,0.48,0.481,148,221,0.67,174,287,461,49,43,116,72,204,601
2000,Elden Campbell,C,31,CHH,78,77,2538,370,829,0.446,0,6,0,370,823,0.45,0.446,247,358,0.69,168,422,590,129,56,150,127,269,987
2000,Antoine Carr,SF,38,VAN,21,0,221,28,64,0.438,0,0,NA,28,64,0.438,0.438,11,14,0.786,8,24,32,7,3,6,9,42,67
2000,Chris Carr,SG,25,GSW,7,0,74,11,33,0.333,1,8,0.125,10,25,0.4,0.348,16,19,0.842,5,8,13,3,0,1,5,12,39
2000,Chris Carr,SF,25,CHI,50,2,1092,185,463,0.4,31,93,0.333,154,370,0.416,0.433,91,106,0.858,36,124,160,81,30,14,112,101,492
2000,Anthony Carter,PG,24,MIA,79,30,1859,201,509,0.395,3,23,0.13,198,486,0.407,0.398,93,124,0.75,48,151,199,378,93,5,173,167,498
2000,Vince Carter,SF,23,TOR,82,82,3126,788,1696,0.465,95,236,0.403,693,1460,0.475,0.493,436,551,0.791,150,326,476,322,110,92,178,263,2107
2000,Sam Cassell,PG,30,MIL,81,81,2899,545,1170,0.466,26,90,0.289,519,1080,0.481,0.477,390,445,0.876,69,232,301,729,102,8,267,255,1506
2000,Kelvin Cato,C,25,HOU,65,32,1581,216,402,0.537,0,4,0,216,398,0.543,0.537,135,208,0.649,102,287,389,26,33,124,71,175,567
2000,Cedric Ceballos,SF,30,DAL,69,25,2064,447,1002,0.446,44,134,0.328,403,868,0.464,0.468,209,248,0.843,172,290,462,90,56,24,125,165,1147
2000,Rex Chapman,SG,32,PHO,53,19,957,124,320,0.388,41,123,0.333,83,197,0.421,0.452,59,78,0.756,10,70,80,62,22,1,38,70,348
2000,Pete Chilcutt,PF,31,UTA,26,0,224,22,62,0.355,1,10,0.1,21,52,0.404,0.363,2,2,1,15,28,43,10,5,4,9,31,47
2000,Pete Chilcutt,PF,31,CLE,6,0,30,0,2,0,0,0,NA,0,2,0,0,0,0,NA,4,5,9,1,0,0,0,3,0
2000,Pete Chilcutt,PF,31,LAC,24,2,347,31,63,0.492,5,16,0.313,26,47,0.553,0.532,6,6,1,27,52,79,16,10,6,11,39,73
2000,Chris Childs,PG,32,NYK,71,2,1675,146,357,0.409,37,104,0.356,109,253,0.431,0.461,47,59,0.797,17,130,147,285,36,4,105,240,376
2000,Doug Christie,SG,29,TOR,73,73,2264,311,764,0.407,99,275,0.36,212,489,0.434,0.472,182,216,0.843,63,222,285,321,102,43,144,167,903
2000,Keon Clark,C,24,DEN,81,20,1850,286,528,0.542,1,8,0.125,285,520,0.548,0.543,121,176,0.688,162,343,505,71,45,114,125,231,694
2000,Bimbo Coles,PG,31,ATL,80,54,1924,276,607,0.455,8,39,0.205,268,568,0.472,0.461,85,104,0.817,30,142,172,290,58,11,103,178,645
2000,Marty Conlon,C,32,LAC,3,0,9,1,2,0.5,0,0,NA,1,2,0.5,0.5,0,0,NA,1,1,2,0,0,0,0,1,2
2000,Tyrone Corbin,SF,37,SAC,54,5,941,88,247,0.356,10,44,0.227,78,203,0.384,0.377,33,39,0.846,40,125,165,60,36,5,29,99,219
2000,Austin Croshere,PF,24,IND,81,14,1885,288,653,0.441,63,174,0.362,225,479,0.47,0.489,196,231,0.848,135,381,516,89,44,60,121,203,835
2000,John Crotty,PG,30,DET,69,0,937,106,251,0.422,33,80,0.413,73,171,0.427,0.488,80,93,0.86,17,58,75,128,27,5,54,104,325
2000,Terry Cummings,PF,38,GSW,22,0,398,76,177,0.429,0,0,NA,76,177,0.429,0.429,32,39,0.821,45,62,107,21,13,8,27,74,184
2000,Bill Curley,PF,27,HOU,4,0,50,6,11,0.545,0,0,NA,6,11,0.545,0.545,0,0,NA,4,4,8,0,2,0,4,10,12
2000,Bill Curley,SF,27,GSW,24,0,259,23,57,0.404,0,1,0,23,56,0.411,0.404,18,25,0.72,14,28,42,14,11,4,17,51,64
2000,Michael Curry,SG,31,DET,82,3,1611,182,379,0.48,1,5,0.2,181,374,0.484,0.482,141,168,0.839,21,83,104,87,33,5,73,209,506
2000,Antonio Daniels,SG,24,SAS,68,1,1195,163,344,0.474,22,66,0.333,141,278,0.507,0.506,72,101,0.713,16,70,86,177,55,5,58,73,420
2000,Kornél Dávid,SF,28,CHI,26,5,443,63,148,0.426,0,3,0,63,145,0.434,0.426,42,52,0.808,22,51,73,16,13,2,31,49,168
2000,Kornél Dávid,SF,28,CLE,6,0,31,4,9,0.444,0,0,NA,4,9,0.444,0.444,3,4,0.75,4,4,8,1,4,1,2,7,11
2000,Antonio Davis,C,31,TOR,79,78,2479,313,712,0.44,0,0,NA,313,712,0.44,0.44,284,371,0.765,235,461,696,105,38,100,121,267,910
2000,Baron Davis,PG,20,CHH,82,0,1523,182,433,0.42,25,111,0.225,157,322,0.488,0.449,97,153,0.634,48,117,165,309,97,19,140,201,486
2000,Dale Davis,C,30,IND,74,72,2127,302,602,0.502,0,0,NA,302,602,0.502,0.502,139,203,0.685,256,473,729,64,52,94,91,203,743
2000,Hubert Davis,PG,29,DAL,79,15,1817,217,464,0.468,82,167,0.491,135,297,0.455,0.556,67,77,0.87,17,117,134,141,24,3,70,109,583
2000,Ricky Davis,SG,20,CHH,48,4,570,94,187,0.503,0,4,0,94,183,0.514,0.503,39,51,0.765,29,54,83,62,30,8,46,39,227
2000,Todd Day,SG,30,PHO,58,1,941,130,330,0.394,64,165,0.388,66,165,0.4,0.491,72,108,0.667,31,98,129,65,44,22,50,127,396
2000,Andrew DeClercq,C,26,CLE,82,31,1831,225,443,0.508,0,0,NA,225,443,0.508,0.508,94,160,0.588,156,283,439,58,63,66,108,275,544
2000,Vinny Del Negro,PG,33,MIL,67,0,1211,153,325,0.471,8,24,0.333,145,301,0.482,0.483,35,39,0.897,9,98,107,160,36,0,48,81,349
2000,Tony Delk,PG,26,SAC,46,1,682,120,279,0.43,9,40,0.225,111,239,0.464,0.446,47,59,0.797,36,52,88,55,35,5,32,58,296
2000,Derrick Dial,SG,24,SAS,8,0,95,17,46,0.37,3,12,0.25,14,34,0.412,0.402,3,5,0.6,14,12,26,5,1,1,6,10,40
2000,Michael Doleac,C,22,ORL,81,29,1335,242,535,0.452,1,2,0.5,241,533,0.452,0.453,80,95,0.842,89,245,334,63,29,34,65,224,565
2000,Sherman Douglas,PG,33,NJN,20,2,309,45,90,0.5,5,16,0.313,40,74,0.541,0.528,25,28,0.893,13,16,29,34,17,0,24,26,120
2000,Chris Dudley,C,34,NYK,47,3,459,23,67,0.343,0,0,NA,23,67,0.343,0.343,9,27,0.333,63,73,136,5,7,21,18,95,55
2000,Howard Eisley,PG,27,UTA,82,5,2096,282,675,0.418,60,163,0.368,222,512,0.434,0.462,84,102,0.824,23,147,170,347,59,9,132,223,708
2000,Obinna Ekezie,PF,24,VAN,39,0,351,41,88,0.466,0,0,NA,41,88,0.466,0.466,43,64,0.672,34,58,92,8,9,4,26,61,125
2000,Mario Elie,SF,36,SAS,79,79,2217,195,457,0.427,74,186,0.398,121,271,0.446,0.508,126,149,0.846,48,201,249,193,73,9,130,156,590
2000,Dale Ellis,SG,39,MIL,18,0,324,47,101,0.465,23,65,0.354,24,36,0.667,0.579,6,9,0.667,7,27,34,6,6,0,7,23,123
2000,Dale Ellis,SG,39,CHH,24,5,240,19,58,0.328,14,35,0.4,5,23,0.217,0.448,3,4,0.75,6,16,22,8,7,0,13,22,55
2000,Jamie Feick,C,25,NJN,81,17,2241,181,423,0.428,3,3,1,178,420,0.424,0.431,94,133,0.707,264,491,755,68,43,38,59,206,459
2000,Michael Finley,SF,26,DAL,82,82,3464,748,1636,0.457,99,247,0.401,649,1389,0.467,0.487,260,317,0.82,122,396,518,438,109,32,196,171,1855
2000,Derek Fisher,PG,25,LAL,78,22,1803,167,483,0.346,52,166,0.313,115,317,0.363,0.4,105,145,0.724,22,121,143,216,80,3,75,150,491
2000,Greg Foster,PF,31,SEA,60,5,718,91,224,0.406,3,15,0.2,88,209,0.421,0.413,18,28,0.643,16,91,107,41,10,18,28,105,203
2000,Adonal Foyle,C,24,GSW,76,59,1654,193,380,0.508,0,0,NA,193,380,0.508,0.508,34,90,0.378,174,250,424,42,26,136,71,218,420
2000,Steve Francis,PG,22,HOU,77,77,2776,497,1117,0.445,107,310,0.345,390,807,0.483,0.493,287,365,0.786,152,257,409,507,118,29,306,231,1388
2000,Kevin Garnett,PF,23,MIN,81,81,3243,759,1526,0.497,30,81,0.37,729,1445,0.504,0.507,309,404,0.765,223,733,956,401,120,126,268,205,1857
2000,Dean Garrett,C,33,MIN,56,23,604,48,108,0.444,0,0,NA,48,108,0.444,0.444,18,26,0.692,41,99,140,19,8,40,21,94,114
2000,Chris Gatling,PF,32,ORL,45,0,1041,210,462,0.455,7,23,0.304,203,439,0.462,0.462,171,245,0.698,91,206,297,40,48,10,105,142,598
2000,Chris Gatling,PF,32,DEN,40,0,770,155,340,0.456,11,47,0.234,144,293,0.491,0.472,95,128,0.742,63,142,205,31,34,13,64,104,416
2000,Kendall Gill,SF,31,NJN,76,75,2355,396,956,0.414,20,78,0.256,376,878,0.428,0.425,181,255,0.71,82,201,283,210,139,41,89,211,993
2000,Armen Gilliam,PF,35,UTA,50,0,782,133,305,0.436,0,1,0,133,304,0.438,0.436,67,86,0.779,72,137,209,42,12,16,55,83,333
2000,Dion Glover,SG,21,ATL,30,1,446,66,171,0.386,12,45,0.267,54,126,0.429,0.421,51,70,0.729,15,23,38,27,15,4,28,28,195
2000,Devin Gray,SF,27,HOU,21,2,124,15,37,0.405,0,0,NA,15,37,0.405,0.405,19,29,0.655,11,14,25,5,5,3,4,22,49
2000,A.C. Green,PF,36,LAL,82,82,1929,173,387,0.447,1,4,0.25,172,383,0.449,0.448,66,95,0.695,160,326,486,80,53,18,53,127,413
2000,Adrian Griffin,SG,25,BOS,72,47,1927,175,413,0.424,16,57,0.281,159,356,0.447,0.443,119,158,0.753,128,244,372,177,116,15,93,222,485
2000,Tom Gugliotta,PF,30,PHO,54,54,1767,310,645,0.481,1,8,0.125,309,637,0.485,0.481,117,151,0.775,141,284,425,124,80,31,106,152,738
2000,Darvin Ham,SF,26,MIL,35,21,792,71,128,0.555,0,1,0,71,127,0.559,0.555,35,78,0.449,85,87,172,42,29,29,29,102,177
2000,Tom Hammonds,PF,32,MIN,56,0,372,42,97,0.433,0,0,NA,42,97,0.433,0.433,33,56,0.589,34,67,101,10,8,3,21,55,117
2000,Anfernee Hardaway,SG,28,PHO,60,60,2253,378,798,0.474,33,102,0.324,345,696,0.496,0.494,226,286,0.79,91,256,347,315,94,38,153,164,1015
2000,Tim Hardaway,PG,33,MIA,52,52,1672,246,638,0.386,94,256,0.367,152,382,0.398,0.459,110,133,0.827,25,125,150,385,49,4,119,112,696
2000,Ron Harper,PG,36,LAL,80,78,2042,212,531,0.399,33,106,0.311,179,425,0.421,0.43,100,147,0.68,96,241,337,270,85,39,132,164,557
2000,Al Harrington,PF,19,IND,50,0,854,121,264,0.458,8,34,0.235,113,230,0.491,0.473,78,111,0.703,47,112,159,38,25,9,65,130,328
2000,Othella Harrington,PF,26,VAN,82,82,2677,420,830,0.506,0,2,0,420,828,0.507,0.506,236,298,0.792,196,367,563,97,36,58,217,287,1076
2000,Antonio Harvey,PF,29,POR,19,0,137,17,30,0.567,0,0,NA,17,30,0.567,0.567,7,12,0.583,8,25,33,5,1,6,12,20,41
2000,Mark Hendrickson,PF,25,CLE,10,0,47,5,7,0.714,0,0,NA,5,7,0.714,0.714,2,2,1,2,9,11,3,2,1,3,7,12
2000,Mark Hendrickson,PF,25,NJN,5,0,24,0,1,0,0,0,NA,0,1,0,0,1,2,0.5,1,1,2,3,0,0,0,1,1
2000,Tyrone Hill,PF,31,PHI,68,65,2155,318,656,0.485,0,1,0,318,655,0.485,0.485,179,259,0.691,220,405,625,52,64,27,124,243,815
2000,Jeff Hornacek,SG,36,UTA,77,77,2133,358,728,0.492,66,138,0.478,292,590,0.495,0.537,171,180,0.95,49,133,182,202,66,16,113,149,953
2000,Robert Horry,PF,29,LAL,76,0,1685,159,363,0.438,29,94,0.309,130,269,0.483,0.478,89,113,0.788,133,228,361,118,84,80,73,189,436
2000,Juwan Howard,PF,26,WAS,82,82,2909,509,1108,0.459,0,7,0,509,1101,0.462,0.459,202,275,0.735,132,338,470,247,67,21,225,299,1220
2000,Larry Hughes,SG,21,PHI,50,5,1018,192,461,0.416,11,51,0.216,181,410,0.441,0.428,106,142,0.746,52,107,159,75,54,12,95,94,501
2000,Larry Hughes,SG,21,GSW,32,32,1306,267,686,0.389,18,74,0.243,249,612,0.407,0.402,173,235,0.736,61,129,190,130,61,16,100,97,725
2000,Allen Iverson,SG,24,PHI,70,70,2853,729,1733,0.421,89,261,0.341,640,1472,0.435,0.446,442,620,0.713,71,196,267,328,144,5,230,162,1989
2000,Bobby Jackson,PG,26,MIN,73,10,1034,140,346,0.405,13,46,0.283,127,300,0.423,0.423,76,98,0.776,50,103,153,172,48,7,58,114,369
2000,Jermaine Jackson,SG,23,DET,7,0,73,1,11,0.091,0,1,0,1,10,0.1,0.091,5,8,0.625,1,10,11,4,3,0,7,7,7
2000,Jim Jackson,SF,29,ATL,79,76,2767,507,1235,0.411,117,303,0.386,390,932,0.418,0.458,186,212,0.877,101,293,394,230,57,10,185,167,1317
2000,Mark Jackson,PG,34,IND,81,81,2190,246,570,0.432,89,221,0.403,157,349,0.45,0.51,79,98,0.806,63,233,296,650,76,10,174,111,660
2000,Sam Jacobson,PG,24,LAL,3,0,18,5,9,0.556,0,0,NA,5,9,0.556,0.556,0,2,0,0,1,1,2,1,0,2,1,10
2000,Sam Jacobson,PG,24,GSW,49,5,663,103,203,0.507,9,24,0.375,94,179,0.525,0.53,30,39,0.769,25,45,70,30,29,3,31,112,245
2000,Antawn Jamison,SF,23,GSW,43,41,1556,356,756,0.471,2,7,0.286,354,749,0.473,0.472,127,208,0.611,172,187,359,90,30,15,113,115,841
2000,Anthony Johnson,PG,25,ATL,38,2,423,36,103,0.35,1,6,0.167,35,97,0.361,0.354,19,24,0.792,15,24,39,59,23,2,24,41,92
2000,Anthony Johnson,PG,25,ORL,18,4,214,26,61,0.426,1,5,0.2,25,56,0.446,0.434,9,15,0.6,6,6,12,13,10,2,8,17,62
2000,Avery Johnson,PG,34,SAS,82,82,2571,402,850,0.473,1,9,0.111,401,841,0.477,0.474,114,155,0.735,33,125,158,491,76,18,140,150,919
2000,Damon Jones,PG,23,GSW,13,1,196,25,54,0.463,11,23,0.478,14,31,0.452,0.565,7,9,0.778,0,16,16,39,6,0,15,13,68
2000,Damon Jones,PG,23,DAL,42,0,416,55,154,0.357,30,91,0.33,25,63,0.397,0.455,25,39,0.641,12,27,39,57,12,1,25,21,165
2000,Eddie Jones,SG,28,CHH,72,72,2807,478,1119,0.427,128,341,0.375,350,778,0.45,0.484,362,419,0.864,81,262,343,305,192,49,160,176,1446
2000,Reggie Jordan,PG,32,WAS,36,0,243,17,53,0.321,0,1,0,17,52,0.327,0.321,7,13,0.538,16,25,41,32,12,2,19,29,41
2000,Steve Kerr,PG,34,SAS,32,0,268,32,74,0.432,16,31,0.516,16,43,0.372,0.541,9,11,0.818,3,16,19,12,4,0,7,14,89
2000,Lari Ketner,PF,22,CHI,6,0,41,4,10,0.4,0,0,NA,4,10,0.4,0.4,2,2,1,0,7,7,1,1,1,3,8,10
2000,Lari Ketner,PF,22,CLE,16,0,91,9,22,0.409,0,0,NA,9,22,0.409,0.409,6,10,0.6,12,15,27,0,3,2,7,12,24
2000,Jason Kidd,PG,26,PHO,67,67,2616,350,855,0.409,56,166,0.337,294,689,0.427,0.442,203,245,0.829,96,387,483,678,134,28,226,148,959
2000,Joe Kleine,C,38,POR,7,0,31,4,11,0.364,0,0,NA,4,11,0.364,0.364,3,3,1,0,6,6,2,1,0,2,7,11
2000,Brevin Knight,PG,24,CLE,65,46,1754,230,558,0.412,2,10,0.2,228,548,0.416,0.414,140,184,0.761,38,155,193,458,107,21,157,185,602
2000,Toni Kukoč,SF,31,CHI,24,23,868,148,388,0.381,18,78,0.231,130,310,0.419,0.405,118,155,0.761,37,93,130,124,44,19,75,51,432
2000,Toni Kukoč,SF,31,PHI,32,8,916,149,340,0.438,26,90,0.289,123,250,0.492,0.476,74,110,0.673,38,105,143,141,33,9,71,61,398
2000,Christian Laettner,C,30,DET,82,82,2443,379,801,0.473,7,24,0.292,372,777,0.479,0.478,237,292,0.812,175,378,553,186,83,45,186,326,1002
2000,Raef LaFrentz,C,23,DEN,81,80,2435,392,879,0.446,60,183,0.328,332,696,0.477,0.48,162,236,0.686,170,471,641,97,42,180,96,292,1006
2000,Andrew Lang,C,33,NYK,19,10,244,28,64,0.438,0,0,NA,28,64,0.438,0.438,3,7,0.429,16,44,60,3,8,6,5,31,59
2000,Antonio Lang,SF,27,TOR,7,0,32,0,5,0,0,0,NA,0,5,0,0,3,4,0.75,0,5,5,1,4,1,2,7,3
2000,Antonio Lang,SF,27,PHI,3,0,6,1,1,1,0,0,NA,1,1,1,1,1,1,1,0,0,0,1,0,0,0,1,3
2000,Tim Legler,SG,33,GSW,23,4,284,28,78,0.359,7,21,0.333,21,57,0.368,0.404,14,18,0.778,4,19,23,24,4,1,6,33,77
2000,Voshon Lenard,SG,26,MIA,53,13,1434,228,560,0.407,89,228,0.39,139,332,0.419,0.487,84,106,0.792,37,116,153,136,41,15,80,127,629
2000,Rashard Lewis,SF,20,SEA,82,8,1575,275,566,0.486,40,120,0.333,235,446,0.527,0.521,84,123,0.683,127,209,336,70,62,36,78,163,674
2000,Grant Long,PF,33,VAN,42,1,920,74,167,0.443,0,4,0,74,163,0.454,0.443,55,71,0.775,86,148,234,43,45,10,49,108,203
2000,Luc Longley,C,31,PHO,72,68,1417,186,399,0.466,0,0,NA,186,399,0.466,0.466,80,97,0.825,100,223,323,77,22,42,136,221,452
2000,Felipe López,SG,25,VAN,65,0,781,111,261,0.425,3,18,0.167,108,243,0.444,0.431,67,109,0.615,59,65,124,44,32,17,53,94,292
2000,Tyronn Lue,PG,22,LAL,8,0,146,19,39,0.487,4,8,0.5,15,31,0.484,0.538,6,8,0.75,2,10,12,17,3,0,9,17,48
2000,Sam Mack,SF,29,GSW,23,5,333,37,122,0.303,21,64,0.328,16,58,0.276,0.389,19,20,0.95,7,32,39,24,18,1,19,45,114
2000,Danny Manning,PF,33,MIL,72,0,1217,149,339,0.44,1,4,0.25,148,335,0.442,0.441,34,52,0.654,50,158,208,73,62,29,55,183,333
2000,Stephon Marbury,PG,22,NJN,74,74,2881,569,1317,0.432,66,233,0.283,503,1084,0.464,0.457,436,536,0.813,61,179,240,622,112,15,270,195,1640
2000,Shawn Marion,SF,21,PHO,51,38,1260,222,471,0.471,4,22,0.182,218,449,0.486,0.476,72,85,0.847,105,227,332,69,38,53,51,113,520
2000,Donyell Marshall,PF,26,GSW,64,51,2071,331,840,0.394,49,138,0.355,282,702,0.402,0.423,199,255,0.78,189,448,637,167,68,68,123,180,910
2000,Darrick Martin,PG,28,SAC,71,1,893,133,350,0.38,38,124,0.306,95,226,0.42,0.434,98,119,0.824,7,37,44,122,28,2,62,89,402
2000,Jamal Mashburn,SF,27,MIA,76,76,2828,515,1158,0.445,112,278,0.403,403,880,0.458,0.493,186,239,0.778,64,317,381,298,79,14,180,215,1328
2000,Tony Massenburg,PF,32,HOU,10,0,109,16,36,0.444,0,0,NA,16,36,0.444,0.444,14,16,0.875,7,20,27,3,2,5,9,13,46
2000,Vernon Maxwell,SG,34,SEA,47,0,989,169,490,0.345,67,223,0.3,102,267,0.382,0.413,108,148,0.73,15,64,79,75,38,9,53,83,513
2000,Walter McCarty,PF,25,BOS,61,5,879,78,230,0.339,34,110,0.309,44,120,0.367,0.413,39,54,0.722,33,77,110,70,24,23,67,83,229
2000,George McCloud,SF,32,DEN,78,11,2118,266,638,0.417,107,283,0.378,159,355,0.448,0.501,148,181,0.818,72,213,285,246,48,26,134,180,787
2000,Antonio McDyess,PF,25,DEN,81,81,2698,614,1211,0.507,0,2,0,614,1209,0.508,0.507,323,516,0.626,234,451,685,159,69,139,230,316,1551
2000,Tracy McGrady,SF,20,TOR,79,34,2462,459,1018,0.451,18,65,0.277,441,953,0.463,0.46,277,392,0.707,188,313,501,263,90,151,160,201,1213
2000,Jeff McInnis,PG,25,LAC,25,10,597,80,186,0.43,7,21,0.333,73,165,0.442,0.449,13,17,0.765,18,54,72,89,15,2,27,55,180
2000,Aaron McKie,SG,27,PHI,82,14,1952,244,593,0.411,44,121,0.364,200,472,0.424,0.449,121,146,0.829,47,199,246,240,108,18,113,194,653
2000,Roshown McLeod,SF,24,ATL,44,20,860,131,332,0.395,2,13,0.154,129,319,0.404,0.398,54,70,0.771,41,97,138,52,16,5,59,84,318
2000,Ron Mercer,SG,23,DEN,37,37,1408,272,612,0.444,15,39,0.385,257,573,0.449,0.457,119,151,0.788,29,123,152,104,33,15,87,75,678
2000,Ron Mercer,SG,23,ORL,31,31,969,188,468,0.402,0,9,0,188,459,0.41,0.402,94,119,0.79,35,63,98,54,42,8,64,76,470
2000,Andre Miller,PG,23,CLE,82,36,2093,339,755,0.449,10,49,0.204,329,706,0.466,0.456,226,292,0.774,85,195,280,476,84,17,166,194,914
2000,Anthony Miller,PF,28,HOU,35,14,476,52,97,0.536,0,0,NA,52,97,0.536,0.536,26,51,0.51,49,115,164,16,11,10,19,68,130
2000,Brad Miller,C,23,CHH,55,4,961,135,293,0.461,0,2,0,135,291,0.464,0.461,153,195,0.785,113,180,293,45,23,35,48,111,423
2000,Oliver Miller,C,29,PHO,51,9,1088,137,233,0.588,0,0,NA,137,233,0.588,0.588,49,73,0.671,87,174,261,68,42,80,74,132,323
2000,Terry Mills,PF,32,DET,82,78,1842,214,488,0.439,95,242,0.393,119,246,0.484,0.536,25,34,0.735,50,340,390,85,38,24,46,242,548
2000,Cuttino Mobley,SG,24,HOU,81,8,2496,437,1016,0.43,104,292,0.356,333,724,0.46,0.481,299,353,0.847,59,229,288,208,87,32,186,171,1277
2000,Nazr Mohammed,C,22,PHI,28,3,190,21,54,0.389,0,0,NA,21,54,0.389,0.389,12,22,0.545,16,34,50,2,4,12,18,29,54
2000,Eric Montross,C,28,DET,51,0,332,17,55,0.309,0,0,NA,17,55,0.309,0.309,6,12,0.5,18,54,72,7,6,9,22,81,40
2000,Mikki Moore,C,24,DET,29,0,488,87,140,0.621,0,0,NA,87,140,0.621,0.621,54,68,0.794,44,68,112,17,9,31,23,104,228
2000,Alonzo Mourning,C,29,MIA,79,78,2748,652,1184,0.551,0,4,0,652,1180,0.553,0.551,414,582,0.711,215,538,753,123,40,294,217,308,1718
2000,Eric Murdock,PG,31,LAC,40,15,693,79,205,0.385,16,42,0.381,63,163,0.387,0.424,51,80,0.638,15,62,77,108,47,5,58,67,225
2000,Tracy Murray,SF,28,WAS,80,8,1831,290,670,0.433,113,263,0.43,177,407,0.435,0.517,120,141,0.851,63,208,271,72,45,24,84,185,813
2000,Dikembe Mutombo,C,33,ATL,82,82,2984,322,573,0.562,0,0,NA,322,573,0.562,0.562,298,421,0.708,304,853,1157,105,27,269,174,248,942
2000,Tyrone Nesby,SG,24,LAC,73,39,2317,364,915,0.398,94,281,0.335,270,634,0.426,0.449,151,191,0.791,82,193,275,121,75,31,102,205,973
2000,Johnny Newman,SF,36,NJN,82,9,1763,278,623,0.446,72,190,0.379,206,433,0.476,0.504,192,229,0.838,39,115,154,65,53,11,89,207,820
2000,Moochie Norris,PG,26,HOU,30,0,502,69,159,0.434,12,29,0.414,57,130,0.438,0.472,57,73,0.781,16,52,68,94,23,1,30,32,207
2000,Jermaine O'Neal,C,21,POR,70,8,859,108,222,0.486,0,1,0,108,221,0.489,0.486,57,98,0.582,97,132,229,18,11,55,47,127,273
2000,Shaquille O'Neal,C,27,LAL,79,79,3163,956,1665,0.574,0,1,0,956,1664,0.575,0.574,432,824,0.524,336,742,1078,299,36,239,223,255,2344
2000,Kevin Ollie,PG,27,PHI,40,0,290,22,49,0.449,0,0,NA,22,49,0.449,0.449,28,37,0.757,4,27,31,46,10,0,10,27,72
2000,Michael Olowokandi,C,24,LAC,80,77,2493,330,756,0.437,0,0,NA,330,756,0.437,0.437,123,189,0.651,194,462,656,38,35,140,177,304,783
2000,Bo Outlaw,PF,28,ORL,82,55,2326,204,339,0.602,0,3,0,204,336,0.607,0.602,82,162,0.506,202,323,525,245,113,148,133,203,490
2000,Doug Overton,PG,30,BOS,48,0,432,61,154,0.396,10,28,0.357,51,126,0.405,0.429,20,21,0.952,14,19,33,53,10,0,20,46,152
2000,Billy Owens,PF,30,PHI,46,7,919,112,258,0.434,9,27,0.333,103,231,0.446,0.452,38,64,0.594,63,129,192,59,26,16,61,119,271
2000,Billy Owens,SF,30,GSW,16,4,386,38,100,0.38,2,7,0.286,36,93,0.387,0.39,25,42,0.595,36,73,109,38,7,5,24,47,103
2000,Robert Pack,PG,30,DAL,29,22,665,96,230,0.417,4,11,0.364,92,219,0.42,0.426,63,78,0.808,7,35,42,168,31,3,76,44,259
2000,Scott Padgett,PF,23,UTA,47,9,432,44,140,0.314,13,44,0.295,31,96,0.323,0.361,19,27,0.704,24,64,88,25,14,8,22,55,120
2000,Milt Palacio,PG,21,VAN,53,0,394,43,98,0.439,0,2,0,43,96,0.448,0.439,22,37,0.595,17,34,51,48,20,0,44,32,108
2000,Cherokee Parks,C,27,VAN,56,14,808,72,145,0.497,0,1,0,72,144,0.5,0.497,24,37,0.649,55,128,183,35,29,45,28,115,168
2000,Ruben Patterson,SF,24,SEA,81,74,2097,354,661,0.536,12,27,0.444,342,634,0.539,0.545,222,321,0.692,218,216,434,126,94,40,144,190,942
2000,Gary Payton,PG,31,SEA,82,82,3425,747,1666,0.448,177,520,0.34,570,1146,0.497,0.502,311,423,0.735,100,429,529,732,153,18,224,178,1982
2000,Anthony Peeler,SG,30,MIN,82,22,2073,316,725,0.436,85,255,0.333,231,470,0.491,0.494,87,109,0.798,58,174,232,195,62,10,85,171,804
2000,Sam Perkins,PF,38,IND,81,0,1620,184,441,0.417,89,218,0.408,95,223,0.426,0.518,80,97,0.825,64,225,289,68,31,33,63,136,537
2000,Elliot Perry,PG,30,NJN,60,5,803,128,294,0.435,11,39,0.282,117,255,0.459,0.454,50,62,0.806,13,48,61,139,39,1,60,47,317
2000,Wesley Person,SG,28,CLE,79,38,2056,280,654,0.428,106,250,0.424,174,404,0.431,0.509,61,77,0.792,44,223,267,146,40,19,60,119,727
2000,Olden Polynice,C,35,UTA,82,79,1819,203,398,0.51,1,2,0.5,202,396,0.51,0.511,28,90,0.311,166,287,453,37,30,84,70,260,435
2000,James Posey,SF,23,DEN,81,77,2052,230,536,0.429,82,220,0.373,148,316,0.468,0.506,120,150,0.8,85,232,317,146,98,33,95,207,662
2000,Vitaly Potapenko,C,24,BOS,79,72,1797,307,615,0.499,0,1,0,307,614,0.5,0.499,109,160,0.681,182,317,499,77,41,29,145,239,723
2000,Theo Ratliff,PF,26,PHI,57,56,1795,247,491,0.503,0,0,NA,247,491,0.503,0.503,182,236,0.771,140,295,435,36,32,171,108,185,676
2000,Eldridge Recasner,PG,32,CHH,7,0,28,3,7,0.429,1,4,0.25,2,3,0.667,0.5,0,0,NA,0,4,4,5,0,0,0,1,7
2000,Khalid Reeves,PG,27,CHI,3,0,48,3,12,0.25,0,3,0,3,9,0.333,0.25,5,5,1,2,2,4,13,2,0,6,8,11
2000,Don Reid,PF,26,DET,21,3,165,16,34,0.471,0,0,NA,16,34,0.471,0.471,3,6,0.5,5,20,25,1,5,12,11,45,35
2000,Don Reid,PF,26,WAS,17,0,333,44,78,0.564,0,0,NA,44,78,0.564,0.564,21,28,0.75,26,51,77,10,19,19,12,73,109
2000,J.R. Reid,PF,31,MIL,34,7,602,53,127,0.417,1,7,0.143,52,120,0.433,0.421,43,56,0.768,29,88,117,18,19,5,20,81,150
2000,Rodrick Rhodes,SF,26,DAL,1,0,8,0,3,0,0,0,NA,0,3,0,0,0,0,NA,1,0,1,0,2,0,2,0,0
2000,Clifford Robinson,SF,33,PHO,80,67,2839,530,1142,0.464,120,324,0.37,410,818,0.501,0.517,298,381,0.782,105,254,359,224,90,61,166,239,1478
2000,Carlos Rogers,C,28,HOU,53,15,1101,170,324,0.525,1,14,0.071,169,310,0.545,0.526,81,137,0.591,98,177,275,42,14,34,63,77,422
2000,Rodney Rogers,PF,28,PHO,82,7,2286,428,881,0.486,115,262,0.439,313,619,0.506,0.551,159,249,0.639,138,309,447,170,94,47,163,290,1130
2000,Roy Rogers,PF,26,DEN,40,0,355,35,88,0.398,0,1,0,35,87,0.402,0.398,19,41,0.463,33,47,80,9,2,38,10,36,89
2000,Sean Rooks,C,30,DAL,71,13,1001,122,283,0.431,0,0,NA,122,283,0.431,0.431,65,89,0.73,82,166,248,68,29,52,70,169,309
2000,Jalen Rose,SF,27,IND,80,80,2978,563,1196,0.471,77,196,0.393,486,1000,0.486,0.503,254,307,0.827,42,345,387,320,84,49,188,234,1457
2000,Malik Rose,PF,25,SAS,74,3,1341,176,385,0.457,1,3,0.333,175,382,0.458,0.458,143,198,0.722,133,202,335,47,35,52,99,232,496
2000,John Salley,C,35,LAL,45,3,303,25,69,0.362,0,0,NA,25,69,0.362,0.362,21,28,0.75,20,45,65,26,8,14,18,67,71
2000,Dennis Scott,SF,31,VAN,66,0,1263,125,333,0.375,71,189,0.376,54,144,0.375,0.482,48,57,0.842,16,90,106,69,28,9,30,104,369
2000,Brian Shaw,SG,33,LAL,74,2,1249,123,322,0.382,18,58,0.31,105,264,0.398,0.41,41,54,0.759,45,171,216,201,35,14,75,105,305
2000,Dickey Simpkins,PF,27,CHI,69,48,1651,111,274,0.405,0,1,0,111,273,0.407,0.405,65,120,0.542,124,248,372,100,22,22,128,217,287
2000,Brian Skinner,PF,23,LAC,33,9,775,68,134,0.507,0,0,NA,68,134,0.507,0.507,43,65,0.662,63,138,201,11,16,44,37,75,179
2000,Joe Smith,C,24,MIN,78,9,1975,289,623,0.464,1,1,1,288,622,0.463,0.465,195,258,0.756,186,298,484,88,45,85,119,302,774
2000,Michael Smith,SF,27,WAS,46,46,1145,108,192,0.563,0,1,0,108,191,0.565,0.563,73,101,0.723,121,210,331,56,27,23,45,127,289
2000,Steve Smith,SG,30,POR,82,81,2689,420,900,0.467,96,241,0.398,324,659,0.492,0.52,289,340,0.85,123,190,313,209,71,31,117,214,1225
2000,Eric Snow,PG,26,PHI,82,80,2866,257,597,0.43,11,45,0.244,246,552,0.446,0.44,126,177,0.712,42,219,261,624,140,8,162,243,651
2000,Felton Spencer,C,32,SAS,26,0,149,15,33,0.455,0,0,NA,15,33,0.455,0.455,20,30,0.667,15,24,39,3,6,8,9,32,50
2000,Jerry Stackhouse,SG,25,DET,82,82,3148,619,1447,0.428,83,288,0.288,536,1159,0.462,0.456,618,758,0.815,118,197,315,365,103,36,311,188,1939
2000,John Starks,SG,34,GSW,33,30,1108,192,508,0.378,56,161,0.348,136,347,0.392,0.433,45,54,0.833,10,81,91,170,37,3,64,93,485
2000,John Starks,SG,34,CHI,4,0,82,11,34,0.324,3,10,0.3,8,24,0.333,0.368,5,5,1,0,10,10,11,5,1,3,9,30
2000,Michael Stewart,C,24,TOR,42,1,389,20,53,0.377,0,0,NA,20,53,0.377,0.377,18,32,0.563,33,61,94,6,5,19,17,81,58
2000,Peja Stojaković,SF,22,SAC,74,11,1749,321,717,0.448,100,267,0.375,221,450,0.491,0.517,135,153,0.882,74,202,276,106,52,7,88,97,877
2000,Damon Stoudamire,PG,26,POR,78,78,2372,386,894,0.432,80,212,0.377,306,682,0.449,0.477,122,145,0.841,61,182,243,405,77,1,149,173,974
2000,Erick Strickland,SG,26,DAL,68,67,2025,316,730,0.433,73,186,0.392,243,544,0.447,0.483,162,195,0.831,69,254,323,211,105,13,102,190,867
2000,Mark Strickland,SF,29,MIA,58,5,663,122,224,0.545,0,0,NA,122,224,0.545,0.545,40,56,0.714,44,96,140,22,15,18,24,68,284
2000,Rod Strickland,PG,33,WAS,69,67,2188,327,762,0.429,1,21,0.048,326,741,0.44,0.43,214,305,0.702,73,186,259,519,94,18,187,147,869
2000,Bruno Šundov,C,19,DAL,14,0,61,12,31,0.387,0,0,NA,12,31,0.387,0.387,2,2,1,5,7,12,2,2,2,4,16,26
2000,Bob Sura,SG,26,CLE,73,45,2216,356,815,0.437,122,332,0.367,234,483,0.484,0.512,175,251,0.697,50,238,288,284,91,19,148,201,1009
2000,Wally Szczerbiak,SF,22,MIN,73,53,2171,342,669,0.511,28,78,0.359,314,591,0.531,0.532,133,161,0.826,89,183,272,201,58,23,83,175,845
2000,Žan Tabak,C,29,IND,18,0,114,16,34,0.471,0,0,NA,16,34,0.471,0.471,5,8,0.625,16,16,32,4,3,9,11,13,37
2000,Johnny Taylor,SF,25,DEN,1,0,5,0,2,0,0,0,NA,0,2,0,0,0,0,NA,0,1,1,0,0,0,0,1,0
2000,Johnny Taylor,SF,25,ORL,5,0,29,5,12,0.417,1,1,1,4,11,0.364,0.458,0,0,NA,2,3,5,1,1,1,2,4,11
2000,Maurice Taylor,PF,23,LAC,62,60,2227,458,988,0.464,1,8,0.125,457,980,0.466,0.464,143,201,0.711,96,304,400,101,51,48,169,217,1060
2000,Jamel Thomas,SF,26,BOS,3,0,19,5,10,0.5,0,1,0,5,9,0.556,0.5,1,1,1,0,2,2,2,0,0,1,0,11
2000,Jamel Thomas,SF,26,GSW,4,0,27,3,8,0.375,0,2,0,3,6,0.5,0.375,0,0,NA,1,2,3,4,1,0,4,2,6
2000,John Thomas,C,24,TOR,55,6,477,49,107,0.458,0,1,0,49,106,0.462,0.458,16,41,0.39,37,38,75,9,12,14,14,106,114
2000,Kenny Thomas,PF,22,HOU,72,29,1797,212,531,0.399,32,122,0.262,180,409,0.44,0.429,138,209,0.66,147,290,437,113,54,22,112,167,594
2000,Kurt Thomas,PF,27,NYK,80,21,1971,270,535,0.505,1,3,0.333,269,532,0.506,0.506,100,128,0.781,144,361,505,82,51,42,105,278,641
2000,Tim Thomas,SF,22,MIL,80,1,2093,347,753,0.461,63,182,0.346,284,571,0.497,0.503,188,243,0.774,100,232,332,113,59,31,129,227,945
2000,Otis Thorpe,PF,37,MIA,51,1,777,125,243,0.514,0,3,0,125,240,0.521,0.514,29,48,0.604,56,110,166,33,26,9,59,136,279
2000,Gary Trent,SF,25,DAL,11,11,301,70,142,0.493,0,2,0,70,140,0.5,0.493,11,21,0.524,20,32,52,22,8,3,25,28,151
2000,Mirsad Türkcan,PF,23,NYK,7,0,25,2,10,0.2,0,2,0,2,8,0.25,0.2,0,0,NA,2,8,10,1,2,0,1,4,4
2000,Mirsad Türkcan,PF,23,MIL,10,0,65,12,28,0.429,0,4,0,12,24,0.5,0.429,5,8,0.625,11,12,23,4,1,1,7,10,29
2000,Nick Van Exel,PG,28,DEN,79,79,2950,473,1213,0.39,133,401,0.332,340,812,0.419,0.445,196,240,0.817,34,277,311,714,68,11,221,148,1275
2000,Keith Van Horn,PF,24,NJN,80,80,2782,559,1257,0.445,84,228,0.368,475,1029,0.462,0.478,333,393,0.847,200,476,676,158,64,60,245,258,1535
2000,Loy Vaught,PF,31,DET,43,0,292,32,89,0.36,0,3,0,32,86,0.372,0.36,11,16,0.688,26,65,91,11,6,4,11,45,75
2000,Antoine Walker,PF,23,BOS,82,82,3003,648,1506,0.43,73,285,0.256,575,1221,0.471,0.455,311,445,0.699,199,453,652,305,117,32,259,263,1680
2000,Ben Wallace,PF,25,ORL,81,81,1959,168,334,0.503,0,0,NA,168,334,0.503,0.503,54,114,0.474,211,454,665,67,72,130,67,162,390
2000,Rasheed Wallace,PF,25,POR,81,77,2845,542,1045,0.519,8,50,0.16,534,995,0.537,0.522,233,331,0.704,129,437,566,142,87,107,157,216,1325
2000,Rex Walters,PG,29,MIA,33,0,389,38,91,0.418,5,20,0.25,33,71,0.465,0.445,12,16,0.75,8,28,36,65,6,0,29,44,93
2000,Charlie Ward,PG,29,NYK,72,69,1986,189,447,0.423,102,264,0.386,87,183,0.475,0.537,48,58,0.828,22,206,228,300,95,16,102,176,528
2000,Clarence Weatherspoon,PF,29,MIA,78,2,1615,215,419,0.513,0,0,NA,215,419,0.513,0.513,135,183,0.738,128,321,449,93,51,49,100,165,565
2000,Chris Webber,PF,26,SAC,75,75,2880,748,1548,0.483,27,95,0.284,721,1453,0.496,0.492,311,414,0.751,189,598,787,345,120,128,218,264,1834
2000,Bonzi Wells,SF,23,POR,66,0,1162,236,480,0.492,20,53,0.377,216,427,0.506,0.513,88,129,0.682,78,104,182,97,69,12,97,153,580
2000,David Wesley,PG,29,CHH,82,82,2760,407,955,0.426,88,248,0.355,319,707,0.451,0.472,214,275,0.778,39,186,225,463,109,11,159,186,1116
2000,Jahidi White,C,23,WAS,80,59,1537,228,450,0.507,0,0,NA,228,450,0.507,0.507,113,211,0.536,202,351,553,15,31,83,94,234,569
2000,Chris Whitney,PG,28,WAS,82,15,1627,217,521,0.417,96,255,0.376,121,266,0.455,0.509,112,132,0.848,20,114,134,313,55,5,107,166,642
2000,Aaron Williams,PF,28,WAS,81,0,1545,235,450,0.522,0,3,0,235,447,0.526,0.522,146,201,0.726,159,250,409,58,41,92,80,234,616
2000,Alvin Williams,PG,25,TOR,55,28,779,114,287,0.397,16,55,0.291,98,232,0.422,0.425,48,65,0.738,27,58,85,126,34,11,47,78,292
2000,Eric Williams,SF,27,BOS,68,17,1378,165,386,0.427,25,72,0.347,140,314,0.446,0.46,134,169,0.793,55,101,156,93,44,16,66,165,489
2000,Jason Williams,PG,24,SAC,81,81,2760,363,973,0.373,145,505,0.287,218,468,0.466,0.448,128,170,0.753,22,208,230,589,117,8,296,140,999
2000,Jerome Williams,PF,26,DET,82,1,2102,257,456,0.564,0,3,0,257,453,0.567,0.564,175,284,0.616,277,512,789,68,95,21,105,196,689
2000,Lorenzo Williams,PF,30,WAS,8,0,76,7,9,0.778,0,0,NA,7,9,0.778,0.778,0,0,NA,12,13,25,1,3,6,3,13,14
2000,Monty Williams,SF,28,ORL,75,23,1501,263,538,0.489,2,5,0.4,261,533,0.49,0.491,123,166,0.741,96,154,250,106,46,17,109,187,651
2000,Scott Williams,C,31,MIL,68,46,1488,213,426,0.5,0,0,NA,213,426,0.5,0.5,94,129,0.729,177,271,448,28,40,66,65,230,520
2000,Shammond Williams,PG,24,SEA,43,5,517,84,225,0.373,24,81,0.296,60,144,0.417,0.427,33,51,0.647,12,40,52,78,18,0,40,39,225
2000,Walt Williams,SF,29,HOU,76,66,1859,312,681,0.458,102,261,0.391,210,420,0.5,0.533,101,123,0.821,69,237,306,157,49,44,113,190,827
2000,Corliss Williamson,SF,26,SAC,76,76,1707,311,622,0.5,0,0,NA,311,622,0.5,0.5,163,212,0.769,122,168,290,82,38,19,110,192,785
2000,Kevin Willis,PF,37,TOR,79,1,1679,236,569,0.415,1,3,0.333,235,566,0.415,0.416,131,164,0.799,201,281,482,49,36,48,98,256,604
2000,Haywoode Workman,PG,34,MIL,23,1,248,23,62,0.371,11,29,0.379,12,33,0.364,0.46,9,13,0.692,1,16,17,44,11,0,14,23,66
2000,Haywoode Workman,PG,34,TOR,13,1,102,8,28,0.286,3,14,0.214,5,14,0.357,0.339,1,2,0.5,0,9,9,17,9,0,4,14,20
2000,Metta World Peace,SF,20,CHI,72,63,2238,309,759,0.407,60,191,0.314,249,568,0.438,0.447,188,279,0.674,62,246,308,202,119,39,166,159,866
2000,Lorenzen Wright,C,24,ATL,75,0,1205,180,361,0.499,1,3,0.333,179,358,0.5,0.5,87,135,0.644,117,188,305,21,29,40,66,203,448
2001,Tariq Abdul-Wahad,SG,26,DEN,29,12,420,43,111,0.387,4,10,0.4,39,101,0.386,0.405,21,36,0.583,14,45,59,22,14,13,34,54,111
2001,Shareef Abdur-Rahim,SF,24,VAN,81,81,3241,604,1280,0.472,12,64,0.188,592,1216,0.487,0.477,443,531,0.834,175,560,735,250,90,77,231,238,1663
2001,Cory Alexander,PG,27,ORL,26,0,227,18,56,0.321,4,16,0.25,14,40,0.35,0.357,12,18,0.667,0,25,25,36,16,0,25,29,52
2001,Courtney Alexander,PG,23,DAL,38,6,472,62,178,0.348,3,10,0.3,59,168,0.351,0.357,33,45,0.733,20,43,63,21,16,3,21,76,160
2001,Courtney Alexander,PG,23,WAS,27,18,910,177,395,0.448,14,36,0.389,163,359,0.454,0.466,90,105,0.857,22,58,80,41,29,2,54,63,458
2001,Ray Allen,SG,25,MIL,82,82,3129,628,1309,0.48,202,467,0.433,426,842,0.506,0.557,348,392,0.888,101,327,428,374,124,20,204,192,1806
2001,Rafer Alston,PG,24,MIL,37,2,288,30,84,0.357,8,30,0.267,22,54,0.407,0.405,9,13,0.692,4,27,31,68,13,0,20,27,77
2001,Derek Anderson,SG,26,SAS,82,82,2859,413,993,0.416,101,253,0.399,312,740,0.422,0.467,342,402,0.851,75,288,363,301,120,14,165,188,1269
2001,Kenny Anderson,PG,30,BOS,33,28,849,88,227,0.388,11,33,0.333,77,194,0.397,0.412,59,71,0.831,16,57,73,134,44,2,52,62,246
2001,Shandon Anderson,SG,27,HOU,82,82,2396,263,590,0.446,46,170,0.271,217,420,0.517,0.485,138,188,0.734,72,261,333,189,82,40,131,202,710
2001,Greg Anthony,PG,33,POR,58,0,856,97,253,0.383,65,159,0.409,32,94,0.34,0.512,23,35,0.657,21,40,61,82,40,3,43,63,282
2001,Darrell Armstrong,PG,32,ORL,75,75,2767,413,1002,0.412,143,403,0.355,270,599,0.451,0.484,220,249,0.884,94,249,343,524,135,13,200,155,1189
2001,Chucky Atkins,PG,26,DET,81,75,2363,380,952,0.399,121,339,0.357,259,613,0.423,0.463,90,130,0.692,28,145,173,330,67,5,149,184,971
2001,Stacey Augmon,SG,32,POR,66,23,1182,127,266,0.477,0,4,0,127,262,0.485,0.477,57,87,0.655,60,99,159,98,48,21,48,105,311
2001,Isaac Austin,C,31,VAN,52,16,845,96,270,0.356,6,24,0.25,90,246,0.366,0.367,28,40,0.7,50,172,222,58,20,23,54,94,226
2001,Vin Baker,PF,29,SEA,76,27,2129,347,822,0.422,1,16,0.063,346,806,0.429,0.423,232,321,0.723,179,251,430,90,38,73,158,264,927
2001,Brent Barry,SG,29,SEA,67,20,1778,198,401,0.494,109,229,0.476,89,172,0.517,0.63,84,103,0.816,33,178,211,225,80,14,86,126,589
2001,Jon Barry,SG,31,SAC,62,2,1010,103,255,0.404,46,132,0.348,57,123,0.463,0.494,64,73,0.877,16,78,94,130,28,6,53,66,316
2001,Tony Battie,C,24,BOS,40,25,845,108,201,0.537,0,3,0,108,198,0.545,0.537,44,69,0.638,73,160,233,16,27,60,37,126,260
2001,Raja Bell,SG,24,PHI,5,0,30,2,7,0.286,1,3,0.333,1,4,0.25,0.357,0,0,NA,0,1,1,0,1,0,2,1,5
2001,David Benoit,SF,32,UTA,49,2,446,71,147,0.483,5,13,0.385,66,134,0.493,0.5,31,39,0.795,20,61,81,22,6,6,28,75,178
2001,Travis Best,PG,28,IND,77,21,2457,347,788,0.44,37,97,0.381,310,691,0.449,0.464,187,226,0.827,38,184,222,473,110,11,127,246,918
2001,Mike Bibby,PG,22,VAN,82,82,3190,525,1157,0.454,108,285,0.379,417,872,0.478,0.5,143,188,0.761,47,257,304,685,107,12,248,148,1301
2001,Chauncey Billups,SG,24,MIN,77,33,1790,248,587,0.422,73,194,0.376,175,393,0.445,0.485,144,171,0.842,32,126,158,260,51,11,111,178,713
2001,Corie Blount,PF,32,PHO,30,6,387,23,47,0.489,0,0,NA,23,47,0.489,0.489,8,15,0.533,35,50,85,8,13,5,18,75,54
2001,Corie Blount,PF,32,GSW,38,0,918,107,247,0.433,2,8,0.25,105,239,0.439,0.437,43,68,0.632,146,169,315,51,29,17,55,90,259
2001,Mark Blount,C,25,BOS,64,50,1098,101,200,0.505,0,0,NA,101,200,0.505,0.505,46,66,0.697,97,134,231,32,39,76,62,183,248
2001,Muggsy Bogues,PG,36,TOR,3,0,34,0,2,0,0,1,0,0,1,0,0,0,0,NA,0,3,3,5,2,0,4,3,0
2001,Etdrick Bohannon,PF,27,CLE,6,0,19,2,4,0.5,0,0,NA,2,4,0.5,0.5,4,4,1,3,4,7,0,0,2,1,4,8
2001,Calvin Booth,C,24,WAS,40,22,640,74,168,0.44,0,0,NA,74,168,0.44,0.44,33,45,0.733,53,121,174,23,17,81,36,91,181
2001,Calvin Booth,C,24,DAL,15,7,293,46,84,0.548,0,0,NA,46,84,0.548,0.548,20,33,0.606,24,48,72,19,12,30,17,55,112
2001,Bruce Bowen,SF,29,MIA,82,72,2685,211,581,0.363,103,307,0.336,108,274,0.394,0.452,98,161,0.609,45,200,245,132,83,53,74,269,623
2001,Earl Boykins,PG,24,LAC,10,0,149,25,63,0.397,1,8,0.125,24,55,0.436,0.405,14,17,0.824,4,7,11,32,5,0,9,9,65
2001,Shawn Bradley,C,28,DAL,82,35,2001,219,447,0.49,1,6,0.167,218,441,0.494,0.491,140,178,0.787,160,448,608,38,36,228,88,256,579
2001,Terrell Brandon,PG,30,MIN,78,78,2821,511,1134,0.451,33,91,0.363,478,1043,0.458,0.465,195,224,0.871,60,238,298,583,161,21,155,138,1250
2001,Chucky Brown,SF,32,GSW,6,0,74,9,20,0.45,0,2,0,9,18,0.5,0.45,6,10,0.6,3,15,18,5,3,1,2,10,24
2001,Chucky Brown,SF,32,CLE,20,2,265,31,75,0.413,0,1,0,31,74,0.419,0.413,16,24,0.667,5,31,36,6,6,6,6,27,78
2001,Dee Brown,PG,32,ORL,7,0,155,16,44,0.364,12,32,0.375,4,12,0.333,0.5,4,5,0.8,0,11,11,12,4,0,7,10,48
2001,Rick Brunson,PG,28,BOS,7,0,142,10,35,0.286,2,11,0.182,8,24,0.333,0.314,4,9,0.444,2,7,9,24,7,1,9,16,26
2001,Rick Brunson,PG,28,NYK,15,0,66,8,19,0.421,0,3,0,8,16,0.5,0.421,4,6,0.667,3,9,12,7,1,0,8,5,20
2001,Mark Bryant,PF,35,DAL,18,1,101,8,20,0.4,0,0,NA,8,20,0.4,0.4,3,5,0.6,4,17,21,3,1,2,5,29,19
2001,Jud Buechler,SF,32,DET,57,3,737,76,164,0.463,32,77,0.416,44,87,0.506,0.561,9,12,0.75,20,74,94,39,21,10,25,83,193
2001,Scott Burrell,SF,30,CHH,4,0,41,7,15,0.467,2,6,0.333,5,9,0.556,0.533,1,4,0.25,1,2,3,1,3,0,0,8,17
2001,Jason Caffey,PF,27,MIL,70,33,1460,179,367,0.488,0,0,NA,179,367,0.488,0.488,142,211,0.673,135,218,353,53,38,25,77,184,500
2001,Marcus Camby,C,26,NYK,63,63,2127,304,580,0.524,1,8,0.125,303,572,0.53,0.525,150,225,0.667,196,527,723,52,66,136,63,205,759
2001,Elden Campbell,PF,32,CHH,78,78,2337,367,834,0.44,0,6,0,367,828,0.443,0.44,288,406,0.709,157,451,608,104,60,140,144,280,1022
2001,Chris Carr,SG,26,BOS,35,0,309,53,112,0.473,17,37,0.459,36,75,0.48,0.549,46,60,0.767,11,33,44,11,4,3,19,45,169
2001,Anthony Carter,PG,25,MIA,72,6,1630,195,480,0.406,6,40,0.15,189,440,0.43,0.413,65,103,0.631,46,134,180,268,73,10,119,154,461
2001,Vince Carter,SF,24,TOR,75,75,2979,762,1656,0.46,162,397,0.408,600,1259,0.477,0.509,384,502,0.765,176,240,416,291,114,82,167,205,2070
2001,Sam Cassell,PG,31,MIL,76,75,2709,537,1132,0.474,30,98,0.306,507,1034,0.49,0.488,277,323,0.858,46,244,290,580,88,8,220,214,1381
2001,Kelvin Cato,C,26,HOU,35,13,624,64,111,0.577,0,0,NA,64,111,0.577,0.577,37,57,0.649,47,94,141,11,13,31,25,89,165
2001,Cedric Ceballos,SF,31,DET,13,0,166,28,71,0.394,11,40,0.275,17,31,0.548,0.472,8,10,0.8,7,19,26,7,6,3,9,19,75
2001,Cedric Ceballos,SF,31,MIA,27,0,393,73,158,0.462,11,33,0.333,62,125,0.496,0.497,29,33,0.879,27,53,80,13,10,4,23,42,186
2001,Chris Childs,PG,33,NYK,51,5,1309,93,222,0.419,20,64,0.313,73,158,0.462,0.464,39,46,0.848,14,124,138,236,37,7,98,160,245
2001,Chris Childs,PG,33,TOR,26,0,550,42,113,0.372,12,42,0.286,30,71,0.423,0.425,21,25,0.84,10,54,64,119,22,8,58,82,117
2001,Doug Christie,SG,30,SAC,81,81,2939,311,788,0.395,94,250,0.376,217,538,0.403,0.454,280,312,0.897,95,260,355,289,183,45,154,224,996
2001,Keon Clark,PF,25,DEN,35,3,752,82,199,0.412,0,0,NA,82,199,0.412,0.412,63,105,0.6,58,128,186,34,16,44,48,101,227
2001,Keon Clark,PF,25,TOR,46,0,968,167,320,0.522,0,1,0,167,319,0.524,0.522,79,135,0.585,78,170,248,38,16,110,42,143,413
2001,Bimbo Coles,PG,32,CLE,47,0,804,91,239,0.381,2,16,0.125,89,223,0.399,0.385,48,56,0.857,9,39,48,138,27,6,59,87,232
2001,Sean Colson,PG,25,ATL,3,0,14,0,5,0,0,1,0,0,4,0,0,0,0,NA,0,3,3,3,0,0,2,0,0
2001,Sean Colson,PG,25,HOU,10,0,30,6,19,0.316,1,4,0.25,5,15,0.333,0.342,2,4,0.5,2,1,3,7,1,0,0,6,15
2001,Tyrone Corbin,SF,38,TOR,15,1,117,9,38,0.237,0,5,0,9,33,0.273,0.237,2,4,0.5,3,10,13,4,2,0,3,18,20
2001,Jamal Crawford,PG,20,CHI,61,8,1050,107,304,0.352,41,117,0.35,66,187,0.353,0.419,27,34,0.794,9,80,89,141,43,14,85,68,282
2001,Austin Croshere,PF,25,IND,81,23,1874,276,701,0.394,70,207,0.338,206,494,0.417,0.444,200,231,0.866,123,264,387,92,36,50,136,180,822
2001,John Crotty,PG,31,UTA,31,0,264,22,65,0.338,4,7,0.571,18,58,0.31,0.369,17,19,0.895,13,15,28,34,6,0,19,32,65
2001,Bill Curley,PF,28,DAL,5,0,15,1,4,0.25,0,1,0,1,3,0.333,0.25,1,4,0.25,0,0,0,0,1,1,2,4,3
2001,Bill Curley,PF,28,GSW,15,2,177,24,43,0.558,1,1,1,23,42,0.548,0.57,11,15,0.733,21,16,37,3,6,8,14,41,60
2001,Michael Curry,SG,32,DET,68,58,1485,145,319,0.455,4,9,0.444,141,310,0.455,0.461,62,73,0.849,21,100,121,132,27,3,61,173,356
2001,Antonio Daniels,PG,25,SAS,79,23,2060,275,588,0.468,74,183,0.404,201,405,0.496,0.531,121,156,0.776,26,137,163,304,61,14,109,120,745
2001,Kornél Dávid,SF,29,TOR,17,0,140,15,29,0.517,0,0,NA,15,29,0.517,0.517,12,13,0.923,9,24,33,4,2,3,7,20,42
2001,Kornél Dávid,SF,29,DET,10,0,69,10,22,0.455,0,0,NA,10,22,0.455,0.455,0,0,NA,6,13,19,3,4,1,4,8,20
2001,Antonio Davis,C,32,TOR,78,77,2729,375,866,0.433,0,1,0,375,865,0.434,0.433,319,423,0.754,274,513,787,106,22,151,135,230,1069
2001,Baron Davis,PG,21,CHH,82,82,3192,409,957,0.427,85,274,0.31,324,683,0.474,0.472,228,337,0.677,129,279,408,598,170,36,226,267,1131
2001,Dale Davis,C,31,POR,81,43,2162,242,487,0.497,0,4,0,242,483,0.501,0.497,96,152,0.632,233,373,606,103,44,76,67,199,580
2001,Hubert Davis,PG,30,DAL,51,7,1261,139,314,0.443,58,133,0.436,81,181,0.448,0.535,35,41,0.854,18,91,109,61,29,1,56,92,371
2001,Hubert Davis,PG,30,WAS,15,11,431,57,119,0.479,20,38,0.526,37,81,0.457,0.563,19,21,0.905,10,20,30,49,6,0,25,29,153
2001,Ricky Davis,SG,21,MIA,7,0,70,12,29,0.414,1,1,1,11,28,0.393,0.431,7,8,0.875,1,6,7,11,5,2,5,7,32
2001,Todd Day,SG,31,MIN,31,0,345,44,118,0.373,26,69,0.377,18,49,0.367,0.483,18,23,0.783,10,27,37,28,10,7,24,52,132
2001,Andrew DeClercq,C,27,ORL,67,51,903,107,193,0.554,0,0,NA,107,193,0.554,0.554,47,82,0.573,91,145,236,32,41,33,51,198,261
2001,Vinny Del Negro,PG,34,GSW,29,1,396,30,90,0.333,1,9,0.111,29,81,0.358,0.339,16,16,1,4,27,31,62,6,0,15,36,77
2001,Vinny Del Negro,PG,34,PHO,36,0,526,76,144,0.528,0,4,0,76,140,0.543,0.528,25,28,0.893,8,43,51,64,20,3,19,42,177
2001,Tony Delk,SG,27,PHO,82,11,2288,383,923,0.415,54,168,0.321,329,755,0.436,0.444,185,235,0.787,76,185,261,160,75,17,101,171,1005
2001,Derrick Dial,SG,25,SAS,33,0,207,36,83,0.434,2,10,0.2,34,73,0.466,0.446,12,21,0.571,12,26,38,21,4,6,12,22,86
2001,Michael Doleac,C,23,ORL,77,21,1398,220,527,0.417,0,3,0,220,524,0.42,0.417,50,59,0.847,70,203,273,65,37,41,59,239,490
2001,Sherman Douglas,PG,34,NJN,59,7,1094,122,303,0.403,8,40,0.2,114,263,0.433,0.416,86,115,0.748,21,53,74,144,36,4,79,93,338
2001,Chris Dudley,C,35,PHO,53,33,613,29,73,0.397,0,0,NA,29,73,0.397,0.397,14,36,0.389,64,119,183,18,14,29,26,111,72
2001,Kevin Edwards,SG,35,VAN,46,5,634,56,170,0.329,5,19,0.263,51,151,0.338,0.344,43,53,0.811,23,59,82,52,29,8,37,46,160
2001,Howard Eisley,SG,28,DAL,82,40,2426,265,675,0.393,107,269,0.398,158,406,0.389,0.472,104,126,0.825,23,174,197,295,99,12,102,218,741
2001,Obinna Ekezie,PF,25,WAS,29,0,273,32,77,0.416,0,0,NA,32,77,0.416,0.416,37,53,0.698,31,45,76,9,5,5,14,46,101
2001,Obinna Ekezie,PF,25,DAL,4,0,8,0,4,0,0,0,NA,0,4,0,0,0,0,NA,0,2,2,0,0,0,0,2,0
2001,Mario Elie,SG,37,PHO,68,67,1506,104,246,0.423,36,100,0.36,68,146,0.466,0.496,55,69,0.797,38,117,155,131,58,12,60,112,299
2001,Jamie Feick,C,26,NJN,6,0,149,8,23,0.348,0,0,NA,8,23,0.348,0.348,6,12,0.5,12,44,56,5,8,3,7,15,22
2001,Michael Finley,SF,27,DAL,82,82,3443,711,1552,0.458,91,263,0.346,620,1289,0.481,0.487,252,325,0.775,109,316,425,360,118,32,190,174,1765
2001,Derek Fisher,PG,26,LAL,20,20,709,77,187,0.412,25,63,0.397,52,124,0.419,0.479,50,62,0.806,5,54,59,87,39,2,29,50,229
2001,Greg Foster,C,32,LAL,62,8,451,56,133,0.421,3,9,0.333,53,124,0.427,0.432,10,14,0.714,29,83,112,32,9,12,25,76,125
2001,Adonal Foyle,C,25,GSW,58,37,1457,156,375,0.416,0,0,NA,156,375,0.416,0.416,30,68,0.441,156,249,405,48,31,156,79,136,342
2001,Steve Francis,PG,23,HOU,80,79,3194,550,1219,0.451,133,336,0.396,417,883,0.472,0.506,358,438,0.817,190,363,553,517,141,31,265,274,1591
2001,Rubén Garcés,PF,27,PHO,10,0,62,7,15,0.467,0,0,NA,7,15,0.467,0.467,2,8,0.25,12,10,22,4,2,1,5,14,16
2001,Rubén Garcés,PF,27,GSW,3,0,11,0,7,0,0,0,NA,0,7,0,0,0,0,NA,4,3,7,1,1,1,0,0,0
2001,Kevin Garnett,PF,24,MIN,81,81,3202,704,1475,0.477,19,66,0.288,685,1409,0.486,0.484,357,467,0.764,219,702,921,401,111,145,230,204,1784
2001,Dean Garrett,C,34,MIN,70,21,831,75,156,0.481,0,0,NA,75,156,0.481,0.481,27,39,0.692,65,152,217,24,26,49,25,93,177
2001,Chris Gatling,PF,33,CLE,74,6,1670,329,733,0.449,28,92,0.304,301,641,0.47,0.468,156,228,0.684,99,292,391,61,52,27,119,185,842
2001,Eddie Gill,PG,22,NJN,8,0,152,16,41,0.39,3,9,0.333,13,32,0.406,0.427,4,5,0.8,0,9,9,24,4,1,10,9,39
2001,Kendall Gill,SG,32,NJN,31,26,892,107,323,0.331,4,14,0.286,103,309,0.333,0.337,65,90,0.722,32,99,131,87,47,7,48,64,283
2001,Dion Glover,SG,22,ATL,57,7,929,141,336,0.42,9,46,0.196,132,290,0.455,0.433,47,69,0.681,39,92,131,69,49,10,54,92,338
2001,Anthony Goldwire,PG,29,DEN,20,0,201,30,80,0.375,9,34,0.265,21,46,0.457,0.431,13,17,0.765,1,11,12,34,9,0,15,13,82
2001,A.C. Green,PF,37,MIA,82,1,1411,144,324,0.444,0,6,0,144,318,0.453,0.444,79,111,0.712,107,206,313,39,30,8,45,119,367
2001,Adrian Griffin,SF,26,BOS,44,0,377,33,97,0.34,9,26,0.346,24,71,0.338,0.387,18,24,0.75,27,60,87,27,18,5,18,45,93
2001,Tom Gugliotta,PF,31,PHO,57,2,1159,149,380,0.392,3,12,0.25,146,368,0.397,0.396,61,77,0.792,76,179,255,55,47,21,51,110,362
2001,Darvin Ham,SF,27,MIL,29,13,540,39,80,0.488,2,3,0.667,37,77,0.481,0.5,29,49,0.592,56,65,121,25,17,21,33,85,109
2001,Zendon Hamilton,C,25,LAC,3,0,19,2,9,0.222,0,0,NA,2,9,0.222,0.222,5,8,0.625,3,5,8,0,0,0,2,4,9
2001,Tom Hammonds,PF,33,MIN,7,0,30,3,10,0.3,0,0,NA,3,10,0.3,0.3,1,2,0.5,2,2,4,1,0,0,3,8,7
2001,Anfernee Hardaway,SG,29,PHO,4,4,112,15,36,0.417,2,8,0.25,13,28,0.464,0.444,7,11,0.636,5,13,18,15,6,1,3,6,39
2001,Tim Hardaway,PG,34,MIA,77,77,2613,408,1042,0.392,189,517,0.366,219,525,0.417,0.482,145,181,0.801,26,178,204,483,90,6,189,155,1150
2001,Ron Harper,PG,37,LAL,47,46,1139,127,271,0.469,19,72,0.264,108,199,0.543,0.504,34,48,0.708,46,120,166,113,39,25,62,70,307
2001,Al Harrington,PF,20,IND,78,38,1892,241,543,0.444,1,7,0.143,240,536,0.448,0.445,103,157,0.656,119,262,381,130,63,18,148,223,586
2001,Othella Harrington,C,27,VAN,44,40,1267,180,386,0.466,0,3,0,180,383,0.47,0.466,120,154,0.779,102,187,289,36,19,26,104,136,480
2001,Othella Harrington,C,27,NYK,30,5,548,67,121,0.554,0,0,NA,67,121,0.554,0.554,51,70,0.729,37,62,99,20,15,19,41,101,185
2001,Jason Hart,PG,22,MIL,1,0,10,1,1,1,0,0,NA,1,1,1,1,0,0,NA,0,0,0,1,0,0,2,0,2
2001,Antonio Harvey,PF,30,POR,12,0,72,13,28,0.464,0,0,NA,13,28,0.464,0.464,5,6,0.833,5,9,14,4,1,6,3,10,31
2001,Donnell Harvey,PF,20,DAL,18,0,65,8,14,0.571,0,0,NA,8,14,0.571,0.571,6,16,0.375,6,14,20,2,3,1,7,15,22
2001,Tyrone Hill,PF,32,PHI,76,75,2363,278,587,0.474,0,1,0,278,586,0.474,0.474,172,273,0.63,239,448,687,48,37,27,127,242,728
2001,Robert Horry,PF,30,LAL,79,1,1587,147,380,0.387,54,156,0.346,93,224,0.415,0.458,59,83,0.711,93,203,296,128,54,54,79,210,407
2001,Eddie House,PG,22,MIA,50,0,550,104,247,0.421,19,55,0.345,85,192,0.443,0.46,24,35,0.686,5,37,42,52,13,0,35,58,251
2001,Juwan Howard,PF,27,WAS,54,54,1981,392,827,0.474,0,0,NA,392,827,0.474,0.474,197,256,0.77,121,258,379,154,46,21,169,186,981
2001,Juwan Howard,PF,27,DAL,27,27,993,191,391,0.488,0,3,0,191,388,0.492,0.488,99,127,0.78,50,143,193,70,29,16,73,106,481
2001,Larry Hughes,SG,22,GSW,50,45,1846,308,805,0.383,14,75,0.187,294,730,0.403,0.391,193,252,0.766,76,200,276,223,96,29,152,147,823
2001,Allen Iverson,SG,25,PHI,71,71,2979,762,1813,0.42,98,306,0.32,664,1507,0.441,0.447,585,719,0.814,50,223,273,325,178,20,237,147,2207
2001,Bobby Jackson,PG,27,SAC,79,7,1648,231,526,0.439,39,104,0.375,192,422,0.455,0.476,65,88,0.739,74,172,246,161,87,7,103,139,566
2001,Jim Jackson,SF,30,ATL,17,14,550,77,217,0.355,16,38,0.421,61,179,0.341,0.392,73,85,0.859,17,62,79,50,19,4,48,42,243
2001,Jim Jackson,SF,30,CLE,39,26,1140,162,415,0.39,10,42,0.238,152,373,0.408,0.402,66,84,0.786,36,109,145,113,34,6,82,97,400
2001,Marc Jackson,C,26,GSW,48,35,1410,237,508,0.467,5,23,0.217,232,485,0.478,0.471,154,192,0.802,119,242,361,59,34,27,93,138,633
2001,Mark Jackson,PG,35,TOR,54,54,1802,170,403,0.422,57,165,0.345,113,238,0.475,0.493,64,76,0.842,42,143,185,498,63,7,117,83,461
2001,Mark Jackson,PG,35,NYK,29,28,786,74,180,0.411,13,42,0.31,61,138,0.442,0.447,9,17,0.529,21,99,120,163,21,0,58,56,170
2001,Stephen Jackson,SF,22,NJN,77,40,1660,243,572,0.425,52,155,0.335,191,417,0.458,0.47,97,135,0.719,41,167,208,140,86,14,130,166,635
2001,Sam Jacobson,PG,25,MIN,14,0,59,9,18,0.5,0,0,NA,9,18,0.5,0.5,2,3,0.667,3,3,6,4,3,0,0,19,20
2001,Antawn Jamison,SF,24,GSW,82,82,3394,800,1812,0.442,62,205,0.302,738,1607,0.459,0.459,382,534,0.715,280,435,715,164,114,28,199,225,2044
2001,Anthony Johnson,PG,26,ATL,25,0,279,26,71,0.366,0,3,0,26,68,0.382,0.366,12,17,0.706,3,20,23,34,17,5,20,41,64
2001,Anthony Johnson,PG,26,CLE,28,0,232,27,81,0.333,1,2,0.5,26,79,0.329,0.34,11,16,0.688,7,14,21,44,6,1,14,21,66
2001,Avery Johnson,PG,35,SAS,55,20,1290,134,300,0.447,1,6,0.167,133,294,0.452,0.448,41,60,0.683,21,64,85,237,33,4,60,90,310
2001,Damon Jones,PG,24,VAN,71,10,1415,170,416,0.409,84,231,0.364,86,185,0.465,0.51,37,52,0.712,16,108,124,224,36,1,76,58,461
2001,Eddie Jones,SG,29,MIA,63,58,2282,388,871,0.445,90,238,0.378,298,633,0.471,0.497,228,270,0.844,75,217,292,171,110,58,135,183,1094
2001,Garth Joseph,C,27,TOR,2,0,8,1,2,0.5,0,0,NA,1,2,0.5,0.5,0,0,NA,2,0,2,1,0,0,1,1,2
2001,Garth Joseph,C,27,DEN,2,0,8,0,3,0,0,0,NA,0,3,0,0,0,2,0,0,0,0,0,0,1,1,0,0
2001,Steve Kerr,PG,35,SAS,55,1,650,67,159,0.421,33,77,0.429,34,82,0.415,0.525,14,15,0.933,6,29,35,57,16,1,21,30,181
2001,Lari Ketner,PF,23,IND,3,0,7,0,0,NA,0,0,NA,0,0,NA,NA,0,0,NA,0,0,0,1,0,0,2,0,0
2001,Jason Kidd,PG,27,PHO,77,76,3065,451,1097,0.411,69,232,0.297,382,865,0.442,0.443,328,403,0.814,91,403,494,753,166,23,286,171,1299
2001,Brevin Knight,PG,25,CLE,6,0,93,2,15,0.133,0,0,NA,2,15,0.133,0.133,5,6,0.833,1,6,7,25,6,1,7,17,9
2001,Brevin Knight,PG,25,ATL,47,43,1364,137,356,0.385,1,10,0.1,136,346,0.393,0.386,49,60,0.817,22,139,161,286,95,3,84,138,324
2001,Toni Kukoč,SF,32,PHI,48,5,979,151,330,0.458,32,78,0.41,119,252,0.472,0.506,52,88,0.591,47,115,162,93,35,6,60,62,386
2001,Toni Kukoč,SF,32,ATL,17,14,618,124,252,0.492,38,79,0.481,86,173,0.497,0.567,49,72,0.681,19,78,97,106,13,5,51,36,335
2001,Christian Laettner,C,31,DAL,53,35,930,165,323,0.511,1,3,0.333,164,320,0.513,0.512,67,82,0.817,75,137,212,67,40,27,70,159,398
2001,Christian Laettner,PF,31,WAS,25,13,733,112,228,0.491,3,10,0.3,109,218,0.5,0.498,103,122,0.844,43,110,153,57,31,19,67,83,330
2001,Raef LaFrentz,C,24,DEN,78,74,2457,387,812,0.477,51,139,0.367,336,673,0.499,0.508,183,262,0.698,173,434,607,107,37,206,97,290,1008
2001,Dan Langhi,SF,23,HOU,33,0,241,37,99,0.374,0,1,0,37,98,0.378,0.374,16,29,0.552,13,28,41,4,7,1,8,16,90
2001,Voshon Lenard,SG,27,DEN,80,58,2331,336,846,0.397,147,382,0.385,189,464,0.407,0.484,153,192,0.797,47,184,231,190,65,18,102,170,972
2001,Rashard Lewis,PF,21,SEA,78,78,2720,426,887,0.48,123,285,0.432,303,602,0.503,0.55,176,213,0.826,143,398,541,125,91,45,129,191,1151
2001,Art Long,PF,28,SAC,9,0,20,0,4,0,0,0,NA,0,4,0,0,0,2,0,2,6,8,1,0,3,2,5,0
2001,Grant Long,PF,34,VAN,66,27,1507,140,319,0.439,4,15,0.267,136,304,0.447,0.445,112,157,0.713,76,198,274,83,72,15,62,160,396
2001,Luc Longley,C,32,NYK,25,2,301,18,54,0.333,0,0,NA,18,54,0.333,0.333,13,17,0.765,26,40,66,7,3,9,22,51,49
2001,Felipe López,SG,26,WAS,47,38,1108,142,326,0.436,6,29,0.207,136,297,0.458,0.445,90,123,0.732,30,130,160,73,41,18,56,110,380
2001,Felipe López,PG,26,MIN,23,10,457,69,152,0.454,13,23,0.565,56,129,0.434,0.497,19,33,0.576,25,49,74,34,21,12,27,46,170
2001,Tyronn Lue,PG,23,LAL,38,1,468,50,117,0.427,11,34,0.324,39,83,0.47,0.474,19,24,0.792,5,27,32,45,19,0,27,54,130
2001,Jamaal Magloire,C,22,CHH,74,0,1095,122,271,0.45,0,2,0,122,269,0.454,0.45,95,145,0.655,103,192,295,27,18,78,61,139,339
2001,Danny Manning,PF,34,UTA,82,0,1305,247,500,0.494,7,28,0.25,240,472,0.508,0.501,102,140,0.729,66,148,214,92,47,29,96,219,603
2001,Stephon Marbury,PG,23,NJN,67,67,2557,563,1277,0.441,110,335,0.328,453,942,0.481,0.484,362,458,0.79,53,152,205,506,79,5,197,150,1598
2001,Shawn Marion,SF,22,PHO,79,79,2857,557,1160,0.48,21,82,0.256,536,1078,0.497,0.489,234,289,0.81,220,628,848,160,132,108,129,211,1369
2001,Donyell Marshall,SF,27,UTA,81,49,2326,427,849,0.503,41,128,0.32,386,721,0.535,0.527,205,273,0.751,172,394,566,133,85,78,128,196,1100
2001,Darrick Martin,PG,29,SAC,31,0,176,29,76,0.382,14,27,0.519,15,49,0.306,0.474,31,35,0.886,2,14,16,14,7,0,10,27,103
2001,Jamal Mashburn,SF,28,CHH,76,76,2989,573,1388,0.413,103,289,0.356,470,1099,0.428,0.45,279,364,0.766,92,484,576,411,85,13,211,185,1528
2001,Desmond Mason,SF,23,SEA,78,14,1522,189,439,0.431,18,67,0.269,171,372,0.46,0.451,67,91,0.736,72,177,249,63,39,20,53,146,463
2001,Tony Massenburg,PF,33,VAN,52,20,823,92,199,0.462,0,0,NA,92,199,0.462,0.462,49,70,0.7,75,135,210,9,10,28,48,122,233
2001,Vernon Maxwell,PG,35,PHI,24,6,375,42,125,0.336,21,64,0.328,21,61,0.344,0.42,15,22,0.682,3,34,37,29,12,0,18,33,120
2001,Vernon Maxwell,PG,35,DAL,19,0,285,31,98,0.316,13,47,0.277,18,51,0.353,0.383,6,10,0.6,1,28,29,20,9,3,17,31,81
2001,Walter McCarty,PF,26,BOS,60,3,478,45,126,0.357,19,56,0.339,26,70,0.371,0.433,22,28,0.786,24,57,81,39,14,7,20,82,131
2001,George McCloud,SF,33,DEN,76,8,2007,250,655,0.382,77,234,0.329,173,421,0.411,0.44,152,181,0.84,55,169,224,279,53,27,117,165,729
2001,Antonio McDyess,PF,26,DEN,70,70,2555,577,1165,0.495,0,0,NA,577,1165,0.495,0.495,304,434,0.7,240,605,845,146,43,102,162,220,1458
2001,Tracy McGrady,SG,21,ORL,77,77,3087,788,1724,0.457,59,166,0.355,729,1558,0.468,0.474,430,587,0.733,192,388,580,352,116,118,198,160,2065
2001,Jeff McInnis,PG,26,LAC,81,81,2831,432,933,0.463,52,144,0.361,380,789,0.482,0.491,130,161,0.807,41,179,220,447,75,7,113,199,1046
2001,Aaron McKie,SG,28,PHI,76,33,2394,338,714,0.473,53,170,0.312,285,544,0.524,0.511,149,194,0.768,33,278,311,377,106,8,203,178,878
2001,Roshown McLeod,SF,25,ATL,34,25,907,144,330,0.436,2,21,0.095,142,309,0.46,0.439,45,51,0.882,37,81,118,58,23,8,57,88,335
2001,Roshown McLeod,SF,25,PHI,1,0,15,1,2,0.5,0,1,0,1,1,1,0.5,0,0,NA,1,1,2,0,0,0,1,2,2
2001,Paul McPherson,PG,22,PHO,33,0,308,47,96,0.49,0,6,0,47,90,0.522,0.49,18,24,0.75,20,28,48,16,12,3,23,48,112
2001,Paul McPherson,PG,22,GSW,22,0,287,62,120,0.517,2,6,0.333,60,114,0.526,0.525,24,34,0.706,20,11,31,22,13,1,24,32,150
2001,Ron Mercer,SG,24,CHI,61,61,2535,500,1121,0.446,14,46,0.304,486,1075,0.452,0.452,188,228,0.825,72,164,236,201,78,27,129,148,1202
2001,Chris Mihm,C,21,CLE,59,43,1166,173,391,0.442,0,1,0,173,390,0.444,0.442,100,126,0.794,106,174,280,16,20,53,80,156,446
2001,Darius Miles,SF,19,LAC,81,21,2133,318,630,0.505,1,19,0.053,317,611,0.519,0.506,124,238,0.521,127,350,477,99,51,125,147,191,761
2001,Andre Miller,PG,24,CLE,82,82,2848,452,999,0.452,17,64,0.266,435,935,0.465,0.461,375,450,0.833,94,266,360,657,119,28,265,229,1296
2001,Anthony Miller,PF,29,ATL,2,0,6,1,2,0.5,0,0,NA,1,2,0.5,0.5,0,0,NA,0,2,2,0,0,0,1,0,2
2001,Anthony Miller,PF,29,HOU,1,0,3,0,0,NA,0,0,NA,0,0,NA,NA,0,0,NA,0,0,0,0,0,0,0,1,0
2001,Anthony Miller,PF,29,PHI,1,0,2,0,0,NA,0,0,NA,0,0,NA,NA,0,0,NA,0,0,0,0,0,0,0,0,0
2001,Brad Miller,C,24,CHI,57,45,1434,168,386,0.435,1,5,0.2,167,381,0.438,0.437,168,226,0.743,144,275,419,107,33,38,73,176,505
2001,Mike Miller,SF,20,ORL,82,62,2390,368,845,0.436,148,364,0.407,220,481,0.457,0.523,91,128,0.711,66,261,327,140,51,19,97,200,975
2001,Terry Mills,PF,33,IND,14,0,113,11,34,0.324,3,17,0.176,8,17,0.471,0.368,0,0,NA,4,17,21,5,3,1,10,20,25
2001,Cuttino Mobley,SG,25,HOU,79,49,3002,527,1214,0.434,90,252,0.357,437,962,0.454,0.471,394,474,0.831,83,314,397,195,84,26,165,169,1538
2001,Nazr Mohammed,C,23,PHI,30,3,196,41,88,0.466,0,0,NA,41,88,0.466,0.466,14,28,0.5,18,37,55,2,6,7,9,40,96
2001,Nazr Mohammed,C,23,ATL,28,19,716,135,281,0.48,0,1,0,135,280,0.482,0.48,75,98,0.765,97,155,252,17,23,28,55,73,345
2001,Jérôme Moïso,C,22,BOS,24,0,135,12,30,0.4,0,1,0,12,29,0.414,0.4,11,26,0.423,12,30,42,3,3,4,18,29,35
2001,Eric Montross,C,29,DET,42,20,568,50,121,0.413,0,0,NA,50,121,0.413,0.413,7,26,0.269,43,101,144,15,8,23,37,100,107
2001,Eric Montross,C,29,TOR,12,1,81,6,17,0.353,0,0,NA,6,17,0.353,0.353,1,5,0.2,9,20,29,4,3,3,4,15,13
2001,Mikki Moore,C,25,DET,81,2,1154,132,268,0.493,0,1,0,132,267,0.494,0.493,95,130,0.731,121,195,316,33,24,61,74,202,359
2001,Alonzo Mourning,C,30,MIA,13,3,306,73,141,0.518,0,1,0,73,140,0.521,0.518,31,55,0.564,35,66,101,12,4,31,28,24,177
2001,Tracy Murray,SF,29,DEN,13,0,135,17,55,0.309,7,23,0.304,10,32,0.313,0.373,9,10,0.9,4,18,22,9,4,1,6,8,50
2001,Tracy Murray,SF,29,TOR,38,1,453,77,193,0.399,29,80,0.363,48,113,0.425,0.474,24,32,0.75,18,41,59,14,8,6,20,45,207
2001,Dikembe Mutombo,C,34,ATL,49,49,1716,169,354,0.477,0,0,NA,169,354,0.477,0.477,107,154,0.695,188,505,693,54,20,137,92,139,445
2001,Dikembe Mutombo,C,34,PHI,26,26,875,100,202,0.495,0,0,NA,100,202,0.495,0.495,104,137,0.759,119,203,322,22,9,66,52,65,304
2001,Mamadou N'Diaye,C,25,TOR,3,0,10,1,4,0.25,0,0,NA,1,4,0.25,0.25,2,2,1,1,1,2,0,0,0,0,3,4
2001,Lee Nailon,SF,25,CHH,42,0,469,66,136,0.485,0,1,0,66,135,0.489,0.485,32,43,0.744,29,63,92,24,9,5,27,60,164
2001,Eduardo Nájera,PF,24,DAL,40,4,431,58,111,0.523,1,3,0.333,57,108,0.528,0.527,14,33,0.424,41,54,95,27,13,8,17,48,131
2001,Tyrone Nesby,SG,25,LAC,14,12,333,40,123,0.325,10,46,0.217,30,77,0.39,0.366,18,23,0.783,16,26,42,11,10,4,10,28,108
2001,Tyrone Nesby,SF,25,WAS,48,22,1223,149,407,0.366,39,134,0.291,110,273,0.403,0.414,67,83,0.807,35,96,131,65,41,16,55,127,404
2001,Ira Newble,SF,26,SAS,27,6,184,21,55,0.382,4,9,0.444,17,46,0.37,0.418,8,16,0.5,13,22,35,6,2,4,7,18,54
2001,Johnny Newman,SG,37,NJN,82,17,2049,291,695,0.419,59,176,0.335,232,519,0.447,0.461,254,297,0.855,34,142,176,115,63,10,106,229,895
2001,Moochie Norris,PG,27,HOU,82,6,1654,184,413,0.446,25,89,0.281,159,324,0.491,0.476,151,194,0.778,44,154,198,283,69,2,107,84,544
2001,Jermaine O'Neal,C,22,IND,81,80,2641,404,868,0.465,0,5,0,404,863,0.468,0.465,233,388,0.601,249,545,794,98,49,228,161,280,1041
2001,Shaquille O'Neal,C,28,LAL,74,74,2924,813,1422,0.572,0,2,0,813,1420,0.573,0.572,499,972,0.513,291,649,940,277,47,204,218,256,2125
2001,Kevin Ollie,PG,28,NJN,19,0,161,5,27,0.185,0,0,NA,5,27,0.185,0.185,12,19,0.632,3,20,23,25,5,0,9,14,22
2001,Kevin Ollie,PG,28,PHI,51,4,764,71,165,0.43,1,3,0.333,70,162,0.432,0.433,51,70,0.729,13,59,72,121,25,1,40,70,194
2001,Michael Olowokandi,C,25,LAC,82,82,2127,308,708,0.435,0,0,NA,308,708,0.435,0.435,85,156,0.545,168,357,525,46,30,108,169,250,701
2001,Bo Outlaw,PF,29,ORL,80,69,2534,226,368,0.614,1,2,0.5,225,366,0.615,0.615,129,225,0.573,211,408,619,225,105,137,141,241,582
2001,Doug Overton,PG,31,BOS,7,1,144,15,44,0.341,1,4,0.25,14,40,0.35,0.352,7,11,0.636,3,12,15,19,4,0,13,15,38
2001,Doug Overton,PG,31,CHH,2,0,15,2,2,1,0,0,NA,2,2,1,1,0,0,NA,0,0,0,0,1,0,3,2,4
2001,Doug Overton,PG,31,NJN,12,9,316,35,93,0.376,10,32,0.313,25,61,0.41,0.43,3,5,0.6,1,23,24,53,3,0,15,20,83
2001,Billy Owens,PF,31,DET,45,14,793,88,230,0.383,3,20,0.15,85,210,0.405,0.389,19,40,0.475,84,121,205,55,32,12,39,93,198
2001,Robert Pack,PG,31,DEN,74,11,1260,181,426,0.425,12,31,0.387,169,395,0.428,0.439,105,137,0.766,30,107,137,293,65,1,135,114,479
2001,Scott Padgett,PF,24,UTA,27,0,127,18,43,0.419,5,9,0.556,13,34,0.382,0.477,15,20,0.75,19,20,39,5,6,3,10,21,56
2001,Milt Palacio,PG,22,BOS,58,6,1141,126,267,0.472,12,36,0.333,114,231,0.494,0.494,78,92,0.848,25,77,102,151,48,0,80,83,342
2001,Cherokee Parks,C,28,WAS,13,0,178,18,38,0.474,0,0,NA,18,38,0.474,0.474,12,17,0.706,13,27,40,7,6,11,10,20,48
2001,Cherokee Parks,C,28,LAC,52,31,876,116,236,0.492,0,6,0,116,230,0.504,0.492,19,27,0.704,58,131,189,39,19,25,31,102,251
2001,Ruben Patterson,SF,25,SEA,76,22,2059,370,749,0.494,2,36,0.056,368,713,0.516,0.495,246,361,0.681,183,199,382,161,103,45,155,176,988
2001,Gary Payton,PG,32,SEA,79,79,3244,725,1591,0.456,102,272,0.375,623,1319,0.472,0.488,271,354,0.766,73,288,361,642,127,26,209,184,1823
2001,Anthony Peeler,SG,31,MIN,75,41,2126,308,732,0.421,100,256,0.391,208,476,0.437,0.489,75,87,0.862,44,148,192,192,91,18,105,166,791
2001,Sam Perkins,PF,39,IND,64,41,999,86,226,0.381,38,110,0.345,48,116,0.414,0.465,32,38,0.842,32,136,168,41,33,18,19,61,242
2001,Elliot Perry,PG,31,ORL,6,0,39,5,11,0.455,0,1,0,5,10,0.5,0.455,0,0,NA,1,3,4,5,3,0,6,1,10
2001,Elliot Perry,PG,31,PHO,43,6,460,60,129,0.465,1,4,0.25,59,125,0.472,0.469,16,22,0.727,8,34,42,74,19,1,32,28,137
2001,Wesley Person,SG,29,CLE,44,22,958,128,292,0.438,34,84,0.405,94,208,0.452,0.497,24,30,0.8,11,119,130,64,27,11,40,62,314
2001,Olden Polynice,C,36,UTA,81,79,1619,206,415,0.496,0,1,0,206,414,0.498,0.496,17,65,0.262,157,221,378,31,27,77,78,241,429
2001,James Posey,SF,24,DEN,82,82,2255,243,590,0.412,65,217,0.3,178,373,0.477,0.467,115,141,0.816,125,306,431,163,93,40,102,226,666
2001,Vitaly Potapenko,C,25,BOS,82,7,1901,248,521,0.476,0,0,NA,248,521,0.476,0.476,115,158,0.728,206,289,495,64,52,23,105,228,611
2001,Joel Przybilla,C,21,MIL,33,13,270,12,35,0.343,0,0,NA,12,35,0.343,0.343,3,11,0.273,29,42,71,2,3,30,13,56,27
2001,Theo Ratliff,C,27,PHI,50,50,1800,228,457,0.499,0,0,NA,228,457,0.499,0.499,165,217,0.76,125,288,413,58,30,187,126,165,621
2001,Eldridge Recasner,PG,33,CHH,43,0,403,38,114,0.333,13,39,0.333,25,75,0.333,0.39,14,18,0.778,13,37,50,39,6,1,27,30,103
2001,Don Reid,PF,27,ORL,65,7,764,82,145,0.566,0,0,NA,82,145,0.566,0.566,46,75,0.613,84,158,242,21,23,54,48,190,210
2001,J.R. Reid,PF,32,CLE,6,0,39,2,5,0.4,0,0,NA,2,5,0.4,0.4,6,8,0.75,5,3,8,1,2,1,1,4,10
2001,Clifford Robinson,PF,34,PHO,82,82,2751,501,1186,0.422,90,249,0.361,411,937,0.439,0.46,253,357,0.709,105,229,334,237,87,82,186,258,1345
2001,James Robinson,PG,30,ORL,6,0,50,4,11,0.364,2,5,0.4,2,6,0.333,0.455,0,0,NA,0,8,8,0,4,1,4,5,10
2001,Larry Robinson,SG,33,CLE,1,0,1,0,0,NA,0,0,NA,0,0,NA,NA,0,0,NA,0,0,0,0,0,0,1,0,0
2001,Larry Robinson,PG,33,ATL,33,1,631,67,184,0.364,44,116,0.379,23,68,0.338,0.484,21,24,0.875,23,64,87,36,28,2,24,46,199
2001,Carlos Rogers,C,29,HOU,39,0,544,75,110,0.682,0,1,0,75,109,0.688,0.682,29,52,0.558,48,91,139,9,10,18,17,33,179
2001,Rodney Rogers,SF,29,PHO,82,3,2183,377,876,0.43,56,189,0.296,321,687,0.467,0.462,188,247,0.761,94,265,359,180,97,47,157,269,998
2001,Sean Rooks,C,31,LAC,82,0,1553,169,395,0.428,1,2,0.5,168,393,0.427,0.429,107,143,0.748,91,212,303,77,34,64,73,197,446
2001,Jalen Rose,SF,28,IND,72,72,2943,567,1242,0.457,59,174,0.339,508,1068,0.476,0.48,285,344,0.828,37,322,359,435,65,43,211,230,1478
2001,Malik Rose,PF,26,SAS,57,9,1219,160,368,0.435,3,17,0.176,157,351,0.447,0.439,114,160,0.713,95,213,308,48,59,40,74,148,437
2001,Pepe Sánchez,PG,23,ATL,5,0,34,0,7,0,0,0,NA,0,7,0,0,0,0,NA,1,0,1,5,2,0,3,3,0
2001,Pepe Sánchez,PG,23,PHI,24,0,116,9,21,0.429,0,1,0,9,20,0.45,0.429,2,2,1,2,12,14,36,9,1,3,18,20
2001,Brian Shaw,SG,34,LAL,80,28,1833,164,411,0.399,42,135,0.311,122,276,0.442,0.45,51,64,0.797,48,256,304,258,49,27,97,159,421
2001,Brian Skinner,PF,24,LAC,39,23,584,64,161,0.398,0,0,NA,64,161,0.398,0.398,32,59,0.542,55,113,168,18,14,11,32,61,160
2001,Reggie Slater,PF,30,MIN,55,16,686,90,175,0.514,0,0,NA,90,175,0.514,0.514,74,110,0.673,78,108,186,26,18,9,43,126,254
2001,Jabari Smith,C,23,SAC,9,0,66,11,22,0.5,0,0,NA,11,22,0.5,0.5,4,6,0.667,1,7,8,6,4,0,3,7,26
2001,Joe Smith,PF,25,DET,69,59,1941,308,765,0.403,0,5,0,308,760,0.405,0.403,231,287,0.805,160,331,491,79,47,50,88,258,847
2001,Michael Smith,PF,28,WAS,79,29,1610,106,218,0.486,0,1,0,106,217,0.488,0.486,89,154,0.578,172,390,562,101,57,37,62,156,301
2001,Steve Smith,SG,31,POR,81,36,2542,359,788,0.456,78,230,0.339,281,558,0.504,0.505,309,347,0.89,87,185,272,213,48,24,137,203,1105
2001,Tony Smith,SG,32,ATL,6,0,78,8,23,0.348,0,2,0,8,21,0.381,0.348,1,2,0.5,2,1,3,10,7,0,9,12,17
2001,Eric Snow,PG,27,PHI,50,50,1740,182,435,0.418,5,19,0.263,177,416,0.425,0.424,122,154,0.792,27,139,166,369,77,7,124,123,491
2001,Felton Spencer,C,33,NYK,18,0,113,12,20,0.6,0,0,NA,12,20,0.6,0.6,15,25,0.6,16,19,35,2,2,2,11,24,39
2001,Jerry Stackhouse,SG,26,DET,80,80,3215,774,1927,0.402,166,473,0.351,608,1454,0.418,0.445,666,810,0.822,99,216,315,410,97,54,326,160,2380
2001,John Starks,SG,35,UTA,75,64,2122,273,686,0.398,64,182,0.352,209,504,0.415,0.445,89,111,0.802,29,125,154,178,73,10,94,217,699
2001,DeShawn Stevenson,SG,19,UTA,40,2,293,31,91,0.341,1,12,0.083,30,79,0.38,0.346,26,38,0.684,9,19,28,18,10,2,28,29,89
2001,Michael Stewart,C,25,TOR,26,0,123,11,34,0.324,0,0,NA,11,34,0.324,0.324,11,18,0.611,16,13,29,2,4,3,5,19,33
2001,Peja Stojaković,SF,23,SAC,75,75,2905,559,1189,0.47,144,360,0.4,415,829,0.501,0.531,267,312,0.856,93,341,434,164,91,13,146,144,1529
2001,Damon Stoudamire,PG,27,POR,82,82,2655,406,935,0.434,82,219,0.374,324,716,0.453,0.478,172,207,0.831,69,234,303,468,106,8,191,202,1066
2001,Erick Strickland,PG,27,NYK,28,0,421,40,131,0.305,16,47,0.34,24,84,0.286,0.366,24,28,0.857,9,43,52,29,22,1,21,46,120
2001,Erick Strickland,PG,27,VAN,22,0,409,41,136,0.301,14,48,0.292,27,88,0.307,0.353,44,51,0.863,9,67,76,66,22,1,27,42,140
2001,Mark Strickland,SF,30,DEN,46,2,517,82,185,0.443,0,1,0,82,184,0.446,0.443,37,59,0.627,43,77,120,17,12,19,24,58,201
2001,Mark Strickland,SF,30,NJN,9,0,202,21,54,0.389,1,1,1,20,53,0.377,0.398,8,11,0.727,11,30,41,7,4,3,10,14,51
2001,Rod Strickland,PG,34,WAS,33,28,1020,141,331,0.426,4,16,0.25,137,315,0.435,0.432,115,147,0.782,25,80,105,231,43,4,83,55,401
2001,Rod Strickland,PG,34,POR,21,0,351,41,98,0.418,0,1,0,41,97,0.423,0.418,15,26,0.577,11,24,35,72,10,1,24,21,97
2001,Bruno Šundov,C,20,IND,11,4,120,20,41,0.488,0,4,0,20,37,0.541,0.488,3,5,0.6,4,19,23,2,2,4,3,21,43
2001,Bob Sura,SG,27,GSW,53,42,1684,202,518,0.39,47,172,0.273,155,346,0.448,0.435,135,189,0.714,54,173,227,242,54,8,160,127,586
2001,Stromile Swift,PF,21,VAN,80,6,1312,153,339,0.451,0,4,0,153,335,0.457,0.451,85,141,0.603,109,175,284,28,62,82,64,160,391
2001,Wally Szczerbiak,SF,23,MIN,82,82,2856,469,920,0.51,26,77,0.338,443,843,0.526,0.524,181,208,0.87,133,314,447,260,59,33,138,226,1145
2001,Žan Tabak,C,30,IND,55,14,777,98,186,0.527,0,0,NA,98,186,0.527,0.527,20,47,0.426,65,148,213,33,10,30,57,125,216
2001,Maurice Taylor,SF,24,HOU,69,69,1972,390,797,0.489,0,4,0,390,793,0.492,0.489,119,162,0.735,109,269,378,104,28,38,125,208,899
2001,Jamel Thomas,SF,27,NJN,5,0,56,6,19,0.316,1,3,0.333,5,16,0.313,0.342,0,0,NA,4,5,9,0,3,0,6,6,13
2001,Kenny Thomas,PF,23,HOU,74,21,1820,206,465,0.443,25,92,0.272,181,373,0.485,0.47,91,126,0.722,122,295,417,77,40,43,116,178,528
2001,Kurt Thomas,PF,28,NYK,77,29,2125,314,614,0.511,1,3,0.333,313,611,0.512,0.512,171,210,0.814,172,343,515,63,61,69,99,287,800
2001,Tim Thomas,PF,23,MIL,76,16,2086,326,758,0.43,107,260,0.412,219,498,0.44,0.501,195,253,0.771,79,234,313,138,78,45,114,194,954
2001,Otis Thorpe,PF,38,CHH,49,4,647,59,131,0.45,0,0,NA,59,131,0.45,0.45,20,24,0.833,50,95,145,29,12,7,32,108,138
2001,Gary Trent,PF,26,DAL,33,4,319,57,130,0.438,0,1,0,57,129,0.442,0.438,19,36,0.528,39,53,92,10,13,8,22,52,133
2001,Jake Tsakalidis,C,21,PHO,57,39,947,101,215,0.47,0,0,NA,101,215,0.47,0.47,54,91,0.593,83,159,242,19,10,55,66,137,256
2001,Hedo Türkoğlu,SF,21,SAC,74,7,1245,138,335,0.412,28,86,0.326,110,249,0.442,0.454,87,112,0.777,49,161,210,69,52,24,55,139,391
2001,Nick Van Exel,PG,29,DEN,71,70,2688,460,1112,0.414,135,358,0.377,325,754,0.431,0.474,204,249,0.819,44,197,241,600,61,18,165,109,1259
2001,Keith Van Horn,SF,25,NJN,49,47,1733,308,708,0.435,65,170,0.382,243,538,0.452,0.481,150,186,0.806,78,269,347,82,40,20,103,150,831
2001,Loy Vaught,PF,32,DAL,37,1,392,55,121,0.455,0,0,NA,55,121,0.455,0.455,4,6,0.667,35,88,123,16,15,5,18,61,114
2001,Loy Vaught,PF,32,WAS,14,0,157,25,48,0.521,0,0,NA,25,48,0.521,0.521,4,4,1,16,34,50,7,6,2,8,13,54
2001,Antoine Walker,PF,24,BOS,81,81,3396,711,1720,0.413,221,603,0.367,490,1117,0.439,0.478,249,348,0.716,151,568,719,445,138,49,301,251,1892
2001,Ben Wallace,C,26,DET,80,80,2760,215,439,0.49,1,4,0.25,214,435,0.492,0.491,80,238,0.336,303,749,1052,123,107,186,117,192,511
2001,Rasheed Wallace,PF,26,POR,77,75,2940,590,1178,0.501,52,162,0.321,538,1016,0.53,0.523,245,320,0.766,147,455,602,212,90,135,158,206,1477
2001,Charlie Ward,PG,30,NYK,61,33,1492,155,373,0.416,67,175,0.383,88,198,0.444,0.505,56,70,0.8,32,127,159,273,70,10,112,132,433
2001,Clarence Weatherspoon,PF,30,CLE,82,82,2774,347,692,0.501,0,0,NA,347,692,0.501,0.501,230,291,0.79,223,573,796,103,85,105,112,171,924
2001,Chris Webber,PF,27,SAC,70,70,2836,786,1635,0.481,2,28,0.071,784,1607,0.488,0.481,324,461,0.703,179,598,777,294,93,118,195,226,1898
2001,Bonzi Wells,SF,24,POR,75,46,1995,387,726,0.533,17,50,0.34,370,676,0.547,0.545,159,240,0.663,120,247,367,208,94,20,169,203,950
2001,David Wesley,SG,30,CHH,82,82,3106,523,1239,0.422,97,258,0.376,426,981,0.434,0.461,271,339,0.799,64,160,224,361,128,16,171,220,1414
2001,Jahidi White,C,24,WAS,68,56,1609,203,408,0.498,0,1,0,203,407,0.499,0.498,177,312,0.567,178,343,521,20,32,111,136,211,583
2001,Chris Whitney,PG,29,WAS,59,31,1532,182,470,0.387,93,248,0.375,89,222,0.401,0.486,101,113,0.894,12,94,106,248,55,3,103,150,558
2001,Aaron Williams,PF,29,NJN,82,25,2336,297,650,0.457,0,2,0,297,648,0.458,0.457,244,310,0.787,211,379,590,88,59,113,132,319,838
2001,Alvin Williams,SG,26,TOR,82,34,2394,330,767,0.43,33,108,0.306,297,659,0.451,0.452,109,145,0.752,50,162,212,407,123,26,103,171,802
2001,Eric Williams,SF,28,BOS,81,11,1745,162,448,0.362,46,139,0.331,116,309,0.375,0.413,165,231,0.714,64,143,207,112,64,13,76,179,535
2001,Jason Williams,PG,25,SAC,77,77,2290,281,690,0.407,98,311,0.315,183,379,0.483,0.478,60,76,0.789,19,166,185,416,94,9,160,114,720
2001,Jerome Williams,PF,27,DET,33,2,804,88,201,0.438,0,2,0,88,199,0.442,0.438,65,90,0.722,98,180,278,32,39,10,47,81,241
2001,Jerome Williams,PF,27,TOR,26,0,378,48,93,0.516,0,1,0,48,92,0.522,0.516,35,45,0.778,35,69,104,13,18,10,16,43,131
2001,Monty Williams,SF,29,ORL,82,0,1211,162,364,0.445,1,13,0.077,161,351,0.459,0.446,85,133,0.639,86,157,243,79,29,16,85,136,410
2001,Scott Williams,C,32,MIL,66,31,1272,171,361,0.474,1,4,0.25,170,357,0.476,0.475,60,70,0.857,97,267,364,35,48,32,41,178,403
2001,Shammond Williams,PG,25,SEA,69,6,1238,161,368,0.438,61,133,0.459,100,235,0.426,0.52,84,96,0.875,34,98,132,190,31,4,82,83,467
2001,Walt Williams,SF,30,HOU,72,31,1583,202,513,0.394,98,248,0.395,104,265,0.392,0.489,97,126,0.77,31,214,245,97,30,28,73,153,599
2001,Corliss Williamson,SF,27,TOR,42,31,886,153,325,0.471,0,2,0,153,323,0.474,0.471,84,130,0.646,57,96,153,33,15,13,65,98,390
2001,Corliss Williamson,SF,27,DET,27,9,800,172,322,0.534,0,0,NA,172,322,0.534,0.534,67,107,0.626,53,115,168,28,35,8,45,87,411
2001,Kevin Willis,C,38,TOR,35,9,771,124,269,0.461,0,2,0,124,267,0.464,0.461,61,81,0.753,68,155,223,21,19,21,40,78,309
2001,Kevin Willis,C,38,DEN,43,13,1059,180,421,0.428,1,4,0.25,179,417,0.429,0.429,52,66,0.788,109,200,309,29,38,31,47,138,413
2001,Metta World Peace,SF,21,CHI,76,74,2363,327,815,0.401,43,148,0.291,284,667,0.426,0.428,210,280,0.75,59,235,294,228,152,45,159,254,907
2001,Lorenzen Wright,C,25,ATL,71,46,1988,363,811,0.448,0,2,0,363,809,0.449,0.448,155,216,0.718,180,355,535,87,42,63,125,232,881
2001,Wang Zhizhi,C,23,DAL,5,0,38,8,19,0.421,0,2,0,8,17,0.471,0.421,8,10,0.8,1,6,7,0,0,0,1,8,24
2002,Tariq Abdul-Wahad,SG,27,DEN,20,12,417,55,145,0.379,1,2,0.5,54,143,0.378,0.383,24,32,0.75,39,39,78,22,18,9,24,51,135
2002,Tariq Abdul-Wahad,SG,27,DAL,4,0,24,0,2,0,0,0,NA,0,2,0,0,0,1,0,2,4,6,2,2,1,3,5,0
2002,Shareef Abdur-Rahim,PF,25,ATL,77,77,2980,598,1297,0.461,21,70,0.3,577,1227,0.47,0.469,419,523,0.801,198,498,696,239,98,81,250,214,1636
2002,Courtney Alexander,SG,24,WAS,56,28,1325,223,474,0.47,5,18,0.278,218,456,0.478,0.476,98,121,0.81,43,105,148,86,35,7,60,113,549
2002,Malik Allen,PF,23,MIA,12,2,161,22,51,0.431,0,1,0,22,50,0.44,0.431,8,10,0.8,15,23,38,5,3,8,2,16,52
2002,Ray Allen,SG,26,MIL,69,67,2525,530,1148,0.462,229,528,0.434,301,620,0.485,0.561,214,245,0.873,81,231,312,271,88,18,159,157,1503
2002,Rafer Alston,PG,25,MIL,50,7,600,66,191,0.346,27,71,0.38,39,120,0.325,0.416,18,29,0.621,10,62,72,143,32,2,40,42,177
2002,Chris Andersen,C,23,DEN,24,1,262,25,74,0.338,0,4,0,25,70,0.357,0.338,22,28,0.786,38,38,76,7,7,28,13,35,72
2002,Derek Anderson,SG,27,POR,70,27,1860,247,612,0.404,85,228,0.373,162,384,0.422,0.473,178,208,0.856,47,142,189,216,68,8,87,113,757
2002,Kenny Anderson,PG,31,BOS,76,76,2430,312,716,0.436,9,33,0.273,303,683,0.444,0.442,98,132,0.742,57,218,275,403,141,10,119,210,731
2002,Shandon Anderson,SG,28,NYK,82,6,1596,149,373,0.399,39,141,0.277,110,232,0.474,0.452,74,107,0.692,57,192,249,76,48,15,97,134,411
2002,Greg Anthony,PG,34,CHI,36,35,961,113,287,0.394,29,90,0.322,84,197,0.426,0.444,47,70,0.671,16,72,88,203,49,4,58,72,302
2002,Greg Anthony,PG,34,MIL,24,3,553,70,188,0.372,19,73,0.26,51,115,0.443,0.423,13,21,0.619,6,38,44,79,28,1,36,42,172
2002,Gilbert Arenas,PG,20,GSW,47,30,1155,174,384,0.453,39,113,0.345,135,271,0.498,0.504,124,160,0.775,41,91,132,174,69,11,97,115,511
2002,Darrell Armstrong,PG,33,ORL,82,79,2730,347,828,0.419,139,398,0.349,208,430,0.484,0.503,182,205,0.888,83,236,319,453,157,10,175,166,1015
2002,Carlos Arroyo,PG,22,TOR,17,0,96,13,29,0.448,0,0,NA,13,29,0.448,0.448,4,6,0.667,3,9,12,21,6,0,12,12,30
2002,Carlos Arroyo,PG,22,DEN,20,1,275,36,82,0.439,0,2,0,36,80,0.45,0.439,9,12,0.75,9,19,28,49,5,1,11,18,81
2002,Chucky Atkins,PG,27,DET,79,62,2285,368,790,0.466,138,336,0.411,230,454,0.507,0.553,83,120,0.692,31,127,158,263,72,11,128,177,957
2002,Stacey Augmon,SG,33,CHH,77,3,1319,140,328,0.427,0,3,0,140,325,0.431,0.427,77,101,0.762,59,166,225,103,56,12,54,115,357
2002,Isaac Austin,C,32,MEM,21,8,307,36,92,0.391,0,3,0,36,89,0.404,0.391,4,4,1,11,60,71,13,9,5,11,36,76
2002,Vin Baker,C,30,SEA,55,41,1710,315,649,0.485,1,8,0.125,314,641,0.49,0.486,143,226,0.633,168,182,350,72,22,36,127,197,774
2002,Brent Barry,SG,30,SEA,81,81,3040,401,790,0.508,164,387,0.424,237,403,0.588,0.611,198,234,0.846,58,383,441,426,147,37,165,182,1164
2002,Jon Barry,SG,32,DET,82,6,1985,255,522,0.489,121,258,0.469,134,264,0.508,0.604,108,116,0.931,42,192,234,274,94,20,111,134,739
2002,Tony Battie,C,25,BOS,74,73,1819,211,390,0.541,0,2,0,211,388,0.544,0.541,88,130,0.677,184,297,481,35,60,67,51,219,510
2002,Shane Battier,SF,23,MEM,78,78,3097,412,961,0.429,103,276,0.373,309,685,0.451,0.482,198,283,0.7,180,238,418,216,121,81,155,215,1125
2002,Charlie Bell,SG,22,PHO,5,0,42,3,11,0.273,0,6,0,3,5,0.6,0.273,2,2,1,2,2,4,2,0,0,5,3,8
2002,Charlie Bell,SG,22,DAL,2,0,2,0,0,NA,0,0,NA,0,0,NA,NA,0,0,NA,0,1,1,0,0,0,0,0,0
2002,Raja Bell,SG,25,PHI,74,12,890,103,240,0.429,12,44,0.273,91,196,0.464,0.454,36,48,0.75,31,80,111,71,21,4,48,109,254
2002,Travis Best,PG,29,IND,44,3,954,116,264,0.439,13,34,0.382,103,230,0.448,0.464,57,65,0.877,10,60,70,175,57,6,59,101,302
2002,Travis Best,PG,29,CHI,30,18,793,112,254,0.441,8,25,0.32,104,229,0.454,0.457,47,51,0.922,10,71,81,149,32,1,40,72,279
2002,Mike Bibby,PG,23,SAC,80,80,2659,446,985,0.453,51,138,0.37,395,847,0.466,0.479,155,193,0.803,37,185,222,403,87,15,134,133,1098
2002,Chauncey Billups,PG,25,MIN,82,54,2355,348,823,0.423,124,315,0.394,224,508,0.441,0.498,207,234,0.885,35,191,226,450,66,17,138,169,1027
2002,Corie Blount,PF,33,PHI,72,21,1426,115,251,0.458,0,1,0,115,250,0.46,0.458,29,45,0.644,149,219,368,44,49,26,52,176,259
2002,Mark Blount,C,26,BOS,44,0,415,32,76,0.421,0,0,NA,32,76,0.421,0.421,30,37,0.811,26,59,85,10,16,19,23,59,94
2002,Calvin Booth,C,25,SEA,15,15,279,35,82,0.427,0,0,NA,35,82,0.427,0.427,23,24,0.958,20,34,54,16,6,13,16,47,93
2002,Bruce Bowen,SF,30,SAS,59,59,1699,155,398,0.389,56,148,0.378,99,250,0.396,0.46,46,96,0.479,42,120,162,88,62,25,66,116,412
2002,Earl Boykins,PG,25,LAC,68,2,761,110,275,0.4,13,42,0.31,97,233,0.416,0.424,47,61,0.77,27,27,54,145,20,2,44,44,280
2002,Michael Bradley,PF,22,TOR,26,0,118,13,25,0.52,0,2,0,13,23,0.565,0.52,4,8,0.5,7,17,24,3,0,6,6,10,30
2002,Shawn Bradley,C,29,DAL,53,16,757,78,163,0.479,0,1,0,78,162,0.481,0.479,59,64,0.922,53,123,176,20,28,64,25,128,215
2002,Terrell Brandon,PG,31,MIN,32,28,962,155,365,0.425,4,23,0.174,151,342,0.442,0.43,83,84,0.988,17,76,93,264,52,6,43,49,397
2002,Primož Brezec,C,22,IND,22,4,160,14,29,0.483,0,0,NA,14,29,0.483,0.483,15,25,0.6,16,12,28,6,0,7,6,28,43
2002,Chucky Brown,SF,33,SAC,18,0,92,10,27,0.37,0,0,NA,10,27,0.37,0.37,1,2,0.5,10,23,33,6,2,4,5,12,21
2002,Dee Brown,PG,33,ORL,7,0,65,3,20,0.15,1,12,0.083,2,8,0.25,0.175,0,0,NA,0,9,9,2,3,1,4,4,7
2002,Kedrick Brown,SF,20,BOS,29,5,245,23,70,0.329,5,27,0.185,18,43,0.419,0.364,12,20,0.6,11,39,50,15,18,7,7,18,63
2002,Kwame Brown,PF,19,WAS,57,3,817,94,243,0.387,0,1,0,94,242,0.388,0.387,70,99,0.707,63,135,198,43,16,26,43,105,258
2002,Rick Brunson,PG,29,POR,59,2,520,45,113,0.398,6,11,0.545,39,102,0.382,0.425,29,41,0.707,23,45,68,114,25,2,47,51,125
2002,Mark Bryant,PF,36,SAS,30,3,206,25,55,0.455,0,0,NA,25,55,0.455,0.455,6,8,0.75,25,19,44,10,7,2,6,38,56
2002,Jud Buechler,SF,33,PHO,6,0,54,2,6,0.333,2,6,0.333,0,0,NA,0.5,0,0,NA,2,6,8,3,1,0,1,7,6
2002,Jud Buechler,SF,33,ORL,60,2,630,42,112,0.375,19,54,0.352,23,58,0.397,0.46,2,4,0.5,27,81,108,29,20,8,14,46,105
2002,Jason Caffey,PF,28,MIL,23,0,283,36,72,0.5,0,1,0,36,71,0.507,0.5,27,43,0.628,24,26,50,12,4,5,19,39,99
2002,Marcus Camby,C,27,NYK,29,29,1007,130,290,0.448,0,1,0,130,289,0.45,0.448,62,99,0.626,89,233,322,33,34,50,42,107,322
2002,Elden Campbell,PF,33,CHH,77,74,2156,384,794,0.484,0,2,0,384,792,0.485,0.484,306,384,0.797,133,397,530,102,60,137,138,264,1074
2002,Anthony Carter,PG,26,MIA,46,18,1050,89,260,0.342,1,19,0.053,88,241,0.365,0.344,19,36,0.528,19,98,117,214,50,3,72,85,198
2002,Vince Carter,SG,25,TOR,60,60,2385,559,1307,0.428,121,313,0.387,438,994,0.441,0.474,245,307,0.798,138,175,313,239,94,43,154,191,1484
2002,Sam Cassell,PG,32,MIL,74,73,2605,554,1197,0.463,71,204,0.348,483,993,0.486,0.492,282,328,0.86,54,258,312,493,90,12,177,208,1461
2002,Kelvin Cato,C,27,HOU,75,73,1917,190,326,0.583,0,1,0,190,325,0.585,0.583,113,194,0.582,176,349,525,29,40,95,53,208,493
2002,Tyson Chandler,C,19,CHI,71,31,1389,151,304,0.497,0,0,NA,151,304,0.497,0.497,134,222,0.604,114,229,343,54,28,93,99,179,436
2002,Chris Childs,PG,34,TOR,69,4,1576,97,296,0.328,33,120,0.275,64,176,0.364,0.383,58,71,0.817,18,136,154,351,56,5,123,177,285
2002,Doug Christie,SG,31,SAC,81,81,2798,338,735,0.46,90,256,0.352,248,479,0.518,0.521,206,242,0.851,74,300,374,340,160,25,164,209,972
2002,Keon Clark,C,26,TOR,81,31,2185,380,775,0.49,0,5,0,380,770,0.494,0.49,155,230,0.674,182,421,603,88,58,122,140,258,915
2002,Speedy Claxton,PG,23,PHI,67,18,1528,181,452,0.4,4,33,0.121,177,419,0.422,0.405,114,136,0.838,46,114,160,198,95,6,95,145,480
2002,Bimbo Coles,PG,33,CLE,47,1,693,56,146,0.384,4,20,0.2,52,126,0.413,0.397,33,37,0.892,12,43,55,107,13,4,31,59,149
2002,Jarron Collins,C,23,UTA,70,68,1440,158,343,0.461,0,1,0,158,342,0.462,0.461,134,181,0.74,138,158,296,58,29,22,56,234,450
2002,Jason Collins,C,23,NJN,77,9,1407,117,278,0.421,1,2,0.5,116,276,0.42,0.423,115,164,0.701,132,169,301,81,29,47,72,173,350
2002,Jamal Crawford,PG,21,CHI,23,6,481,89,187,0.476,26,58,0.448,63,129,0.488,0.545,10,13,0.769,5,29,34,55,18,5,32,18,214
2002,Joe Crispin,PG,22,LAL,6,0,27,3,12,0.25,0,4,0,3,8,0.375,0.25,4,5,0.8,0,1,1,2,1,0,1,2,10
2002,Joe Crispin,PG,22,PHO,15,0,129,23,56,0.411,15,35,0.429,8,21,0.381,0.545,8,8,1,2,8,10,24,4,0,9,8,69
2002,Austin Croshere,PF,26,IND,76,1,1286,185,448,0.413,49,145,0.338,136,303,0.449,0.468,97,114,0.851,74,220,294,77,26,29,67,106,516
2002,John Crotty,PG,32,UTA,41,0,802,98,208,0.471,31,69,0.449,67,139,0.482,0.546,57,66,0.864,16,59,75,141,19,1,51,77,284
2002,Michael Curry,SG,33,DET,82,75,1912,125,276,0.453,7,26,0.269,118,250,0.472,0.466,72,91,0.791,15,153,168,127,47,10,60,207,329
2002,Antonio Daniels,SG,26,SAS,82,13,2175,269,612,0.44,57,196,0.291,212,416,0.51,0.486,158,210,0.752,23,153,176,228,48,12,70,104,753
2002,Antonio Davis,PF,33,TOR,77,77,2978,410,963,0.426,0,1,0,410,962,0.426,0.426,293,358,0.818,254,486,740,155,54,83,159,225,1113
2002,Baron Davis,PG,22,CHH,82,82,3318,559,1341,0.417,170,478,0.356,389,863,0.451,0.48,196,338,0.58,93,256,349,698,172,47,246,241,1484
2002,Dale Davis,C,32,POR,78,77,2447,296,580,0.51,0,0,NA,296,580,0.51,0.51,150,212,0.708,262,426,688,96,62,83,62,193,742
2002,Hubert Davis,SG,31,WAS,51,17,1231,146,326,0.448,57,126,0.452,89,200,0.445,0.535,16,21,0.762,7,70,77,107,28,3,44,58,365
2002,Ricky Davis,SF,22,CLE,82,8,1954,376,781,0.481,11,35,0.314,365,746,0.489,0.488,196,248,0.79,63,180,243,178,69,23,148,145,959
2002,Andrew DeClercq,C,28,ORL,61,14,633,67,149,0.45,0,0,NA,67,149,0.45,0.45,28,50,0.56,74,89,163,22,23,24,34,130,162
2002,Vinny Del Negro,PG,35,PHO,2,0,6,1,4,0.25,0,0,NA,1,4,0.25,0.25,0,0,NA,0,0,0,2,0,0,0,0,2
2002,Tony Delk,SG,28,PHO,41,1,877,166,416,0.399,47,147,0.32,119,269,0.442,0.456,56,67,0.836,38,86,124,81,31,4,40,60,435
2002,Tony Delk,SG,28,BOS,22,16,570,60,172,0.349,20,67,0.299,40,105,0.381,0.407,22,30,0.733,20,59,79,51,22,6,19,38,162
2002,Derrick Dial,SG,26,NJN,25,0,249,30,94,0.319,0,7,0,30,87,0.345,0.319,13,18,0.722,12,33,45,31,8,4,13,12,73
2002,Derrick Dial,SG,26,TOR,7,0,50,11,26,0.423,1,4,0.25,10,22,0.455,0.442,5,6,0.833,2,9,11,4,2,0,3,1,28
2002,DeSagana Diop,C,20,CLE,18,1,109,12,29,0.414,0,0,NA,12,29,0.414,0.414,1,5,0.2,5,12,17,5,1,10,12,19,25
2002,Michael Doleac,C,24,CLE,42,15,705,78,187,0.417,0,0,NA,78,187,0.417,0.417,38,46,0.826,47,121,168,25,15,11,37,98,194
2002,Chris Dudley,C,36,POR,43,2,327,20,50,0.4,0,2,0,20,48,0.417,0.4,8,15,0.533,27,53,80,13,3,14,14,42,48
2002,Howard Eisley,PG,29,NYK,39,0,609,59,175,0.337,14,58,0.241,45,117,0.385,0.377,39,49,0.796,9,40,49,100,24,3,53,55,171
2002,Obinna Ekezie,PF,26,LAC,29,1,152,13,39,0.333,0,0,NA,13,39,0.333,0.333,28,40,0.7,12,22,34,3,2,6,10,16,54
2002,Maurice Evans,SG,23,MIN,10,0,45,9,19,0.474,0,3,0,9,16,0.563,0.474,3,4,0.75,3,1,4,4,0,0,2,9,21
2002,Michael Finley,SF,28,DAL,69,69,2754,569,1228,0.463,76,224,0.339,493,1004,0.491,0.494,210,251,0.837,90,270,360,230,65,25,117,144,1424
2002,Derek Fisher,PG,27,LAL,70,35,1974,274,666,0.411,144,349,0.413,130,317,0.41,0.52,94,111,0.847,15,131,146,181,66,9,62,121,786
2002,Greg Foster,PF,33,MIL,6,0,24,2,9,0.222,0,4,0,2,5,0.4,0.222,3,4,0.75,0,8,8,1,0,0,0,4,7
2002,Adonal Foyle,C,26,GSW,79,36,1485,171,385,0.444,0,0,NA,171,385,0.444,0.444,37,93,0.398,150,234,384,41,36,168,76,179,379
2002,Steve Francis,PG,24,HOU,57,56,2343,420,1007,0.417,68,210,0.324,352,797,0.442,0.451,326,422,0.773,102,299,401,362,71,25,221,172,1234
2002,Kevin Garnett,PF,25,MIN,81,81,3175,659,1401,0.47,37,116,0.319,622,1285,0.484,0.484,359,448,0.801,243,738,981,422,96,126,229,184,1714
2002,Dean Garrett,C,35,MIN,29,0,152,14,40,0.35,0,0,NA,14,40,0.35,0.35,0,3,0,13,34,47,4,5,9,7,26,28
2002,Dean Garrett,C,35,GSW,5,0,31,4,15,0.267,0,0,NA,4,15,0.267,0.267,0,0,NA,3,7,10,1,2,1,3,6,8
2002,Pau Gasol,PF,21,MEM,82,79,3007,551,1064,0.518,1,5,0.2,550,1059,0.519,0.518,338,477,0.709,238,492,730,223,41,169,224,195,1441
2002,Chris Gatling,PF,34,MIA,54,1,809,131,293,0.447,1,8,0.125,130,285,0.456,0.449,82,117,0.701,71,135,206,25,17,11,58,109,345
2002,Eddie Gill,PG,23,MEM,23,5,384,39,92,0.424,7,22,0.318,32,70,0.457,0.462,31,39,0.795,7,21,28,49,11,3,34,38,116
2002,Kendall Gill,SG,33,MIA,65,49,1410,162,422,0.384,6,44,0.136,156,378,0.413,0.391,42,62,0.677,29,155,184,100,44,8,55,140,372
2002,Dion Glover,SG,23,ATL,55,25,1156,192,456,0.421,30,91,0.33,162,365,0.444,0.454,78,103,0.757,36,133,169,84,45,14,76,89,492
2002,Adrian Griffin,SG,27,DAL,58,34,1383,179,359,0.499,16,54,0.296,163,305,0.534,0.521,41,49,0.837,68,161,229,106,75,12,42,142,415
2002,Tom Gugliotta,PF,32,PHO,44,40,1129,127,301,0.422,3,9,0.333,124,292,0.425,0.427,28,37,0.757,59,162,221,77,39,30,61,116,285
2002,Darvin Ham,SF,28,MIL,70,2,1208,120,211,0.569,1,7,0.143,119,204,0.583,0.571,62,123,0.504,91,111,202,73,25,37,83,175,303
2002,Zendon Hamilton,PF,26,DEN,54,15,848,103,245,0.42,0,0,NA,103,245,0.42,0.42,118,181,0.652,110,143,253,14,21,18,60,104,324
2002,Anfernee Hardaway,SG,30,PHO,80,55,2462,389,931,0.418,23,83,0.277,366,848,0.432,0.43,158,195,0.81,98,252,350,324,122,32,189,184,959
2002,Tim Hardaway,PG,35,DAL,54,2,1276,179,494,0.362,95,279,0.341,84,215,0.391,0.459,65,78,0.833,13,84,97,201,40,8,73,84,518
2002,Tim Hardaway,PG,35,DEN,14,14,325,47,126,0.373,28,75,0.373,19,51,0.373,0.484,12,19,0.632,1,26,27,77,17,2,38,25,134
2002,Al Harrington,PF,21,IND,44,1,1313,230,484,0.475,1,3,0.333,229,481,0.476,0.476,115,144,0.799,96,180,276,54,41,21,78,166,576
2002,Othella Harrington,PF,28,NYK,77,4,1563,237,450,0.527,0,2,0,237,448,0.529,0.527,122,172,0.709,125,224,349,37,30,36,95,250,596
2002,Jason Hart,PG,23,SAS,10,0,92,10,19,0.526,0,2,0,10,17,0.588,0.526,6,6,1,4,9,13,12,7,1,8,16,26
2002,Antonio Harvey,PF,31,SEA,5,3,47,4,12,0.333,0,0,NA,4,12,0.333,0.333,1,2,0.5,5,4,9,5,1,3,3,8,9
2002,Donnell Harvey,PF,21,DAL,18,0,162,14,26,0.538,0,0,NA,14,26,0.538,0.538,10,22,0.455,12,34,46,5,4,5,8,27,38
2002,Donnell Harvey,PF,21,DEN,29,4,679,94,191,0.492,0,0,NA,94,191,0.492,0.492,44,68,0.647,68,113,181,32,17,19,25,88,232
2002,Trenton Hassell,SG,22,CHI,78,47,2237,267,628,0.425,60,165,0.364,207,463,0.447,0.473,87,114,0.763,65,190,255,172,55,44,101,184,681
2002,Brendan Haywood,C,22,WAS,62,2,1266,109,221,0.493,0,0,NA,109,221,0.493,0.493,97,160,0.606,143,179,322,29,21,91,50,158,315
2002,Tyrone Hill,PF,33,CLE,26,26,810,71,182,0.39,0,1,0,71,181,0.392,0.39,67,103,0.65,79,195,274,23,17,13,48,102,209
2002,Robert Horry,PF,31,LAL,81,23,2140,183,460,0.398,76,203,0.374,107,257,0.416,0.48,108,138,0.783,130,349,479,232,77,89,88,208,550
2002,Eddie House,PG,23,MIA,64,3,1230,209,524,0.399,54,157,0.344,155,367,0.422,0.45,42,49,0.857,17,93,110,123,43,5,80,98,514
2002,Juwan Howard,PF,28,DAL,53,44,1659,270,585,0.462,0,1,0,270,584,0.462,0.462,144,191,0.754,138,252,390,93,28,30,78,170,684
2002,Juwan Howard,PF,28,DEN,28,28,976,192,420,0.457,0,1,0,192,419,0.458,0.457,117,152,0.77,85,137,222,76,18,17,74,95,501
2002,Larry Hughes,SG,23,GSW,73,56,2049,343,810,0.423,18,93,0.194,325,717,0.453,0.435,191,259,0.737,83,162,245,316,113,23,171,150,895
2002,Allen Iverson,SG,26,PHI,60,59,2622,665,1669,0.398,78,268,0.291,587,1401,0.419,0.422,475,585,0.812,44,225,269,331,168,13,237,102,1883
2002,Bobby Jackson,PG,28,SAC,81,3,1750,334,754,0.443,79,219,0.361,255,535,0.477,0.495,149,184,0.81,82,169,251,164,73,11,93,145,896
2002,Jermaine Jackson,SG,25,TOR,24,0,280,20,42,0.476,1,2,0.5,19,40,0.475,0.488,16,24,0.667,3,24,27,57,9,1,14,24,57
2002,Jim Jackson,SF,31,MIA,55,19,1825,238,538,0.442,38,81,0.469,200,457,0.438,0.478,75,87,0.862,54,236,290,140,42,14,106,145,589
2002,Marc Jackson,C,27,GSW,17,0,169,22,65,0.338,0,0,NA,22,65,0.338,0.338,40,48,0.833,17,26,43,7,5,3,12,25,84
2002,Marc Jackson,C,27,MIN,22,0,326,38,99,0.384,0,1,0,38,98,0.388,0.384,26,32,0.813,31,54,85,7,6,3,18,44,102
2002,Mark Jackson,PG,36,NYK,82,82,2367,260,592,0.439,79,195,0.405,181,397,0.456,0.506,87,110,0.791,56,253,309,605,74,1,150,162,686
2002,Stephen Jackson,SF,23,SAS,23,1,227,34,91,0.374,9,36,0.25,25,55,0.455,0.423,12,17,0.706,3,23,26,11,15,3,23,29,89
2002,Mike James,PG,26,MIA,15,0,119,15,43,0.349,8,21,0.381,7,22,0.318,0.442,4,7,0.571,2,12,14,19,6,1,13,17,42
2002,Antawn Jamison,SF,25,GSW,82,82,3033,614,1375,0.447,68,210,0.324,546,1165,0.469,0.471,323,440,0.734,211,345,556,161,70,45,161,187,1619
2002,Richard Jefferson,SF,21,NJN,79,9,1917,270,591,0.457,13,56,0.232,257,535,0.48,0.468,189,265,0.713,85,208,293,140,64,48,107,211,742
2002,Anthony Johnson,SG,27,NJN,34,0,366,37,90,0.411,4,12,0.333,33,78,0.423,0.433,16,25,0.64,10,19,29,48,31,1,20,30,94
2002,Avery Johnson,PG,36,DEN,51,13,1200,186,383,0.486,0,5,0,186,378,0.492,0.486,109,146,0.747,14,50,64,258,35,8,67,69,481
2002,Avery Johnson,PG,36,DAL,17,0,152,21,49,0.429,0,0,NA,21,49,0.429,0.429,12,17,0.706,0,5,5,28,5,1,9,17,54
2002,Joe Johnson,SG,20,BOS,48,33,1003,130,296,0.439,24,88,0.273,106,208,0.51,0.48,20,26,0.769,40,99,139,74,33,9,28,59,304
2002,Joe Johnson,SG,20,PHO,29,27,913,121,288,0.42,14,42,0.333,107,246,0.435,0.444,21,27,0.778,35,83,118,105,26,11,43,55,277
2002,Damon Jones,PG,25,DET,67,0,1083,114,284,0.401,69,186,0.371,45,98,0.459,0.523,43,59,0.729,13,90,103,140,23,1,61,83,340
2002,Eddie Jones,SG,30,MIA,81,81,3156,517,1198,0.432,149,382,0.39,368,816,0.451,0.494,297,355,0.837,61,317,378,262,117,77,148,258,1480
2002,Steve Kerr,PG,36,POR,65,0,775,102,217,0.47,26,66,0.394,76,151,0.503,0.53,39,40,0.975,6,54,60,63,13,1,24,49,269
2002,Jason Kidd,PG,28,NJN,82,82,3056,445,1138,0.391,117,364,0.321,328,774,0.424,0.442,201,247,0.814,130,465,595,808,175,20,286,136,1208
2002,Brevin Knight,PG,26,MEM,53,11,1151,141,334,0.422,2,8,0.25,139,326,0.426,0.425,87,115,0.757,11,98,109,302,79,7,111,135,371
2002,Toni Kukoč,SF,33,ATL,59,9,1494,211,504,0.419,53,171,0.31,158,333,0.474,0.471,109,153,0.712,43,175,218,210,48,17,113,91,584
2002,Christian Laettner,PF,32,WAS,57,48,1441,168,362,0.464,2,10,0.2,166,352,0.472,0.467,66,76,0.868,74,227,301,151,60,25,85,129,404
2002,Raef LaFrentz,C,25,DEN,51,51,1668,307,659,0.466,75,173,0.434,232,486,0.477,0.523,70,105,0.667,117,262,379,60,31,153,60,173,759
2002,Raef LaFrentz,C,25,DAL,27,25,787,114,261,0.437,29,95,0.305,85,166,0.512,0.492,35,46,0.761,59,141,200,29,24,60,34,108,292
2002,Dan Langhi,SF,24,HOU,34,8,434,49,125,0.392,1,4,0.25,48,121,0.397,0.396,8,11,0.727,22,45,67,14,8,5,9,25,107
2002,Voshon Lenard,SG,28,DEN,71,19,1665,315,769,0.41,89,240,0.371,226,529,0.427,0.467,94,120,0.783,38,145,183,130,59,25,91,105,813
2002,Rashard Lewis,SF,22,SEA,71,70,2585,455,972,0.468,123,316,0.389,332,656,0.506,0.531,162,200,0.81,139,359,498,123,104,40,97,174,1195
2002,Art Long,PF,29,SEA,63,27,989,120,244,0.492,0,0,NA,120,244,0.492,0.492,45,85,0.529,107,144,251,41,22,28,63,180,285
2002,Grant Long,PF,35,MEM,66,56,1868,164,385,0.426,3,17,0.176,161,368,0.438,0.43,86,123,0.699,31,200,231,136,63,12,103,123,417
2002,Felipe López,SG,27,MIN,67,0,581,59,156,0.378,14,33,0.424,45,123,0.366,0.423,37,55,0.673,29,51,80,39,18,1,36,73,169
2002,Tyronn Lue,PG,24,WAS,71,0,1458,222,520,0.427,63,141,0.447,159,379,0.42,0.488,48,63,0.762,14,108,122,246,49,0,96,120,555
2002,Sam Mack,SF,31,MIA,12,1,159,14,49,0.286,7,28,0.25,7,21,0.333,0.357,5,7,0.714,2,12,14,4,5,1,7,17,40
2002,Jamaal Magloire,C,23,CHH,82,8,1549,228,414,0.551,0,1,0,228,413,0.552,0.551,243,333,0.73,153,308,461,31,27,86,118,201,699
2002,Danny Manning,PF,35,DAL,41,10,552,71,149,0.477,1,7,0.143,70,142,0.493,0.48,22,33,0.667,25,83,108,30,21,21,25,80,165
2002,Stephon Marbury,PG,24,PHO,82,80,3187,625,1413,0.442,71,248,0.286,554,1165,0.476,0.467,353,452,0.781,75,191,266,666,77,13,284,186,1674
2002,Shawn Marion,SF,23,PHO,81,81,3109,654,1395,0.469,48,122,0.393,606,1273,0.476,0.486,191,226,0.845,211,592,803,162,149,86,144,214,1547
2002,Donyell Marshall,SF,28,UTA,58,42,1750,343,661,0.519,13,42,0.31,330,619,0.533,0.529,160,226,0.708,158,285,443,101,50,67,124,150,859
2002,Darrick Martin,PG,30,DAL,3,0,22,0,10,0,0,2,0,0,8,0,0,1,2,0.5,0,1,1,3,2,0,1,4,1
2002,Jamal Mashburn,SF,29,CHH,40,40,1601,303,744,0.407,41,112,0.366,262,632,0.415,0.435,211,241,0.876,31,211,242,171,45,6,110,80,858
2002,Desmond Mason,SF,24,SEA,75,20,2420,357,769,0.464,16,59,0.271,341,710,0.48,0.475,201,237,0.848,92,259,351,104,67,27,104,170,931
2002,Tony Massenburg,PF,34,MEM,73,31,1247,159,349,0.456,1,1,1,158,348,0.454,0.457,84,117,0.718,100,224,324,26,30,31,65,174,403
2002,Walter McCarty,PF,27,BOS,56,0,718,80,180,0.444,39,99,0.394,41,81,0.506,0.553,13,19,0.684,32,96,128,41,18,7,22,83,212
2002,George McCloud,SF,34,DEN,69,26,1830,206,576,0.358,60,222,0.27,146,354,0.412,0.41,132,163,0.81,67,184,251,204,58,19,144,175,604
2002,Antonio McDyess,PF,27,DEN,10,10,236,43,75,0.573,0,0,NA,43,75,0.573,0.573,27,33,0.818,18,37,55,18,10,8,20,20,113
2002,Tracy McGrady,SG,22,ORL,76,76,2912,715,1586,0.451,103,283,0.364,612,1303,0.47,0.483,415,555,0.748,150,447,597,400,119,73,189,139,1948
2002,Jeff McInnis,PG,27,LAC,81,80,3030,463,1121,0.413,75,234,0.321,388,887,0.437,0.446,183,219,0.836,45,168,213,500,63,6,147,202,1184
2002,Aaron McKie,SG,29,PHI,48,16,1471,220,490,0.449,51,128,0.398,169,362,0.467,0.501,96,122,0.787,26,166,192,179,56,14,93,74,587
2002,Ron Mercer,SG,25,CHI,40,40,1503,286,717,0.399,17,57,0.298,269,660,0.408,0.411,84,108,0.778,44,111,155,118,30,10,79,86,673
2002,Ron Mercer,SG,25,IND,13,1,213,25,67,0.373,1,5,0.2,24,62,0.387,0.381,11,11,1,6,17,23,10,2,3,9,22,62
2002,Chris Mihm,C,22,CLE,74,60,1659,221,526,0.42,3,7,0.429,218,519,0.42,0.423,124,179,0.693,133,259,392,24,18,89,97,260,569
2002,Darius Miles,SF,20,LAC,82,6,2227,309,642,0.481,3,19,0.158,306,623,0.491,0.484,158,255,0.62,109,344,453,184,71,103,160,184,779
2002,Andre Miller,PG,25,CLE,81,81,3023,474,1045,0.454,22,87,0.253,452,958,0.472,0.464,365,447,0.817,108,271,379,882,126,34,245,228,1335
2002,Brad Miller,C,25,CHI,48,47,1391,208,452,0.46,2,4,0.5,206,448,0.46,0.462,190,253,0.751,176,225,401,101,52,29,74,156,608
2002,Brad Miller,C,25,IND,28,28,872,158,281,0.562,1,3,0.333,157,278,0.565,0.564,107,130,0.823,76,144,220,51,24,12,41,88,424
2002,Mike Miller,SF,21,ORL,63,53,2123,351,802,0.438,116,303,0.383,235,499,0.471,0.51,138,181,0.762,49,224,273,198,47,23,108,145,956
2002,Cuttino Mobley,SG,26,HOU,74,74,3116,595,1358,0.438,149,377,0.395,446,981,0.455,0.493,267,314,0.85,63,237,300,187,109,37,180,189,1606
2002,Nazr Mohammed,C,24,ATL,82,73,2168,329,713,0.461,0,1,0,329,712,0.462,0.461,137,222,0.617,242,409,651,33,63,61,118,252,795
2002,Jérôme Moïso,C,23,CHH,15,0,76,8,20,0.4,0,0,NA,8,20,0.4,0.4,0,0,NA,4,21,25,4,3,2,8,12,16
2002,Eric Montross,C,30,TOR,49,24,655,53,132,0.402,0,1,0,53,131,0.405,0.402,10,31,0.323,36,104,140,16,12,23,25,92,116
2002,Mikki Moore,C,26,DET,30,0,217,29,61,0.475,1,2,0.5,28,59,0.475,0.484,20,26,0.769,22,31,53,11,7,9,14,35,79
2002,Alonzo Mourning,C,31,MIA,75,74,2455,447,866,0.516,1,3,0.333,446,863,0.517,0.517,283,431,0.657,182,450,632,87,27,186,182,258,1178
2002,Troy Murphy,PF,21,GSW,82,4,1448,178,423,0.421,3,9,0.333,175,414,0.423,0.424,121,156,0.776,99,223,322,70,36,21,84,217,480
2002,Tracy Murray,SF,30,TOR,40,3,473,85,207,0.411,40,104,0.385,45,103,0.437,0.507,17,21,0.81,18,35,53,19,11,8,25,38,227
2002,Dikembe Mutombo,C,35,PHI,80,80,2907,321,641,0.501,0,0,NA,321,641,0.501,0.501,278,364,0.764,254,609,863,83,29,190,156,242,920
2002,Mamadou N'Diaye,C,26,TOR,5,0,46,6,10,0.6,0,0,NA,6,10,0.6,0.6,8,10,0.8,6,5,11,0,0,2,1,6,20
2002,Lee Nailon,SF,26,CHH,79,41,1912,369,764,0.483,1,2,0.5,368,762,0.483,0.484,112,150,0.747,103,188,291,94,59,17,96,175,851
2002,Eduardo Nájera,PF,25,DAL,62,11,1357,150,300,0.5,0,2,0,150,298,0.503,0.5,100,148,0.676,149,193,342,38,56,30,40,156,400
2002,Tyrone Nesby,SF,26,WAS,70,9,1498,183,421,0.435,13,47,0.277,170,374,0.455,0.45,64,93,0.688,105,213,318,91,61,22,49,164,443
2002,Ira Newble,SF,27,ATL,42,35,1273,131,263,0.498,1,7,0.143,130,256,0.508,0.5,75,88,0.852,80,142,222,45,38,20,49,117,338
2002,Johnny Newman,SF,38,DAL,47,17,724,67,148,0.453,22,57,0.386,45,91,0.495,0.527,42,58,0.724,9,40,49,14,29,4,21,88,198
2002,Moochie Norris,PG,28,HOU,82,26,2249,251,631,0.398,36,134,0.269,215,497,0.433,0.426,127,169,0.751,73,173,246,403,81,4,156,130,665
2002,Jermaine O'Neal,PF,23,IND,72,72,2707,543,1133,0.479,1,14,0.071,542,1119,0.484,0.48,284,413,0.688,188,569,757,118,45,166,174,269,1371
2002,Shaquille O'Neal,C,29,LAL,67,66,2422,712,1229,0.579,0,1,0,712,1228,0.58,0.579,398,717,0.555,235,480,715,200,41,137,171,199,1822
2002,Kevin Ollie,PG,29,CHI,52,17,1146,97,253,0.383,1,2,0.5,96,251,0.382,0.385,109,130,0.838,18,110,128,193,36,1,80,64,304
2002,Kevin Ollie,PG,29,IND,29,0,577,40,100,0.4,0,0,NA,40,100,0.4,0.4,78,97,0.804,7,49,56,98,26,1,26,33,158
2002,Michael Olowokandi,C,26,LAC,80,79,2568,384,886,0.433,0,0,NA,384,886,0.433,0.433,117,188,0.622,164,547,711,90,55,145,175,217,885
2002,Bo Outlaw,PF,30,ORL,10,0,160,13,21,0.619,0,0,NA,13,21,0.619,0.619,8,18,0.444,15,14,29,5,9,9,11,23,34
2002,Bo Outlaw,PF,30,PHO,73,36,1768,153,278,0.55,1,2,0.5,152,276,0.551,0.552,35,84,0.417,132,203,335,122,61,83,85,182,342
2002,Doug Overton,PG,32,LAC,18,0,130,14,44,0.318,7,27,0.259,7,17,0.412,0.398,4,7,0.571,1,11,12,13,3,1,12,10,39
2002,Robert Pack,PG,32,MIN,16,0,252,25,68,0.368,1,4,0.25,24,64,0.375,0.375,11,15,0.733,7,16,23,49,13,0,20,32,62
2002,Scott Padgett,PF,25,UTA,75,1,1295,188,395,0.476,49,113,0.434,139,282,0.493,0.538,75,102,0.735,111,174,285,82,43,13,69,140,500
2002,Milt Palacio,PG,23,BOS,41,0,518,52,135,0.385,12,34,0.353,40,101,0.396,0.43,36,51,0.706,8,42,50,54,21,3,24,38,152
2002,Milt Palacio,SG,23,PHO,28,1,272,30,79,0.38,1,7,0.143,29,72,0.403,0.386,18,23,0.783,3,20,23,29,9,1,16,23,79
2002,Cherokee Parks,C,29,SAS,42,1,234,30,83,0.361,0,0,NA,30,83,0.361,0.361,3,8,0.375,24,34,58,10,7,8,14,34,63
2002,Ruben Patterson,SF,26,POR,75,13,1765,319,619,0.515,9,36,0.25,310,583,0.532,0.523,192,274,0.701,155,143,298,107,79,37,114,140,839
2002,Gary Payton,PG,33,SEA,82,82,3301,737,1578,0.467,74,236,0.314,663,1342,0.494,0.49,267,335,0.797,80,316,396,737,131,26,209,179,1815
2002,Anthony Peeler,SG,32,MIN,82,0,2060,288,684,0.421,111,283,0.392,177,401,0.441,0.502,50,58,0.862,37,169,206,177,61,11,76,137,737
2002,Elliot Perry,PG,32,MEM,2,0,48,5,10,0.5,0,0,NA,5,10,0.5,0.5,1,2,0.5,0,4,4,7,3,0,7,6,11
2002,Wesley Person,SG,30,CLE,78,78,2793,467,944,0.495,143,322,0.444,324,622,0.521,0.57,99,124,0.798,50,244,294,173,77,37,74,93,1176
2002,James Posey,SF,25,DEN,73,63,2238,277,736,0.376,67,237,0.283,210,499,0.421,0.422,161,203,0.793,109,320,429,180,114,39,127,224,782
2002,Vitaly Potapenko,C,26,BOS,79,9,1343,137,301,0.455,0,0,NA,137,301,0.455,0.455,89,120,0.742,167,180,347,30,37,18,63,174,363
2002,Joel Przybilla,C,22,MIL,71,62,1128,76,142,0.535,0,1,0,76,141,0.539,0.535,38,90,0.422,78,205,283,21,20,118,43,199,190
2002,Vladimir Radmanović,PF,21,SEA,61,16,1230,146,354,0.412,66,157,0.42,80,197,0.406,0.506,49,72,0.681,45,185,230,81,56,24,72,119,407
2002,Zach Randolph,PF,20,POR,41,0,238,48,107,0.449,0,0,NA,48,107,0.449,0.449,18,27,0.667,31,38,69,13,7,4,15,29,114
2002,Theo Ratliff,C,28,ATL,3,2,82,10,20,0.5,0,0,NA,10,20,0.5,0.5,6,11,0.545,5,11,16,1,1,8,7,8,26
2002,Željko Rebrača,C,29,DET,74,4,1179,189,374,0.505,0,0,NA,189,374,0.505,0.505,135,175,0.771,84,206,290,38,28,73,84,192,513
2002,Eldridge Recasner,SG,34,CHH,1,0,2,0,0,NA,0,0,NA,0,0,NA,NA,0,0,NA,0,0,0,0,0,0,0,1,0
2002,Eldridge Recasner,PG,34,LAC,5,0,31,2,6,0.333,0,1,0,2,5,0.4,0.333,1,1,1,0,0,0,5,1,0,1,3,5
2002,Don Reid,PF,28,ORL,68,5,714,90,190,0.474,0,0,NA,90,190,0.474,0.474,44,68,0.647,65,111,176,27,20,44,54,180,224
2002,Jason Richardson,SG,21,GSW,80,75,2629,464,1090,0.426,82,246,0.333,382,844,0.453,0.463,141,210,0.671,124,216,340,236,106,31,160,195,1151
2002,Norm Richardson,SG,22,IND,3,0,4,0,3,0,0,0,NA,0,3,0,0,0,0,NA,1,0,1,1,0,0,0,0,0
2002,Norm Richardson,SG,22,CHI,8,0,63,10,23,0.435,4,8,0.5,6,15,0.4,0.522,6,9,0.667,2,5,7,1,0,0,3,5,30
2002,Clifford Robinson,PF,35,DET,80,80,2855,454,1069,0.425,115,304,0.378,339,765,0.443,0.478,143,206,0.694,79,307,386,202,89,95,151,243,1166
2002,Larry Robinson,SG,34,NYK,2,0,10,1,4,0.25,1,2,0.5,0,2,0,0.375,0,0,NA,0,2,2,0,0,0,0,1,3
2002,Carlos Rogers,C,30,IND,22,1,168,24,43,0.558,1,6,0.167,23,37,0.622,0.57,10,19,0.526,14,24,38,3,5,6,5,17,59
2002,Rodney Rogers,SF,30,PHO,50,7,1254,249,534,0.466,49,140,0.35,200,394,0.508,0.512,82,99,0.828,95,146,241,72,50,17,66,148,629
2002,Rodney Rogers,SF,30,BOS,27,1,626,107,222,0.482,39,95,0.411,68,127,0.535,0.57,35,50,0.7,34,73,107,40,16,12,42,78,288
2002,Sean Rooks,C,32,LAC,61,2,728,81,194,0.418,0,0,NA,81,194,0.418,0.418,21,29,0.724,32,92,124,25,12,21,20,114,183
2002,Jalen Rose,SF,29,IND,53,53,1937,387,871,0.444,52,146,0.356,335,725,0.462,0.474,156,186,0.839,29,220,249,197,45,29,105,148,982
2002,Jalen Rose,SF,29,CHI,30,30,1216,276,587,0.47,37,100,0.37,239,487,0.491,0.502,125,149,0.839,14,110,124,158,33,16,96,103,714
2002,Malik Rose,PF,27,SAS,82,1,1725,293,633,0.463,1,12,0.083,292,621,0.47,0.464,185,257,0.72,172,320,492,61,70,42,140,208,772
2002,Kenny Satterfield,PG,20,DEN,36,4,560,73,199,0.367,7,27,0.259,66,172,0.384,0.384,36,46,0.783,17,35,52,108,31,1,53,43,189
2002,Brian Shaw,PG,35,LAL,58,0,631,61,173,0.353,29,88,0.33,32,85,0.376,0.436,18,26,0.692,19,93,112,89,25,3,32,43,169
2002,Dickey Simpkins,PF,29,ATL,1,0,3,0,0,NA,0,0,NA,0,0,NA,NA,0,0,NA,0,0,0,1,0,0,0,0,0
2002,Brian Skinner,PF,25,CLE,65,8,1107,88,162,0.543,0,0,NA,88,162,0.543,0.543,48,79,0.608,93,188,281,17,24,61,42,130,224
2002,Reggie Slater,PF,31,NJN,4,0,10,2,2,1,0,0,NA,2,2,1,1,1,1,1,0,2,2,0,0,0,1,1,5
2002,Reggie Slater,PF,31,ATL,4,0,37,5,13,0.385,0,0,NA,5,13,0.385,0.385,6,9,0.667,5,2,7,1,1,1,0,2,16
2002,Charles Smith,SG,26,SAS,60,22,1141,182,428,0.425,35,131,0.267,147,297,0.495,0.466,42,65,0.646,34,99,133,80,52,44,59,114,441
2002,Jabari Smith,C,24,SAC,12,0,71,6,21,0.286,0,1,0,6,20,0.3,0.286,6,12,0.5,2,12,14,6,2,4,2,12,18
2002,Jabari Smith,C,24,PHI,11,0,110,20,42,0.476,0,2,0,20,40,0.5,0.476,15,20,0.75,6,8,14,5,4,2,3,19,55
2002,Joe Smith,C,26,MIN,72,63,1922,297,581,0.511,2,3,0.667,295,578,0.51,0.513,171,206,0.83,152,301,453,82,39,59,86,250,767
2002,Steve Smith,SG,32,SAS,77,76,2211,310,682,0.455,116,246,0.472,194,436,0.445,0.54,159,181,0.878,45,148,193,151,54,15,108,158,895
2002,Eric Snow,PG,28,PHI,61,61,2225,276,624,0.442,3,27,0.111,273,597,0.457,0.445,183,227,0.806,33,182,215,400,95,9,138,167,738
2002,Will Solomon,SG,23,MEM,62,4,872,113,331,0.341,46,162,0.284,67,169,0.396,0.411,49,73,0.671,12,56,68,92,35,7,62,76,321
2002,Felton Spencer,C,34,NYK,32,8,248,6,26,0.231,0,0,NA,6,26,0.231,0.231,17,33,0.515,16,34,50,3,7,8,12,73,29
2002,Jerry Stackhouse,SF,27,DET,76,76,2685,524,1319,0.397,86,300,0.287,438,1019,0.43,0.43,495,577,0.858,77,238,315,403,77,37,266,163,1629
2002,John Starks,SG,36,UTA,66,1,929,114,310,0.368,29,95,0.305,85,215,0.395,0.415,33,41,0.805,15,53,68,70,33,0,52,126,290
2002,DeShawn Stevenson,SG,20,UTA,67,23,1134,143,371,0.385,2,25,0.08,141,346,0.408,0.388,37,53,0.698,44,87,131,116,29,24,68,82,325
2002,Michael Stewart,C,26,TOR,11,0,93,8,23,0.348,0,0,NA,8,23,0.348,0.348,6,11,0.545,12,13,25,3,4,3,4,22,22
2002,Peja Stojaković,SF,24,SAC,71,71,2649,547,1130,0.484,129,310,0.416,418,820,0.51,0.541,283,323,0.876,72,301,373,175,81,14,140,120,1506
2002,Damon Stoudamire,PG,28,POR,75,71,2796,369,918,0.402,104,295,0.353,265,623,0.425,0.459,174,196,0.888,78,214,292,490,67,7,149,153,1016
2002,Erick Strickland,PG,28,BOS,79,4,1643,190,488,0.389,95,247,0.385,95,241,0.394,0.487,131,155,0.845,22,191,213,184,56,1,94,145,606
2002,Mark Strickland,SF,31,ATL,46,10,654,91,204,0.446,1,4,0.25,90,200,0.45,0.449,25,44,0.568,41,90,131,20,19,17,28,48,208
2002,Rod Strickland,PG,35,MIA,76,64,2294,316,714,0.443,8,26,0.308,308,688,0.448,0.448,154,201,0.766,49,183,232,463,82,11,159,114,794
2002,Bruno Šundov,C,21,IND,22,0,88,16,40,0.4,0,1,0,16,39,0.41,0.4,0,2,0,7,14,21,3,3,3,4,16,32
2002,Bob Sura,PG,28,GSW,78,5,1780,250,590,0.424,42,133,0.316,208,457,0.455,0.459,236,328,0.72,89,167,256,275,88,17,133,160,778
2002,Stromile Swift,PF,22,MEM,68,14,1805,293,611,0.48,0,3,0,293,608,0.482,0.48,217,305,0.711,161,269,430,50,53,113,122,178,803
2002,Wally Szczerbiak,SF,24,MIN,82,82,3117,609,1200,0.508,87,191,0.455,522,1009,0.517,0.544,226,272,0.831,120,271,391,257,66,21,181,188,1531
2002,Kenny Thomas,PF,24,HOU,72,71,2484,396,829,0.478,0,16,0,396,813,0.487,0.478,223,336,0.664,158,358,516,137,85,66,143,195,1015
2002,Kurt Thomas,C,29,NYK,82,82,2771,463,938,0.494,1,6,0.167,462,932,0.496,0.494,216,265,0.815,214,533,747,87,71,79,153,341,1143
2002,Tim Thomas,SF,24,MIL,74,22,1987,316,753,0.42,95,291,0.326,221,462,0.478,0.483,142,179,0.793,64,236,300,105,65,32,127,200,869
2002,Gary Trent,PF,27,MIN,64,10,1140,193,381,0.507,0,2,0,193,379,0.509,0.507,92,144,0.639,104,166,270,60,21,27,58,160,478
2002,Jake Tsakalidis,C,22,PHO,67,47,1582,190,400,0.475,0,1,0,190,399,0.476,0.475,111,159,0.698,130,244,374,23,23,69,78,193,491
2002,Hedo Türkoğlu,SF,22,SAC,80,10,1970,290,687,0.422,63,171,0.368,227,516,0.44,0.468,167,230,0.726,63,300,363,163,57,31,81,184,810
2002,Nick Van Exel,PG,30,DEN,45,44,1739,372,912,0.408,85,252,0.337,287,660,0.435,0.454,136,174,0.782,19,150,169,365,30,7,116,69,965
2002,Nick Van Exel,SG,30,DAL,27,2,757,129,314,0.411,34,98,0.347,95,216,0.44,0.465,65,77,0.844,9,76,85,113,14,4,40,35,357
2002,Keith Van Horn,SF,26,NJN,81,81,2465,471,1089,0.433,101,293,0.345,370,796,0.465,0.479,156,195,0.8,137,472,609,164,63,42,146,221,1199
2002,Antoine Walker,PF,25,BOS,81,81,3406,666,1689,0.394,222,645,0.344,444,1044,0.425,0.46,240,324,0.741,150,564,714,407,122,38,251,237,1794
2002,Ben Wallace,C,27,DET,80,80,2921,255,480,0.531,0,3,0,255,477,0.535,0.531,99,234,0.423,318,721,1039,115,138,278,70,178,609
2002,Gerald Wallace,SF,19,SAC,54,1,430,75,175,0.429,0,7,0,75,168,0.446,0.429,23,46,0.5,49,40,89,27,19,6,22,46,173
2002,Rasheed Wallace,PF,27,POR,79,79,2963,603,1287,0.469,114,317,0.36,489,970,0.504,0.513,201,274,0.734,136,509,645,152,101,101,131,212,1521
2002,Charlie Ward,PG,31,NYK,63,0,1058,113,303,0.373,53,164,0.323,60,139,0.432,0.46,47,58,0.81,15,112,127,203,68,14,75,100,326
2002,Earl Watson,PG,22,SEA,64,0,964,96,212,0.453,16,44,0.364,80,168,0.476,0.491,23,36,0.639,31,52,83,125,60,5,51,93,231
2002,Clarence Weatherspoon,PF,31,NYK,56,41,1728,189,452,0.418,0,0,NA,189,452,0.418,0.418,116,146,0.795,149,311,460,60,37,48,47,132,494
2002,Chris Webber,PF,28,SAC,54,54,2071,532,1075,0.495,5,19,0.263,527,1056,0.499,0.497,253,338,0.749,150,396,546,258,90,76,158,181,1322
2002,Bonzi Wells,SG,25,POR,74,69,2348,487,1039,0.469,66,172,0.384,421,867,0.486,0.5,215,290,0.741,121,323,444,204,113,25,191,208,1255
2002,David Wesley,SG,31,CHH,67,63,2487,364,910,0.4,85,256,0.332,279,654,0.427,0.447,138,188,0.734,44,99,143,236,74,15,119,147,951
2002,Jahidi White,C,25,WAS,71,69,1346,150,279,0.538,0,0,NA,150,279,0.538,0.538,83,154,0.539,159,285,444,17,25,75,65,163,383
2002,Rodney White,SF,21,DET,16,0,129,21,60,0.35,2,9,0.222,19,51,0.373,0.367,12,14,0.857,2,16,18,12,9,2,14,6,56
2002,Chris Whitney,PG,30,WAS,82,81,2171,274,656,0.418,131,323,0.406,143,333,0.429,0.518,154,175,0.88,11,141,152,314,72,6,85,182,833
2002,Aaron Williams,PF,30,NJN,82,13,1546,231,439,0.526,0,2,0,231,437,0.529,0.526,130,186,0.699,115,224,339,77,29,76,79,212,592
2002,Alvin Williams,PG,27,TOR,82,82,2927,403,971,0.415,62,193,0.321,341,778,0.438,0.447,103,140,0.736,58,223,281,468,135,26,150,191,971
2002,Eric Williams,SF,29,BOS,74,30,1747,144,385,0.374,24,86,0.279,120,299,0.401,0.405,160,219,0.731,58,163,221,109,77,8,95,179,472
2002,Jason Williams,PG,26,MEM,65,65,2236,376,985,0.382,127,430,0.295,249,555,0.449,0.446,80,101,0.792,22,173,195,519,111,7,214,102,959
2002,Jerome Williams,PF,28,TOR,68,32,1641,190,388,0.49,0,0,NA,190,388,0.49,0.49,138,204,0.676,165,221,386,75,78,25,68,153,518
2002,Monty Williams,SF,30,ORL,68,19,1284,198,362,0.547,0,4,0,198,358,0.553,0.547,88,134,0.657,80,155,235,96,49,17,86,134,484
2002,Scott Williams,PF,33,DEN,41,16,737,86,217,0.396,0,2,0,86,215,0.4,0.396,30,41,0.732,82,127,209,13,17,33,35,98,202
2002,Shammond Williams,SG,26,SEA,50,2,603,81,193,0.42,28,75,0.373,53,118,0.449,0.492,31,39,0.795,16,47,63,83,21,2,35,35,221
2002,Walt Williams,SF,31,HOU,48,25,1117,166,396,0.419,78,183,0.426,88,213,0.413,0.518,40,51,0.784,37,125,162,69,18,10,53,106,450
2002,Corliss Williamson,SF,28,DET,78,7,1701,411,806,0.51,1,5,0.2,410,801,0.512,0.511,240,298,0.805,117,202,319,94,49,26,137,226,1063
2002,Kevin Willis,PF,39,HOU,52,5,865,125,284,0.44,0,1,0,125,283,0.442,0.44,65,87,0.747,105,194,299,14,25,23,41,98,315
2002,Metta World Peace,SF,22,CHI,27,26,823,152,351,0.433,36,91,0.396,116,260,0.446,0.484,81,129,0.628,40,91,131,77,75,23,69,108,421
2002,Metta World Peace,SF,22,IND,28,24,819,117,285,0.411,17,79,0.215,100,206,0.485,0.44,55,75,0.733,33,107,140,50,66,16,49,109,306
2002,Lorenzen Wright,C,26,MEM,43,33,1251,223,486,0.459,0,2,0,223,484,0.461,0.459,70,123,0.569,130,275,405,44,30,23,72,126,516
2002,Wang Zhizhi,C,24,DAL,55,0,600,109,248,0.44,48,116,0.414,61,132,0.462,0.536,42,57,0.737,19,92,111,22,11,18,25,84,308
2003,Tariq Abdul-Wahad,SG,28,DAL,14,0,204,27,58,0.466,0,1,0,27,57,0.474,0.466,3,6,0.5,14,26,40,21,6,3,7,26,57
2003,Shareef Abdur-Rahim,PF,26,ATL,81,81,3087,566,1183,0.478,21,60,0.35,545,1123,0.485,0.487,455,541,0.841,175,502,677,242,87,38,212,240,1608
2003,Courtney Alexander,PG,25,NOH,66,7,1360,193,505,0.382,19,57,0.333,174,448,0.388,0.401,118,146,0.808,39,79,118,79,31,6,68,125,523
2003,Malik Allen,PF,24,MIA,80,73,2318,335,790,0.424,0,4,0,335,786,0.426,0.424,97,121,0.802,134,291,425,54,37,78,128,234,767
2003,Ray Allen,SG,27,MIL,47,46,1683,351,803,0.437,123,311,0.395,228,492,0.463,0.514,178,195,0.913,45,173,218,164,57,11,117,149,1003
2003,Ray Allen,SG,27,SEA,29,29,1197,247,560,0.441,78,222,0.351,169,338,0.5,0.511,138,150,0.92,49,114,163,170,46,3,81,71,710
2003,Rafer Alston,PG,26,TOR,47,4,980,139,335,0.415,51,130,0.392,88,205,0.429,0.491,37,54,0.685,21,86,107,192,38,15,86,120,366
2003,Chris Andersen,C,24,DEN,59,3,907,114,285,0.4,0,1,0,114,284,0.401,0.4,77,140,0.55,109,165,274,32,30,60,60,90,305
2003,Derek Anderson,PG,28,POR,76,76,2556,355,832,0.427,116,331,0.35,239,501,0.477,0.496,231,269,0.859,53,211,264,325,90,16,128,141,1057
2003,Kenny Anderson,PG,32,SEA,38,1,689,102,232,0.44,0,5,0,102,227,0.449,0.44,29,35,0.829,17,70,87,121,40,1,33,63,233
2003,Kenny Anderson,PG,32,NOH,23,1,446,61,150,0.407,1,2,0.5,60,148,0.405,0.41,16,22,0.727,14,31,45,77,18,4,42,43,139
2003,Shandon Anderson,SF,29,NYK,82,9,1731,248,537,0.462,52,140,0.371,196,397,0.494,0.51,139,190,0.732,64,190,254,87,73,20,114,177,687
2003,Robert Archibald,PF,22,MEM,12,0,72,6,20,0.3,0,0,NA,6,20,0.3,0.3,7,18,0.389,6,11,17,3,0,3,7,9,19
2003,Gilbert Arenas,PG,21,GSW,82,82,2866,509,1180,0.431,109,313,0.348,400,867,0.461,0.478,370,468,0.791,97,289,386,514,124,17,290,260,1497
2003,Darrell Armstrong,PG,34,ORL,82,23,2350,263,643,0.409,78,232,0.336,185,411,0.45,0.47,165,188,0.878,91,204,295,323,135,13,160,167,769
2003,Carlos Arroyo,PG,23,UTA,44,0,287,50,109,0.459,3,7,0.429,47,102,0.461,0.472,18,22,0.818,11,15,26,53,12,1,30,28,121
2003,Chucky Atkins,PG,28,DET,65,7,1398,168,465,0.361,86,242,0.355,82,223,0.368,0.454,40,49,0.816,21,75,96,175,27,4,77,108,462
2003,Stacey Augmon,SG,34,NOH,70,3,862,79,192,0.411,0,7,0,79,185,0.427,0.411,54,72,0.75,26,93,119,69,27,9,40,80,212
2003,Vin Baker,C,31,BOS,52,9,942,99,207,0.478,0,4,0,99,203,0.488,0.478,72,107,0.673,90,108,198,29,22,30,61,146,270
2003,Brent Barry,SG,31,SEA,75,68,2480,264,577,0.458,118,293,0.403,146,284,0.514,0.56,128,161,0.795,48,253,301,384,113,15,142,199,774
2003,Jon Barry,SG,33,DET,80,0,1473,191,424,0.45,87,214,0.407,104,210,0.495,0.553,86,100,0.86,33,147,180,206,63,14,81,104,555
2003,Tony Battie,C,26,BOS,67,62,1683,199,369,0.539,1,5,0.2,198,364,0.544,0.541,88,118,0.746,148,285,433,49,33,81,48,197,487
2003,Shane Battier,SF,24,MEM,78,47,2383,275,569,0.483,86,216,0.398,189,353,0.535,0.559,120,145,0.828,128,217,345,105,102,88,68,207,756
2003,Lonny Baxter,C,24,CHI,55,0,682,96,206,0.466,0,2,0,96,204,0.471,0.466,70,103,0.68,65,100,165,16,9,22,46,135,262
2003,Raja Bell,SG,26,DAL,75,32,1173,93,211,0.441,21,51,0.412,72,160,0.45,0.491,23,34,0.676,47,98,145,57,52,8,43,134,230
2003,Travis Best,PG,30,MIA,72,52,1807,231,583,0.396,36,109,0.33,195,474,0.411,0.427,105,123,0.854,26,121,147,255,44,7,106,174,603
2003,Mike Bibby,PG,24,SAC,55,55,1835,329,700,0.47,56,137,0.409,273,563,0.485,0.51,161,187,0.861,34,113,147,285,72,8,127,93,875
2003,Chauncey Billups,PG,26,DET,74,74,2327,366,870,0.421,149,380,0.392,217,490,0.443,0.506,318,362,0.878,38,235,273,287,63,15,134,136,1199
2003,Corie Blount,C,34,CHI,50,3,836,65,134,0.485,0,0,NA,65,134,0.485,0.485,20,35,0.571,68,137,205,50,33,19,43,121,150
2003,Mark Blount,C,27,DEN,54,24,885,105,267,0.393,0,0,NA,105,267,0.393,0.393,71,99,0.717,62,121,183,35,22,51,70,112,281
2003,Mark Blount,C,27,BOS,27,7,518,45,80,0.563,0,0,NA,45,80,0.563,0.563,30,40,0.75,49,76,125,21,20,17,33,75,120
2003,Calvin Booth,C,26,SEA,47,0,575,52,119,0.437,0,2,0,52,117,0.444,0.437,34,47,0.723,32,77,109,12,11,33,22,74,138
2003,Bruce Bowen,SF,31,SAS,82,82,2566,223,479,0.466,101,229,0.441,122,250,0.488,0.571,36,89,0.404,59,180,239,113,66,42,72,195,583
2003,Earl Boykins,PG,26,GSW,68,0,1321,199,464,0.429,29,77,0.377,170,387,0.439,0.46,173,200,0.865,35,53,88,221,38,4,73,75,600
2003,Michael Bradley,PF,23,TOR,67,11,1314,151,314,0.481,1,6,0.167,150,308,0.487,0.482,35,67,0.522,162,247,409,67,16,32,76,125,338
2003,Shawn Bradley,C,30,DAL,81,39,1731,201,375,0.536,0,1,0,201,374,0.537,0.536,141,175,0.806,151,325,476,54,65,170,67,242,543
2003,J.R. Bremer,PG,22,BOS,64,41,1503,171,464,0.369,101,286,0.353,70,178,0.393,0.477,85,111,0.766,18,127,145,164,38,3,59,80,528
2003,Primož Brezec,C,23,IND,22,1,111,15,38,0.395,0,1,0,15,37,0.405,0.395,12,20,0.6,13,10,23,4,2,4,7,16,42
2003,Devin Brown,SG,24,SAS,7,0,22,5,10,0.5,0,0,NA,5,10,0.5,0.5,2,2,1,4,3,7,2,0,0,5,3,12
2003,Devin Brown,SG,24,DEN,3,2,71,7,25,0.28,0,1,0,7,24,0.292,0.28,4,6,0.667,4,7,11,5,4,1,4,11,18
2003,Kedrick Brown,SF,21,BOS,51,5,666,61,171,0.357,3,39,0.077,58,132,0.439,0.365,20,32,0.625,45,95,140,20,34,13,23,68,145
2003,Kwame Brown,C,20,WAS,80,20,1773,224,502,0.446,0,3,0,224,499,0.449,0.446,145,217,0.668,128,298,426,58,50,80,110,159,593
2003,Rick Brunson,PG,30,CHI,17,0,196,23,50,0.46,4,6,0.667,19,44,0.432,0.5,10,12,0.833,4,15,19,36,10,3,17,20,60
2003,Mark Bryant,PF,37,PHI,11,0,77,5,17,0.294,0,0,NA,5,17,0.294,0.294,2,2,1,7,9,16,1,1,1,5,12,12
2003,Mark Bryant,PF,37,DEN,3,0,14,0,1,0,0,0,NA,0,1,0,0,1,2,0.5,1,1,2,2,0,0,2,4,1
2003,Mark Bryant,PF,37,BOS,2,0,9,0,1,0,0,0,NA,0,1,0,0,0,0,NA,0,2,2,1,0,0,0,2,0
2003,Caron Butler,SF,22,MIA,78,78,2858,429,1032,0.416,34,107,0.318,395,925,0.427,0.432,309,375,0.824,135,262,397,213,137,31,192,230,1201
2003,Rasual Butler,SG,23,MIA,72,28,1514,207,572,0.362,50,171,0.292,157,401,0.392,0.406,76,104,0.731,29,157,186,93,21,43,77,105,540
2003,Jason Caffey,PF,29,MIL,51,16,894,113,248,0.456,0,0,NA,113,248,0.456,0.456,69,106,0.651,68,108,176,38,19,15,56,122,295
2003,Marcus Camby,C,28,DEN,29,9,616,93,227,0.41,2,5,0.4,91,222,0.41,0.414,33,50,0.66,75,133,208,47,20,40,27,69,221
2003,Elden Campbell,C,34,NOH,41,1,685,101,247,0.409,0,1,0,101,246,0.411,0.409,93,115,0.809,34,108,142,42,24,31,42,102,295
2003,Elden Campbell,C,34,SEA,15,0,184,16,48,0.333,0,0,NA,16,48,0.333,0.333,16,21,0.762,13,26,39,9,9,8,8,27,48
2003,Anthony Carter,PG,27,MIA,49,26,912,83,233,0.356,0,8,0,83,225,0.369,0.356,33,50,0.66,12,71,83,203,45,5,81,70,199
2003,Vince Carter,SG,26,TOR,43,42,1471,355,760,0.467,45,131,0.344,310,629,0.493,0.497,129,160,0.806,59,129,188,143,48,41,74,121,884
2003,Sam Cassell,PG,33,MIL,78,77,2700,546,1162,0.47,59,163,0.362,487,999,0.487,0.495,385,447,0.861,57,285,342,450,88,14,177,216,1536
2003,Kelvin Cato,C,28,HOU,73,5,1247,133,256,0.52,0,4,0,133,252,0.528,0.52,66,124,0.532,132,296,428,20,38,85,56,176,332
2003,Tyson Chandler,C,20,CHI,75,68,1827,257,484,0.531,0,0,NA,257,484,0.531,0.531,177,291,0.608,169,345,514,76,37,106,135,220,691
2003,Chris Childs,PG,35,NJN,12,0,106,6,20,0.3,1,6,0.167,5,14,0.357,0.325,2,3,0.667,3,2,5,16,8,1,6,17,15
2003,Doug Christie,SG,32,SAC,80,80,2710,267,557,0.479,73,185,0.395,194,372,0.522,0.545,141,174,0.81,61,281,342,376,180,37,144,186,748
2003,Keon Clark,C,27,SAC,80,11,1780,226,451,0.501,0,4,0,226,447,0.506,0.501,84,128,0.656,138,313,451,80,38,150,94,227,536
2003,Speedy Claxton,PG,24,SAS,30,0,471,67,145,0.462,0,11,0,67,134,0.5,0.462,39,57,0.684,22,34,56,75,22,7,35,43,173
2003,Bimbo Coles,PG,34,CLE,21,11,516,34,119,0.286,7,25,0.28,27,94,0.287,0.315,27,34,0.794,10,38,48,56,11,4,18,43,102
2003,Bimbo Coles,PG,34,BOS,14,0,175,22,49,0.449,0,7,0,22,42,0.524,0.449,8,8,1,1,10,11,16,6,0,10,17,52
2003,Jarron Collins,C,24,UTA,22,7,421,38,86,0.442,0,1,0,38,85,0.447,0.442,44,62,0.71,32,28,60,14,5,6,19,70,120
2003,Jason Collins,C,24,NJN,81,66,1900,140,338,0.414,0,4,0,140,334,0.419,0.414,180,236,0.763,136,232,368,87,47,44,85,252,460
2003,Jamal Crawford,PG,22,CHI,80,31,1992,334,808,0.413,86,242,0.355,248,566,0.438,0.467,104,129,0.806,21,164,185,334,77,25,134,126,858
2003,Austin Croshere,PF,27,IND,49,0,633,86,209,0.411,27,69,0.391,59,140,0.421,0.476,53,65,0.815,40,115,155,56,6,13,28,48,252
2003,John Crotty,PG,33,DEN,12,0,180,14,41,0.341,4,13,0.308,10,28,0.357,0.39,9,15,0.6,1,14,15,29,3,0,9,16,41
2003,Michael Curry,SF,34,DET,78,77,1555,92,229,0.402,16,54,0.296,76,175,0.434,0.437,36,45,0.8,16,111,127,104,44,4,43,163,236
2003,Antonio Daniels,SG,27,POR,67,2,872,84,186,0.452,18,59,0.305,66,127,0.52,0.5,65,76,0.855,11,61,72,85,33,9,32,43,251
2003,Antonio Davis,C,34,TOR,53,52,1894,261,641,0.407,0,0,NA,261,641,0.407,0.407,216,280,0.771,130,307,437,131,23,62,118,150,738
2003,Baron Davis,PG,23,NOH,50,47,1889,332,798,0.416,99,283,0.35,233,515,0.452,0.478,93,131,0.71,56,130,186,320,91,22,140,148,856
2003,Dale Davis,C,33,POR,78,78,2282,237,438,0.541,0,0,NA,237,438,0.541,0.541,105,166,0.633,233,331,564,94,51,70,71,189,579
2003,Hubert Davis,SG,32,DET,43,1,328,31,79,0.392,12,36,0.333,19,43,0.442,0.468,5,6,0.833,6,30,36,29,5,0,11,23,79
2003,Ricky Davis,SG,23,CLE,79,76,3131,602,1470,0.41,74,204,0.363,528,1266,0.417,0.435,348,465,0.748,97,293,390,436,125,36,277,180,1626
2003,Andrew DeClercq,C,29,ORL,77,21,1327,149,279,0.534,0,0,NA,149,279,0.534,0.534,67,104,0.644,142,197,339,52,39,36,84,258,365
2003,Tony Delk,PG,29,BOS,67,39,1873,233,560,0.416,120,304,0.395,113,256,0.441,0.523,68,87,0.782,41,191,232,146,72,10,69,124,654
2003,Dan Dickau,PG,24,ATL,50,0,515,70,170,0.412,22,61,0.361,48,109,0.44,0.476,21,26,0.808,9,34,43,85,14,2,53,66,183
2003,DeSagana Diop,PF,21,CLE,80,1,943,54,154,0.351,0,0,NA,54,154,0.351,0.351,11,30,0.367,63,152,215,43,33,81,56,148,119
2003,Juan Dixon,PG,24,WAS,42,3,647,104,271,0.384,25,84,0.298,79,187,0.422,0.43,37,46,0.804,13,59,72,40,26,3,42,54,270
2003,Michael Doleac,C,25,NYK,75,0,1041,146,343,0.426,0,0,NA,146,343,0.426,0.426,36,46,0.783,65,154,219,42,16,16,49,150,328
2003,Chris Dudley,C,37,POR,3,0,11,0,1,0,0,0,NA,0,1,0,0,0,0,NA,2,0,2,0,0,0,0,3,0
2003,Mike Dunleavy,SF,22,GSW,82,3,1305,168,417,0.403,52,150,0.347,116,267,0.434,0.465,78,100,0.78,66,148,214,106,53,19,86,120,466
2003,Howard Eisley,PG,30,NYK,82,76,2243,262,628,0.417,131,337,0.389,131,291,0.45,0.521,89,105,0.848,24,162,186,444,71,9,149,222,744
2003,Melvin Ely,C,24,LAC,52,7,802,92,186,0.495,0,0,NA,92,186,0.495,0.495,52,74,0.703,64,110,174,15,10,32,50,95,236
2003,Reggie Evans,PF,22,SEA,67,60,1365,66,140,0.471,0,0,NA,66,140,0.471,0.471,80,154,0.519,167,278,445,34,38,11,52,173,212
2003,Michael Finley,SF,29,DAL,69,69,2642,507,1193,0.425,119,322,0.37,388,871,0.445,0.475,198,230,0.861,107,295,402,205,76,21,114,105,1331
2003,Derek Fisher,PG,28,LAL,82,82,2829,339,775,0.437,85,212,0.401,254,563,0.451,0.492,100,125,0.8,40,199,239,298,93,15,94,195,863
2003,Greg Foster,C,34,TOR,29,9,539,47,122,0.385,1,4,0.25,46,118,0.39,0.389,26,32,0.813,30,72,102,13,1,9,30,82,121
2003,Adonal Foyle,C,27,GSW,82,0,1787,185,345,0.536,0,1,0,185,344,0.538,0.536,70,104,0.673,176,314,490,37,40,205,73,214,440
2003,Steve Francis,PG,25,HOU,81,81,3318,571,1312,0.435,85,240,0.354,486,1072,0.453,0.468,476,595,0.8,159,340,499,502,141,41,299,251,1703
2003,Dan Gadzuric,C,24,MIL,49,30,760,70,145,0.483,0,1,0,70,144,0.486,0.483,29,56,0.518,66,131,197,9,22,52,27,125,169
2003,Kevin Garnett,PF,26,MIN,82,82,3321,743,1481,0.502,20,71,0.282,723,1410,0.513,0.508,377,502,0.751,244,858,1102,495,113,129,229,199,1883
2003,Pau Gasol,PF,22,MEM,82,82,2948,569,1116,0.51,1,10,0.1,568,1106,0.514,0.51,416,565,0.736,192,528,720,229,34,148,213,220,1555
2003,Kendall Gill,SG,34,MIN,82,34,2068,286,677,0.422,19,59,0.322,267,618,0.432,0.436,123,161,0.764,51,197,248,156,78,15,108,176,714
2003,Gordan Giriček,SG,25,MEM,49,35,1187,207,478,0.433,46,130,0.354,161,348,0.463,0.481,88,107,0.822,18,90,108,70,22,6,94,104,548
2003,Gordan Giriček,SF,25,ORL,27,27,961,143,325,0.44,39,119,0.328,104,206,0.505,0.5,62,76,0.816,18,112,130,67,30,2,51,55,387
2003,Dion Glover,SG,24,ATL,76,42,1890,277,648,0.427,56,158,0.354,221,490,0.451,0.471,127,162,0.784,62,220,282,141,71,15,108,146,737
2003,Anthony Goldwire,PG,31,SAS,10,0,51,5,18,0.278,2,8,0.25,3,10,0.3,0.333,0,2,0,0,3,3,3,3,0,2,5,12
2003,Anthony Goldwire,PG,31,WAS,5,0,34,4,7,0.571,1,1,1,3,6,0.5,0.643,4,5,0.8,0,3,3,1,0,0,4,1,13
2003,Drew Gooden,SF,21,MEM,51,29,1329,255,576,0.443,14,46,0.304,241,530,0.455,0.455,92,132,0.697,105,190,295,63,38,22,105,121,616
2003,Drew Gooden,PF,21,ORL,19,18,544,100,201,0.498,0,2,0,100,199,0.503,0.498,59,80,0.738,58,102,160,20,15,13,45,51,259
2003,Adrian Griffin,SG,28,DAL,74,48,1373,146,337,0.433,6,24,0.25,140,313,0.447,0.442,27,32,0.844,88,176,264,105,77,6,47,157,325
2003,Tom Gugliotta,PF,33,PHO,27,11,447,60,132,0.455,0,1,0,60,131,0.458,0.455,9,9,1,25,75,100,31,14,5,31,35,129
2003,Darvin Ham,SG,29,ATL,75,1,926,71,159,0.447,0,3,0,71,156,0.455,0.447,38,79,0.481,73,80,153,38,16,19,65,127,180
2003,Zendon Hamilton,C,27,TOR,3,0,12,2,5,0.4,0,0,NA,2,5,0.4,0.4,2,2,1,1,3,4,0,1,0,1,2,6
2003,Anfernee Hardaway,SG,31,PHO,58,51,1777,256,573,0.447,26,73,0.356,230,500,0.46,0.469,77,97,0.794,66,192,258,235,66,26,145,150,615
2003,Tim Hardaway,PG,36,IND,10,0,127,18,49,0.367,11,31,0.355,7,18,0.389,0.48,2,4,0.5,1,14,15,24,9,0,11,8,49
2003,Adam Harrington,SG,22,DAL,13,0,37,4,17,0.235,1,3,0.333,3,14,0.214,0.265,2,2,1,0,2,2,2,1,1,2,2,11
2003,Adam Harrington,SG,22,DEN,6,0,74,7,20,0.35,4,11,0.364,3,9,0.333,0.45,1,2,0.5,1,5,6,10,1,0,0,6,19
2003,Al Harrington,SF,22,IND,82,37,2467,389,896,0.434,13,46,0.283,376,850,0.442,0.441,211,274,0.77,159,352,511,125,71,33,163,280,1002
2003,Othella Harrington,PF,29,NYK,74,64,1850,225,443,0.508,0,0,NA,225,443,0.508,0.508,123,150,0.82,165,311,476,62,12,23,90,231,573
2003,Antonio Harvey,PF,32,ATL,4,0,32,2,5,0.4,0,0,NA,2,5,0.4,0.4,0,0,NA,1,5,6,0,1,4,3,7,4
2003,Donnell Harvey,SF,22,DEN,77,27,1613,246,551,0.446,1,7,0.143,245,544,0.45,0.447,118,176,0.67,125,284,409,100,48,27,123,203,611
2003,Trenton Hassell,SG,23,CHI,82,53,1999,144,392,0.367,13,40,0.325,131,352,0.372,0.384,41,55,0.745,37,218,255,151,45,61,83,197,342
2003,Brendan Haywood,C,23,WAS,81,69,1930,173,339,0.51,0,0,NA,173,339,0.51,0.51,155,245,0.633,192,212,404,29,32,119,65,225,501
2003,Nenê,C,20,DEN,80,53,2258,321,619,0.519,0,3,0,321,616,0.521,0.519,197,341,0.578,208,283,491,149,127,65,181,295,839
2003,Tyrone Hill,PF,34,CLE,32,25,855,85,197,0.431,0,0,NA,85,197,0.431,0.431,33,45,0.733,70,197,267,32,31,19,52,104,203
2003,Tyrone Hill,PF,34,PHI,24,18,496,44,109,0.404,0,0,NA,44,109,0.404,0.404,21,35,0.6,56,68,124,9,15,7,16,68,109
2003,Robert Horry,PF,32,LAL,80,26,2343,184,476,0.387,51,177,0.288,133,299,0.445,0.44,103,134,0.769,181,333,514,233,96,61,112,247,522
2003,Eddie House,SG,24,MIA,55,7,1025,172,444,0.387,36,120,0.3,136,324,0.42,0.428,31,36,0.861,17,84,101,87,44,1,46,73,411
2003,Juwan Howard,PF,29,DEN,77,77,2730,567,1261,0.45,2,4,0.5,565,1257,0.449,0.45,282,351,0.803,181,404,585,234,77,27,189,239,1418
2003,Larry Hughes,PG,24,WAS,67,56,2137,346,741,0.467,29,79,0.367,317,662,0.479,0.487,136,186,0.731,67,241,308,205,86,24,136,149,857
2003,Ryan Humphrey,PF,23,ORL,35,1,322,23,85,0.271,0,0,NA,23,85,0.271,0.271,18,28,0.643,30,39,69,7,4,16,21,57,64
2003,Ryan Humphrey,PF,23,MEM,13,0,122,12,35,0.343,0,0,NA,12,35,0.343,0.343,5,11,0.455,4,26,30,4,5,2,2,18,29
2003,Allen Iverson,SG,27,PHI,82,82,3485,804,1940,0.414,84,303,0.277,720,1637,0.44,0.436,570,736,0.774,68,276,344,454,225,13,286,149,2262
2003,Bobby Jackson,PG,29,SAC,59,26,1676,340,732,0.464,89,235,0.379,251,497,0.505,0.525,126,149,0.846,57,162,219,182,71,3,106,126,895
2003,Jermaine Jackson,SG,26,TOR,24,1,286,21,68,0.309,1,9,0.111,20,59,0.339,0.316,23,27,0.852,10,15,25,39,9,3,19,24,66
2003,Jermaine Jackson,SG,26,ATL,29,0,273,19,42,0.452,0,1,0,19,41,0.463,0.452,17,28,0.607,9,23,32,35,10,3,15,27,55
2003,Jim Jackson,SF,32,SAC,63,0,1309,204,462,0.442,32,71,0.451,172,391,0.44,0.476,47,55,0.855,84,178,262,118,31,4,80,132,487
2003,Marc Jackson,C,28,MIN,77,0,1041,153,349,0.438,1,1,1,152,348,0.437,0.44,114,149,0.765,86,139,225,37,24,30,59,137,421
2003,Mark Jackson,PG,37,UTA,82,0,1467,147,369,0.398,27,95,0.284,120,274,0.438,0.435,61,80,0.763,34,142,176,375,48,3,152,90,382
2003,Stephen Jackson,SG,24,SAS,80,58,2254,356,818,0.435,95,297,0.32,261,521,0.501,0.493,139,183,0.76,66,220,286,183,125,30,176,202,946
2003,Casey Jacobsen,SF,21,PHO,72,0,1147,122,327,0.373,52,165,0.315,70,162,0.432,0.453,72,105,0.686,29,54,83,73,35,6,55,90,368
2003,Mike James,PG,27,MIA,78,8,1722,218,585,0.373,67,228,0.294,151,357,0.423,0.43,104,142,0.732,26,123,149,246,64,5,108,176,607
2003,Antawn Jamison,SF,26,GSW,82,82,3226,691,1471,0.47,65,209,0.311,626,1262,0.496,0.492,375,475,0.789,195,383,578,156,76,45,177,197,1822
2003,Chris Jefferies,SF,22,TOR,51,10,666,75,194,0.387,18,54,0.333,57,140,0.407,0.433,29,43,0.674,16,43,59,22,19,16,45,56,197
2003,Richard Jefferson,SF,22,NJN,80,80,2879,456,911,0.501,6,24,0.25,450,887,0.507,0.504,324,436,0.743,150,364,514,201,80,44,156,216,1242
2003,Jared Jeffries,SF,21,WAS,20,1,292,30,63,0.476,3,6,0.5,27,57,0.474,0.5,16,29,0.552,26,32,58,16,8,5,21,28,79
2003,Anthony Johnson,PG,28,NJN,66,2,842,103,231,0.446,13,35,0.371,90,196,0.459,0.474,51,74,0.689,13,65,78,86,37,5,41,93,270
2003,Avery Johnson,PG,37,DAL,48,0,430,63,150,0.42,0,2,0,63,148,0.426,0.42,30,39,0.769,10,21,31,64,15,1,29,26,156
2003,Joe Johnson,SG,21,PHO,82,34,2255,316,796,0.397,75,205,0.366,241,591,0.408,0.444,96,124,0.774,57,207,264,210,62,19,108,143,803
2003,Damon Jones,PG,26,SAC,49,1,709,80,210,0.381,44,121,0.364,36,89,0.404,0.486,20,27,0.741,11,59,70,80,18,4,23,42,224
2003,Eddie Jones,SG,31,MIA,47,47,1789,291,688,0.423,98,241,0.407,193,447,0.432,0.494,189,230,0.822,35,191,226,173,64,31,85,137,869
2003,Fred Jones,SG,23,IND,19,1,115,9,24,0.375,2,7,0.286,7,17,0.412,0.417,3,4,0.75,4,5,9,5,6,1,6,13,23
2003,Steve Kerr,PG,37,SAS,75,0,952,110,256,0.43,49,124,0.395,61,132,0.462,0.525,30,34,0.882,12,48,60,70,27,3,35,49,299
2003,Jason Kidd,PG,29,NJN,80,80,2989,515,1244,0.414,126,370,0.341,389,874,0.445,0.465,339,403,0.841,110,394,504,711,179,25,296,127,1495
2003,Brevin Knight,PG,27,MEM,55,4,928,97,228,0.425,2,8,0.25,95,220,0.432,0.43,20,37,0.541,15,66,81,233,69,2,94,123,216
2003,Toni Kukoč,PF,34,MIL,63,0,1704,249,577,0.432,95,263,0.361,154,314,0.49,0.514,137,194,0.706,67,199,266,230,81,29,122,134,730
2003,Christian Laettner,PF,33,WAS,76,66,2215,255,516,0.494,2,16,0.125,253,500,0.506,0.496,120,144,0.833,114,388,502,235,82,40,87,206,632
2003,Raef LaFrentz,C,26,DAL,69,43,1611,266,514,0.518,47,116,0.405,219,398,0.55,0.563,60,88,0.682,125,205,330,54,35,91,46,264,639
2003,Dan Langhi,SF,25,PHO,60,0,541,81,202,0.401,9,31,0.29,72,171,0.421,0.423,12,20,0.6,19,68,87,21,15,6,16,58,183
2003,Voshon Lenard,SG,29,TOR,63,24,1929,325,809,0.402,92,252,0.365,233,557,0.418,0.459,156,194,0.804,48,164,212,144,59,21,103,156,898
2003,Rashard Lewis,SF,23,SEA,77,77,3044,519,1149,0.452,75,217,0.346,444,932,0.476,0.484,283,345,0.82,152,351,503,133,99,35,143,205,1396
2003,Art Long,PF,30,PHI,19,0,131,19,50,0.38,1,1,1,18,49,0.367,0.39,1,5,0.2,13,27,40,2,2,8,9,22,40
2003,Art Long,PF,30,TOR,7,0,80,9,25,0.36,1,2,0.5,8,23,0.348,0.38,1,5,0.2,8,12,20,4,3,3,11,13,20
2003,Grant Long,PF,36,BOS,41,1,488,27,70,0.386,0,3,0,27,67,0.403,0.386,18,23,0.783,24,59,83,25,9,1,19,62,72
2003,Tyronn Lue,PG,25,WAS,75,24,1986,248,573,0.433,60,176,0.341,188,397,0.474,0.485,91,104,0.875,22,127,149,263,47,1,77,151,647
2003,Jamaal Magloire,C,24,NOH,82,82,2443,305,635,0.48,0,3,0,305,632,0.483,0.48,231,322,0.717,260,464,724,88,49,111,158,276,841
2003,Danny Manning,PF,36,DET,13,0,89,13,32,0.406,3,8,0.375,10,24,0.417,0.453,5,6,0.833,7,11,18,7,9,3,7,11,34
2003,Stephon Marbury,PG,25,PHO,81,81,3240,671,1530,0.439,89,296,0.301,582,1234,0.472,0.468,375,467,0.803,53,210,263,654,108,20,263,200,1806
2003,Shawn Marion,SF,24,PHO,81,81,3373,662,1466,0.452,141,364,0.387,521,1102,0.473,0.5,251,295,0.851,199,574,773,198,185,95,157,208,1716
2003,Donyell Marshall,PF,29,CHI,78,53,2378,421,918,0.459,33,87,0.379,388,831,0.467,0.477,167,221,0.756,234,465,699,137,95,85,135,234,1042
2003,Jamal Mashburn,SF,30,NOH,82,81,3321,670,1586,0.422,119,306,0.389,551,1280,0.43,0.46,313,369,0.848,66,432,498,462,83,17,230,196,1772
2003,Desmond Mason,SF,25,SEA,52,15,1811,291,667,0.436,16,55,0.291,275,612,0.449,0.448,134,181,0.74,88,247,335,95,47,21,74,136,732
2003,Desmond Mason,SF,25,MIL,28,25,952,166,350,0.474,5,17,0.294,161,333,0.483,0.481,78,102,0.765,66,122,188,68,20,11,41,74,415
2003,Roger Mason,SF,22,CHI,17,0,113,11,31,0.355,6,18,0.333,5,13,0.385,0.452,2,2,1,2,10,12,12,4,0,5,20,30
2003,Tony Massenburg,C,35,UTA,58,1,792,104,232,0.448,0,0,NA,104,232,0.448,0.448,65,84,0.774,59,97,156,17,17,19,50,144,273
2003,Walter McCarty,SF,28,BOS,82,8,1949,173,418,0.414,91,248,0.367,82,170,0.482,0.523,61,98,0.622,64,224,288,106,78,28,67,188,498
2003,Tracy McGrady,SG,23,ORL,75,74,2954,829,1813,0.457,173,448,0.386,656,1365,0.481,0.505,576,726,0.793,121,367,488,411,124,59,195,156,2407
2003,Jeff McInnis,PG,28,POR,75,1,1311,188,423,0.444,6,35,0.171,182,388,0.469,0.452,50,67,0.746,22,75,97,170,21,2,75,117,432
2003,Aaron McKie,SF,30,PHI,80,40,2374,286,666,0.429,37,112,0.33,249,554,0.449,0.457,112,134,0.836,61,289,350,278,131,9,109,177,721
2003,Ron Mercer,SG,26,IND,72,3,1671,244,597,0.409,3,16,0.188,241,581,0.415,0.411,65,81,0.802,32,122,154,112,49,14,54,123,556
2003,Chris Mihm,C,23,CLE,52,0,809,116,287,0.404,0,3,0,116,284,0.408,0.404,76,105,0.724,93,138,231,28,18,38,48,124,308
2003,Darius Miles,SF,21,CLE,67,62,2008,263,642,0.41,0,14,0,263,628,0.419,0.41,92,155,0.594,113,250,363,176,67,69,178,159,618
2003,Andre Miller,PG,26,LAC,80,80,2913,377,928,0.406,23,108,0.213,354,820,0.432,0.419,311,391,0.795,84,232,316,537,99,11,206,203,1088
2003,Brad Miller,C,26,IND,73,72,2270,329,667,0.493,5,16,0.313,324,651,0.498,0.497,292,357,0.818,185,418,603,193,65,43,118,203,955
2003,Mike Miller,SF,22,ORL,49,39,1826,296,708,0.418,87,256,0.34,209,452,0.462,0.48,127,150,0.847,40,246,286,139,36,16,99,139,806
2003,Mike Miller,SF,22,MEM,16,13,360,77,151,0.51,22,44,0.5,55,107,0.514,0.583,29,36,0.806,6,49,55,31,6,5,26,34,205
2003,Cuttino Mobley,SG,27,HOU,73,73,3044,463,1067,0.434,112,318,0.352,351,749,0.469,0.486,242,282,0.858,70,233,303,208,95,36,166,185,1280
2003,Nazr Mohammed,C,25,ATL,35,0,445,67,159,0.421,0,0,NA,67,159,0.421,0.421,26,41,0.634,47,82,129,6,16,21,25,79,160
2003,Jérôme Moïso,C,24,NOH,51,1,644,89,171,0.52,0,0,NA,89,171,0.52,0.52,27,41,0.659,59,119,178,22,19,44,46,87,205
2003,Mikki Moore,C,27,BOS,3,0,12,0,1,0,0,0,NA,0,1,0,0,0,0,NA,1,0,1,0,0,2,0,6,0
2003,Mikki Moore,C,27,ATL,5,0,31,5,12,0.417,0,0,NA,5,12,0.417,0.417,8,10,0.8,5,2,7,3,0,2,2,1,18
2003,Troy Murphy,PF,22,GSW,79,79,2510,338,749,0.451,3,14,0.214,335,735,0.456,0.453,244,290,0.841,228,578,806,106,65,30,111,246,923
2003,Ronald Murray,SG,23,MIL,12,0,42,9,26,0.346,0,4,0,9,22,0.409,0.346,5,8,0.625,0,1,1,3,4,0,4,0,23
2003,Ronald Murray,SG,23,SEA,2,0,20,2,5,0.4,0,1,0,2,4,0.5,0.4,0,0,NA,0,3,3,2,0,0,4,0,4
2003,Tracy Murray,SF,31,LAL,31,0,193,23,71,0.324,8,38,0.211,15,33,0.455,0.38,7,9,0.778,5,18,23,12,5,3,14,22,61
2003,Dikembe Mutombo,C,36,NJN,24,16,514,49,131,0.374,0,0,NA,49,131,0.374,0.374,40,55,0.727,54,99,153,19,4,37,34,54,138
2003,Mamadou N'Diaye,C,27,TOR,22,8,364,43,96,0.448,0,0,NA,43,96,0.448,0.448,34,47,0.723,29,53,82,7,8,32,21,58,120
2003,Boštjan Nachbar,SF,22,HOU,14,1,77,11,31,0.355,2,10,0.2,9,21,0.429,0.387,5,10,0.5,3,8,11,3,2,2,6,13,29
2003,Lee Nailon,SF,27,NYK,38,0,405,84,190,0.442,0,1,0,84,189,0.444,0.442,42,51,0.824,32,38,70,26,6,3,32,46,210
2003,Eduardo Nájera,SF,26,DAL,48,12,1103,129,231,0.558,0,1,0,129,230,0.561,0.558,62,91,0.681,90,133,223,47,40,22,23,129,320
2003,Ira Newble,SF,28,ATL,73,45,1931,231,467,0.495,32,84,0.381,199,383,0.52,0.529,70,90,0.778,86,185,271,99,50,26,69,174,564
2003,Moochie Norris,PG,29,HOU,82,3,1375,134,330,0.406,11,45,0.244,123,285,0.432,0.423,78,114,0.684,37,122,159,196,55,4,86,72,357
2003,Jermaine O'Neal,PF,24,IND,77,76,2864,610,1260,0.484,7,21,0.333,603,1239,0.487,0.487,373,510,0.731,202,594,796,155,66,178,180,277,1600
2003,Shaquille O'Neal,C,30,LAL,67,66,2535,695,1211,0.574,0,0,NA,695,1211,0.574,0.574,451,725,0.622,259,483,742,206,38,159,196,229,1841
2003,Kevin Ollie,PG,30,MIL,53,4,1127,117,255,0.459,1,5,0.2,116,250,0.464,0.461,68,91,0.747,12,87,99,181,37,4,36,71,303
2003,Kevin Ollie,PG,30,SEA,29,1,770,82,186,0.441,1,1,1,81,185,0.438,0.444,66,87,0.759,13,70,83,110,32,1,36,51,231
2003,Michael Olowokandi,C,27,LAC,36,36,1369,186,436,0.427,0,0,NA,186,436,0.427,0.427,69,105,0.657,57,271,328,47,18,79,98,110,441
2003,Bo Outlaw,C,31,PHO,80,20,1800,153,278,0.55,0,2,0,153,276,0.554,0.55,72,116,0.621,134,234,368,112,50,71,76,194,378
2003,Robert Pack,PG,33,NOH,28,4,440,52,129,0.403,0,5,0,52,124,0.419,0.403,41,55,0.745,11,40,51,81,25,0,40,35,145
2003,Scott Padgett,PF,26,UTA,82,2,1321,170,423,0.402,45,133,0.338,125,290,0.431,0.455,81,107,0.757,83,189,272,86,41,24,70,148,466
2003,Milt Palacio,PG,24,CLE,80,46,1976,162,388,0.418,8,37,0.216,154,351,0.439,0.428,65,87,0.747,48,187,235,259,68,16,131,168,397
2003,Jannero Pargo,PG,23,LAL,34,0,342,37,93,0.398,7,24,0.292,30,69,0.435,0.435,4,4,1,9,28,37,39,13,2,23,45,85
2003,Smush Parker,PG,21,CLE,66,18,1103,136,338,0.402,38,118,0.322,98,220,0.445,0.459,98,118,0.831,29,90,119,162,48,12,133,106,408
2003,Cherokee Parks,PF,30,LAC,30,18,648,82,163,0.503,1,2,0.5,81,161,0.503,0.506,23,38,0.605,46,86,132,21,16,20,18,52,188
2003,Ruben Patterson,SF,27,POR,78,17,1655,254,516,0.492,3,20,0.15,251,496,0.506,0.495,138,220,0.627,120,144,264,101,73,29,117,161,649
2003,Gary Payton,PG,34,SEA,52,52,2123,444,992,0.448,34,114,0.298,410,878,0.467,0.465,162,234,0.692,56,192,248,457,93,12,131,117,1084
2003,Gary Payton,PG,34,MIL,28,28,1085,221,474,0.466,20,68,0.294,201,406,0.495,0.487,88,118,0.746,23,63,86,206,40,8,56,64,550
2003,Anthony Peeler,SG,33,MIN,82,39,2245,252,609,0.414,87,212,0.41,165,397,0.416,0.485,39,50,0.78,40,201,241,244,72,13,82,161,630
2003,Wesley Person,SG,31,MEM,66,44,1941,274,601,0.456,100,231,0.433,174,370,0.47,0.539,79,97,0.814,24,168,192,112,42,19,56,64,727
2003,James Posey,SF,26,DEN,25,24,872,121,324,0.373,24,88,0.273,97,236,0.411,0.41,86,102,0.843,38,107,145,78,29,6,66,63,352
2003,James Posey,SF,26,HOU,58,47,1646,188,428,0.439,46,141,0.326,142,287,0.495,0.493,119,144,0.826,52,229,281,106,77,9,78,134,541
2003,Vitaly Potapenko,C,27,SEA,26,2,403,41,93,0.441,0,0,NA,41,93,0.441,0.441,22,29,0.759,25,64,89,4,9,8,25,46,104
2003,Tayshaun Prince,SF,22,DET,42,5,435,53,118,0.449,20,47,0.426,33,71,0.465,0.534,11,17,0.647,5,40,45,24,10,14,21,25,137
2003,Joel Przybilla,C,23,MIL,32,17,546,18,46,0.391,0,0,NA,18,46,0.391,0.391,12,24,0.5,48,97,145,12,10,45,19,85,48
2003,Vladimir Radmanović,PF,22,SEA,72,16,1910,274,668,0.41,104,293,0.355,170,375,0.453,0.488,72,102,0.706,76,247,323,97,64,22,100,136,724
2003,Zach Randolph,PF,21,POR,77,11,1301,264,515,0.513,0,5,0,264,510,0.518,0.513,122,161,0.758,139,204,343,41,42,14,62,141,650
2003,Theo Ratliff,C,29,ATL,81,81,2518,276,595,0.464,0,0,NA,276,595,0.464,0.464,154,214,0.72,154,453,607,73,56,262,137,271,706
2003,Željko Rebrača,C,30,DET,30,12,488,80,145,0.552,0,0,NA,80,145,0.552,0.552,38,48,0.792,27,65,92,9,6,17,29,79,198
2003,Don Reid,PF,29,DET,1,0,10,0,3,0,0,0,NA,0,3,0,0,1,2,0.5,0,0,0,0,0,0,0,4,1
2003,Jason Richardson,SG,22,GSW,82,82,2698,476,1161,0.41,123,334,0.368,353,827,0.427,0.463,207,271,0.764,111,267,378,247,90,23,179,201,1282
2003,Clifford Robinson,PF,36,DET,81,69,2825,372,935,0.398,87,259,0.336,285,676,0.422,0.444,161,238,0.676,81,237,318,268,87,88,158,259,992
2003,Rodney Rogers,PF,31,NJN,68,0,1303,183,455,0.402,44,132,0.333,139,323,0.43,0.451,68,90,0.756,61,202,263,107,50,31,91,192,478
2003,Sean Rooks,C,33,LAC,70,38,1344,125,297,0.421,0,1,0,125,296,0.422,0.421,47,58,0.81,53,163,216,69,34,44,66,174,297
2003,Jalen Rose,SF,30,CHI,82,82,3351,642,1583,0.406,133,359,0.37,509,1224,0.416,0.448,399,467,0.854,68,283,351,395,72,23,285,271,1816
2003,Malik Rose,PF,28,SAS,79,13,1933,289,630,0.459,2,5,0.4,287,625,0.459,0.46,242,306,0.791,148,358,506,124,57,40,170,206,822
2003,Kareem Rush,PG,22,LAL,76,0,872,96,244,0.393,19,68,0.279,77,176,0.438,0.432,16,23,0.696,26,68,94,68,10,11,63,71,227
2003,John Salmons,PG,23,PHI,64,1,504,48,116,0.414,10,31,0.323,38,85,0.447,0.457,26,35,0.743,16,43,59,47,17,6,29,53,132
2003,Pepe Sánchez,PG,25,DET,9,0,37,0,5,0,0,0,NA,0,5,0,0,0,0,NA,4,2,6,8,5,0,2,3,0
2003,Kenny Satterfield,PG,21,DEN,22,6,420,51,165,0.309,5,28,0.179,46,137,0.336,0.324,16,23,0.696,12,23,35,53,18,2,36,30,123
2003,Kenny Satterfield,PG,21,PHI,17,0,82,4,18,0.222,0,0,NA,4,18,0.222,0.222,1,2,0.5,4,4,8,15,2,0,7,6,9
2003,Brian Shaw,PG,36,LAL,72,0,900,101,261,0.387,38,109,0.349,63,152,0.414,0.46,10,15,0.667,20,99,119,103,32,13,54,62,250
2003,Brian Skinner,PF,26,PHI,77,9,1381,182,331,0.55,0,0,NA,182,331,0.55,0.55,97,161,0.602,136,230,366,19,47,53,62,176,461
2003,Reggie Slater,PF,32,MIN,26,0,141,27,50,0.54,0,0,NA,27,50,0.54,0.54,27,45,0.6,18,13,31,4,6,1,9,31,81
2003,Charles Smith,SG,27,POR,3,0,13,1,4,0.25,0,1,0,1,3,0.333,0.25,3,4,0.75,0,0,0,1,1,0,1,3,5
2003,Joe Smith,SF,27,MIN,54,21,1117,151,328,0.46,0,2,0,151,326,0.463,0.46,102,131,0.779,111,159,270,38,14,55,43,171,404
2003,Steve Smith,SG,33,SAS,53,18,1032,113,291,0.388,39,118,0.331,74,173,0.428,0.455,95,114,0.833,21,78,99,70,28,9,43,79,360
2003,Eric Snow,PG,29,PHI,82,82,3108,361,799,0.452,7,32,0.219,354,767,0.462,0.456,325,379,0.858,71,230,301,544,133,11,194,235,1054
2003,Jerry Stackhouse,SG,28,WAS,70,70,2747,491,1201,0.409,71,245,0.29,420,956,0.439,0.438,455,518,0.878,61,197,258,316,65,28,193,130,1508
2003,DeShawn Stevenson,SG,21,UTA,61,8,760,114,284,0.401,4,12,0.333,110,272,0.404,0.408,47,68,0.691,22,63,85,40,22,8,49,57,279
2003,Michael Stewart,PF,27,CLE,47,0,251,14,37,0.378,0,0,NA,14,37,0.378,0.378,8,12,0.667,19,36,55,6,2,15,10,42,36
2003,Peja Stojaković,SF,25,SAC,72,72,2450,497,1034,0.481,155,406,0.382,342,628,0.545,0.556,231,264,0.875,61,336,397,141,72,5,101,143,1380
2003,Damon Stoudamire,PG,29,POR,59,27,1315,156,415,0.376,44,114,0.386,112,301,0.372,0.429,53,67,0.791,40,115,155,204,39,6,82,67,409
2003,Amar'e Stoudemire,PF,20,PHO,82,71,2570,392,830,0.472,2,10,0.2,390,820,0.476,0.473,320,484,0.661,250,471,721,78,62,87,189,269,1106
2003,Erick Strickland,SG,29,IND,71,10,1275,163,380,0.429,62,160,0.388,101,220,0.459,0.511,70,87,0.805,23,122,145,209,38,7,98,111,458
2003,Mark Strickland,SF,32,DAL,4,0,13,2,5,0.4,0,0,NA,2,5,0.4,0.4,0,0,NA,5,2,7,0,0,0,1,1,4
2003,Rod Strickland,PG,36,MIN,47,8,956,120,278,0.432,1,11,0.091,119,267,0.446,0.433,79,107,0.738,20,75,95,215,46,6,76,55,320
2003,Bruno Šundov,C,22,BOS,26,0,138,14,56,0.25,4,16,0.25,10,40,0.25,0.286,0,2,0,8,20,28,7,6,3,9,24,32
2003,Bob Sura,SG,29,GSW,55,0,1130,135,328,0.412,28,85,0.329,107,243,0.44,0.454,103,148,0.696,58,109,167,177,45,2,82,108,401
2003,Stromile Swift,PF,23,MEM,67,26,1478,235,489,0.481,0,2,0,235,487,0.483,0.481,177,245,0.722,114,270,384,45,55,104,99,152,647
2003,Wally Szczerbiak,SF,25,MIN,52,42,1836,351,729,0.481,61,145,0.421,290,584,0.497,0.523,150,173,0.867,53,188,241,136,44,22,87,123,913
2003,Maurice Taylor,PF,26,HOU,67,9,1377,231,535,0.432,0,2,0,231,533,0.433,0.432,100,138,0.725,95,143,238,66,22,22,100,151,562
2003,Kenny Thomas,PF,25,HOU,20,14,586,82,190,0.432,0,0,NA,82,190,0.432,0.432,33,45,0.733,45,92,137,39,16,6,40,49,197
2003,Kenny Thomas,PF,25,PHI,46,28,1392,178,369,0.482,0,0,NA,178,369,0.482,0.482,114,152,0.75,140,252,392,73,46,22,76,120,470
2003,Kurt Thomas,C,30,NYK,81,81,2577,497,1028,0.483,2,3,0.667,495,1025,0.483,0.484,138,184,0.75,160,477,637,162,81,97,138,344,1134
2003,Tim Thomas,SF,25,MIL,80,70,2358,412,930,0.443,97,265,0.366,315,665,0.474,0.495,145,186,0.78,97,292,389,102,70,49,133,257,1066
2003,Gary Trent,SF,28,MIN,80,22,1222,208,389,0.535,0,2,0,208,387,0.537,0.535,60,101,0.594,106,185,291,77,32,23,59,142,476
2003,Cezary Trybański,C,23,MEM,15,0,86,5,20,0.25,0,0,NA,5,20,0.25,0.25,4,10,0.4,6,8,14,1,0,6,8,13,14
2003,Jake Tsakalidis,C,23,PHO,33,27,543,61,135,0.452,0,0,NA,61,135,0.452,0.452,39,58,0.672,45,77,122,13,6,17,26,80,161
2003,Nikoloz Tskitishvili,SF,19,DEN,81,16,1320,115,393,0.293,37,152,0.243,78,241,0.324,0.34,48,65,0.738,64,117,181,91,31,29,84,136,315
2003,Hedo Türkoğlu,SF,23,SAC,67,11,1175,165,391,0.422,29,78,0.372,136,313,0.435,0.459,88,110,0.8,35,153,188,87,25,12,50,125,447
2003,Nick Van Exel,SG,31,DAL,73,1,2026,342,831,0.412,118,312,0.378,224,519,0.432,0.483,110,144,0.764,35,173,208,312,42,4,123,86,912
2003,Keith Van Horn,PF,27,PHI,74,73,2337,459,952,0.482,65,176,0.369,394,776,0.508,0.516,193,240,0.804,159,365,524,93,63,30,150,251,1176
2003,Antoine Walker,PF,26,BOS,78,78,3235,603,1554,0.388,188,582,0.323,415,972,0.427,0.449,176,286,0.615,99,464,563,373,116,31,260,221,1570
2003,Ben Wallace,C,28,DET,73,73,2873,210,437,0.481,1,6,0.167,209,431,0.485,0.482,85,189,0.45,293,833,1126,120,104,230,88,179,506
2003,Gerald Wallace,SF,20,SAC,47,7,571,90,183,0.492,1,4,0.25,89,179,0.497,0.495,39,74,0.527,38,90,128,23,24,15,44,68,220
2003,Rasheed Wallace,PF,28,POR,74,74,2684,515,1094,0.471,110,307,0.358,405,787,0.515,0.521,200,272,0.735,113,435,548,153,70,77,140,223,1340
2003,Charlie Ward,PG,32,NYK,66,6,1465,165,414,0.399,101,267,0.378,64,147,0.435,0.521,41,53,0.774,25,152,177,306,78,11,95,146,472
2003,Earl Watson,PG,23,MEM,79,2,1366,170,391,0.435,31,91,0.341,139,300,0.463,0.474,62,86,0.721,46,118,164,225,89,14,88,138,433
2003,Clarence Weatherspoon,PF,32,NYK,79,19,2024,186,414,0.449,0,0,NA,186,414,0.449,0.449,149,194,0.768,214,385,599,68,69,36,63,174,521
2003,Chris Webber,PF,29,SAC,67,67,2622,661,1433,0.461,5,21,0.238,656,1412,0.465,0.463,215,354,0.607,160,544,704,364,106,88,215,204,1542
2003,Bonzi Wells,SG,26,POR,75,65,2396,437,990,0.441,38,130,0.292,399,860,0.464,0.461,226,313,0.722,98,296,394,246,123,18,215,220,1138
2003,Jiří Welsch,SF,23,GSW,37,0,234,19,75,0.253,1,4,0.25,18,71,0.254,0.26,22,29,0.759,12,16,28,27,8,2,19,32,61
2003,David Wesley,SG,32,NOH,73,73,2710,449,1037,0.433,134,316,0.424,315,721,0.437,0.498,185,237,0.781,38,137,175,251,109,9,132,173,1217
2003,Jahidi White,C,26,WAS,16,8,230,25,53,0.472,0,0,NA,25,53,0.472,0.472,17,25,0.68,37,36,73,2,1,12,9,33,67
2003,Rodney White,SG,22,DEN,72,19,1563,260,638,0.408,32,134,0.239,228,504,0.452,0.433,98,125,0.784,43,170,213,121,45,32,156,134,650
2003,Chris Whitney,PG,31,DEN,29,20,762,94,261,0.36,43,128,0.336,51,133,0.383,0.443,46,57,0.807,1,45,46,124,17,1,55,77,277
2003,Chris Whitney,PG,31,ORL,22,1,290,30,88,0.341,7,36,0.194,23,52,0.442,0.381,11,12,0.917,2,19,21,21,12,1,16,15,78
2003,Chris Wilcox,PF,20,LAC,46,3,479,73,140,0.521,0,0,NA,73,140,0.521,0.521,25,50,0.5,32,72,104,21,7,12,26,65,171
2003,Mike Wilks,SG,23,ATL,15,7,364,29,81,0.358,6,17,0.353,23,64,0.359,0.395,21,29,0.724,9,32,41,42,16,1,16,38,85
2003,Mike Wilks,PG,23,MIN,31,0,324,21,67,0.313,4,18,0.222,17,49,0.347,0.343,16,18,0.889,11,19,30,50,11,3,12,31,62
2003,Aaron Williams,C,31,NJN,81,0,1597,199,439,0.453,0,1,0,199,438,0.454,0.453,102,130,0.785,137,194,331,88,27,57,85,206,500
2003,Alvin Williams,PG,28,TOR,78,78,2638,396,905,0.438,48,146,0.329,348,759,0.458,0.464,187,239,0.782,55,190,245,416,111,21,128,170,1027
2003,Eric Williams,SF,30,BOS,82,79,2350,254,575,0.442,37,110,0.336,217,465,0.467,0.474,201,268,0.75,143,239,382,140,86,19,97,234,746
2003,Jason Williams,PG,27,MEM,76,76,2407,333,859,0.388,143,404,0.354,190,455,0.418,0.471,110,131,0.84,25,187,212,631,91,10,168,130,919
2003,Jerome Williams,PF,29,TOR,71,63,2346,267,535,0.499,1,6,0.167,266,529,0.503,0.5,156,281,0.555,231,419,650,95,116,26,98,197,691
2003,Monty Williams,SF,31,PHI,21,2,276,34,80,0.425,0,2,0,34,78,0.436,0.425,24,32,0.75,12,33,45,26,12,5,17,33,92
2003,Scott Williams,C,34,PHO,69,33,872,120,292,0.411,0,2,0,120,290,0.414,0.411,33,42,0.786,72,121,193,22,27,21,32,159,273
2003,Shammond Williams,PG,27,BOS,51,2,1169,134,338,0.396,56,159,0.352,78,179,0.436,0.479,48,57,0.842,12,98,110,128,61,3,61,84,372
2003,Shammond Williams,PG,27,DEN,27,9,712,94,241,0.39,37,102,0.363,57,139,0.41,0.467,30,45,0.667,12,49,61,138,16,3,53,56,255
2003,Walt Williams,SF,32,DAL,66,1,1161,134,341,0.393,64,171,0.374,70,170,0.412,0.487,31,50,0.62,53,154,207,59,42,26,35,141,363
2003,Corliss Williamson,SF,29,DET,82,1,2061,374,826,0.453,2,11,0.182,372,815,0.456,0.454,237,300,0.79,147,211,358,104,44,27,126,238,987
2003,Kevin Willis,C,40,SAS,71,6,840,123,257,0.479,0,2,0,123,255,0.482,0.479,51,83,0.614,83,143,226,24,20,20,60,120,297
2003,Metta World Peace,SF,23,IND,69,67,2317,362,846,0.428,71,211,0.336,291,635,0.458,0.47,273,371,0.736,101,261,362,198,159,50,145,242,1068
2003,Lorenzen Wright,C,27,MEM,70,49,1982,325,716,0.454,0,5,0,325,711,0.457,0.454,147,223,0.659,170,358,528,80,51,54,110,209,797
2003,Wang Zhizhi,C,25,LAC,41,1,412,62,162,0.383,16,47,0.34,46,115,0.4,0.432,42,58,0.724,26,51,77,10,8,10,31,41,182
2004,Shareef Abdur-Rahim,PF,27,ATL,53,53,1956,383,790,0.485,5,23,0.217,378,767,0.493,0.488,294,334,0.88,141,354,495,127,44,19,131,147,1065
2004,Shareef Abdur-Rahim,PF,27,POR,32,3,728,118,264,0.447,4,11,0.364,114,253,0.451,0.455,79,95,0.832,48,96,144,47,24,18,53,75,319
2004,Malik Allen,PF,25,MIA,45,6,616,83,198,0.419,0,0,NA,83,198,0.419,0.419,25,33,0.758,42,77,119,16,12,28,27,81,191
2004,Ray Allen,SG,28,SEA,56,56,2152,447,1017,0.44,148,378,0.392,299,639,0.468,0.512,245,271,0.904,69,217,286,268,71,11,156,132,1287
2004,Rafer Alston,PG,27,MIA,82,28,2581,287,764,0.376,161,434,0.371,126,330,0.382,0.481,103,134,0.769,26,200,226,372,114,18,128,212,838
2004,Chris Andersen,PF,25,DEN,71,0,1029,90,203,0.443,0,1,0,90,202,0.446,0.443,63,107,0.589,89,209,298,35,34,114,48,119,243
2004,Derek Anderson,SG,29,POR,51,46,1810,230,612,0.376,79,259,0.305,151,353,0.428,0.44,155,188,0.824,26,156,182,228,66,3,90,79,694
2004,Kenny Anderson,PG,33,IND,44,31,905,113,256,0.441,1,4,0.25,112,252,0.444,0.443,35,48,0.729,19,62,81,125,26,5,50,73,262
2004,Shandon Anderson,SG,30,NYK,80,37,1974,238,564,0.422,36,128,0.281,202,436,0.463,0.454,123,161,0.764,53,169,222,122,68,17,118,182,635
2004,Carmelo Anthony,SF,19,DEN,82,82,2995,624,1465,0.426,69,214,0.322,555,1251,0.444,0.449,408,525,0.777,183,315,498,227,97,41,247,225,1725
2004,Robert Archibald,PF,23,PHO,1,0,6,0,1,0,0,0,NA,0,1,0,0,1,2,0.5,0,1,1,1,0,0,1,1,1
2004,Robert Archibald,PF,23,ORL,1,0,4,1,2,0.5,0,0,NA,1,2,0.5,0.5,0,2,0,0,1,1,0,1,0,0,0,2
2004,Robert Archibald,C,23,TOR,30,3,246,8,30,0.267,0,0,NA,8,30,0.267,0.267,13,27,0.481,21,29,50,12,13,3,9,49,29
2004,Gilbert Arenas,PG,22,WAS,55,52,2066,358,914,0.392,125,333,0.375,233,581,0.401,0.46,237,317,0.748,55,199,254,275,103,12,226,176,1078
2004,Darrell Armstrong,PG,35,NOH,79,22,2247,291,736,0.395,135,429,0.315,156,307,0.508,0.487,123,144,0.854,63,163,226,311,133,16,155,148,840
2004,Carlos Arroyo,PG,24,UTA,71,71,2008,339,768,0.441,38,117,0.325,301,651,0.462,0.466,181,225,0.804,41,144,185,355,63,5,156,165,897
2004,Chucky Atkins,PG,29,DET,40,0,751,88,235,0.374,42,130,0.323,46,105,0.438,0.464,31,43,0.721,6,42,48,95,19,1,48,60,249
2004,Chucky Atkins,PG,29,BOS,24,24,793,104,249,0.418,39,111,0.351,65,138,0.471,0.496,42,54,0.778,3,42,45,128,26,1,44,42,289
2004,Stacey Augmon,SF,35,NOH,69,24,1416,143,347,0.412,1,7,0.143,142,340,0.418,0.414,110,139,0.791,52,122,174,85,55,15,76,114,397
2004,Vin Baker,PF,32,BOS,37,33,1000,168,333,0.505,0,1,0,168,332,0.506,0.505,82,112,0.732,76,134,210,54,22,23,52,98,418
2004,Vin Baker,PF,32,NYK,17,0,313,40,99,0.404,1,2,0.5,39,97,0.402,0.409,32,45,0.711,36,34,70,12,7,9,25,62,113
2004,Marcus Banks,PG,22,BOS,81,2,1385,177,442,0.4,27,86,0.314,150,356,0.421,0.431,99,131,0.756,30,103,133,175,88,13,125,171,480
2004,Leandro Barbosa,PG,21,PHO,70,46,1500,210,470,0.447,83,210,0.395,127,260,0.488,0.535,47,61,0.77,23,100,123,165,93,7,120,184,550
2004,Matt Barnes,SF,23,LAC,38,9,724,63,138,0.457,2,13,0.154,61,125,0.488,0.464,43,61,0.705,53,98,151,48,27,3,44,76,171
2004,Brent Barry,SG,32,SEA,59,53,1803,215,427,0.504,114,252,0.452,101,175,0.577,0.637,91,110,0.827,21,183,204,342,85,16,139,121,635
2004,Jon Barry,SG,34,DEN,57,9,1101,120,297,0.404,51,138,0.37,69,159,0.434,0.49,60,71,0.845,25,98,123,147,57,8,53,66,351
2004,Tony Battie,C,27,BOS,23,6,501,56,117,0.479,1,1,1,55,116,0.474,0.483,23,33,0.697,39,79,118,21,8,20,24,55,136
2004,Tony Battie,C,27,CLE,50,1,977,114,267,0.427,1,8,0.125,113,259,0.436,0.429,43,56,0.768,79,162,241,37,18,47,39,104,272
2004,Shane Battier,SF,25,MEM,79,1,1947,242,543,0.446,65,186,0.349,177,357,0.496,0.506,120,164,0.732,102,201,303,101,101,58,56,187,669
2004,Lonny Baxter,PF,25,CHI,14,1,147,27,49,0.551,1,1,1,26,48,0.542,0.561,5,8,0.625,11,24,35,5,1,6,11,31,60
2004,Lonny Baxter,C,25,TOR,36,4,487,60,128,0.469,0,1,0,60,127,0.472,0.469,30,56,0.536,42,79,121,10,14,18,22,69,150
2004,Lonny Baxter,PF,25,WAS,12,0,132,16,32,0.5,0,1,0,16,31,0.516,0.5,9,12,0.75,11,20,31,5,2,5,5,23,41
2004,Raja Bell,SG,27,UTA,82,4,2020,329,805,0.409,62,166,0.373,267,639,0.418,0.447,195,248,0.786,60,181,241,107,63,13,111,262,915
2004,Travis Best,PG,31,DAL,61,1,762,64,172,0.372,3,20,0.15,61,152,0.401,0.381,40,46,0.87,17,51,68,112,31,4,33,66,171
2004,Mike Bibby,PG,25,SAC,82,82,2980,527,1170,0.45,148,378,0.392,379,792,0.479,0.514,304,373,0.815,67,210,277,444,112,18,175,146,1506
2004,Chauncey Billups,PG,27,DET,78,78,2758,392,996,0.394,130,335,0.388,262,661,0.396,0.459,404,460,0.878,35,241,276,446,84,8,189,177,1318
2004,Steve Blake,PG,23,WAS,75,14,1392,157,407,0.386,75,202,0.371,82,205,0.4,0.478,55,67,0.821,18,99,117,209,57,7,128,100,444
2004,Corie Blount,PF,35,CHI,46,3,756,97,206,0.471,0,3,0,97,203,0.478,0.471,13,24,0.542,76,130,206,45,38,19,35,86,207
2004,Corie Blount,C,35,TOR,16,0,294,18,47,0.383,0,0,NA,18,47,0.383,0.383,2,3,0.667,22,47,69,10,11,5,8,49,38
2004,Mark Blount,C,28,BOS,82,73,2402,342,604,0.566,0,0,NA,342,604,0.566,0.566,159,221,0.719,207,382,589,75,80,106,150,253,843
2004,Keith Bogans,SF,23,ORL,73,36,1787,183,454,0.403,67,187,0.358,116,267,0.434,0.477,65,103,0.631,106,211,317,98,46,10,75,128,498
2004,Calvin Booth,C,27,SEA,71,35,1206,135,290,0.466,0,2,0,135,288,0.469,0.466,75,94,0.798,86,194,280,28,17,101,45,150,345
2004,Bruce Bowen,SF,32,SAS,82,82,2624,211,502,0.42,77,212,0.363,134,290,0.462,0.497,66,114,0.579,45,208,253,113,84,33,90,166,565
2004,Earl Boykins,SG,27,DEN,82,3,1849,321,766,0.419,55,171,0.322,266,595,0.447,0.455,142,162,0.877,42,101,143,295,51,3,100,84,839
2004,Michael Bradley,PF,24,TOR,5,0,38,1,3,0.333,0,0,NA,1,3,0.333,0.333,1,2,0.5,1,10,11,1,1,0,3,6,3
2004,Michael Bradley,C,24,ATL,11,1,60,6,12,0.5,0,0,NA,6,12,0.5,0.5,0,0,NA,5,7,12,0,2,0,4,8,12
2004,Shawn Bradley,C,31,DAL,66,5,773,89,188,0.473,0,1,0,89,187,0.476,0.473,41,49,0.837,72,101,173,20,33,74,17,130,219
2004,Torraye Braggs,PF,27,HOU,11,0,132,13,28,0.464,0,0,NA,13,28,0.464,0.464,8,12,0.667,15,19,34,6,4,2,12,21,34
2004,Torraye Braggs,PF,27,WAS,4,0,22,3,5,0.6,0,0,NA,3,5,0.6,0.6,0,0,NA,3,2,5,1,0,0,1,8,6
2004,J.R. Bremer,PG,23,CLE,31,2,403,39,137,0.285,19,66,0.288,20,71,0.282,0.354,13,20,0.65,7,26,33,39,18,4,19,27,110
2004,J.R. Bremer,PG,23,GSW,5,0,40,4,21,0.19,0,8,0,4,13,0.308,0.19,0,0,NA,2,1,3,12,0,0,5,5,8
2004,Primož Brezec,C,24,IND,18,0,72,12,26,0.462,0,0,NA,12,26,0.462,0.462,4,6,0.667,5,10,15,3,0,3,6,13,28
2004,Devin Brown,SG,25,SAS,58,0,627,85,196,0.434,4,14,0.286,81,182,0.445,0.444,60,74,0.811,38,92,130,33,15,4,38,61,234
2004,Kedrick Brown,SF,22,BOS,21,10,408,45,99,0.455,12,32,0.375,33,67,0.493,0.515,8,13,0.615,18,50,68,25,17,2,12,38,110
2004,Kedrick Brown,SF,22,CLE,34,16,561,72,155,0.465,26,67,0.388,46,88,0.523,0.548,9,14,0.643,23,55,78,39,13,5,17,42,179
2004,Kwame Brown,PF,21,WAS,74,57,2239,288,589,0.489,1,2,0.5,287,587,0.489,0.49,228,334,0.683,178,372,550,112,66,52,140,144,805
2004,Rick Brunson,PG,31,TOR,3,0,10,2,4,0.5,0,0,NA,2,4,0.5,0.5,0,0,NA,0,0,0,2,0,0,0,0,4
2004,Rick Brunson,PG,31,CHI,37,0,402,38,101,0.376,11,23,0.478,27,78,0.346,0.431,27,31,0.871,9,28,37,80,25,3,33,44,114
2004,Caron Butler,SF,23,MIA,68,56,2030,240,631,0.38,10,42,0.238,230,589,0.39,0.388,133,176,0.756,92,234,326,126,75,13,91,162,623
2004,Rasual Butler,SF,24,MIA,45,0,675,119,250,0.476,50,108,0.463,69,142,0.486,0.576,16,21,0.762,4,57,61,23,10,13,28,72,304
2004,Žarko Čabarkapa,PF,22,PHO,49,4,570,81,197,0.411,6,32,0.188,75,165,0.455,0.426,35,53,0.66,26,73,99,40,10,13,54,75,203
2004,Marcus Camby,C,29,DEN,72,72,2162,262,549,0.477,0,2,0,262,547,0.479,0.477,98,136,0.721,211,516,727,132,86,187,98,239,622
2004,Elden Campbell,C,35,DET,65,27,892,138,314,0.439,0,0,NA,138,314,0.439,0.439,85,124,0.685,52,157,209,45,21,50,63,137,361
2004,Matt Carroll,SG,23,POR,13,0,48,5,11,0.455,1,3,0.333,4,8,0.5,0.5,2,2,1,0,3,3,1,0,0,2,3,13
2004,Matt Carroll,SG,23,SAS,3,0,22,2,5,0.4,0,0,NA,2,5,0.4,0.4,2,4,0.5,1,2,3,1,1,0,4,5,6
2004,Anthony Carter,PG,28,SAS,5,2,87,11,37,0.297,0,3,0,11,34,0.324,0.297,0,0,NA,2,9,11,12,4,0,12,9,22
2004,Maurice Carter,SG,27,LAL,4,0,50,5,14,0.357,1,3,0.333,4,11,0.364,0.393,11,12,0.917,0,3,3,2,0,0,6,5,22
2004,Maurice Carter,SG,27,NOH,6,0,60,6,21,0.286,3,8,0.375,3,13,0.231,0.357,5,8,0.625,2,6,8,2,0,0,3,5,20
2004,Vince Carter,SG,27,TOR,73,73,2785,608,1457,0.417,93,243,0.383,515,1214,0.424,0.449,336,417,0.806,95,254,349,348,88,65,223,212,1645
2004,Sam Cassell,PG,34,MIN,81,81,2838,620,1270,0.488,74,186,0.398,546,1084,0.504,0.517,289,331,0.873,44,227,271,592,102,18,220,247,1603
2004,Kelvin Cato,PF,29,HOU,69,67,1743,161,360,0.447,0,0,NA,161,360,0.447,0.447,96,142,0.676,153,319,472,72,52,96,84,203,418
2004,Tyson Chandler,PF,21,CHI,35,8,782,67,158,0.424,0,1,0,67,157,0.427,0.424,79,118,0.669,82,188,270,23,17,43,38,87,213
2004,Doug Christie,SG,33,SAC,82,82,2780,317,688,0.461,49,142,0.345,268,546,0.491,0.496,148,172,0.86,69,260,329,347,151,41,155,186,831
2004,Keon Clark,PF,28,UTA,2,0,27,2,6,0.333,0,0,NA,2,6,0.333,0.333,0,0,NA,1,6,7,1,1,0,0,1,4
2004,Speedy Claxton,PG,25,GSW,60,29,1595,224,524,0.427,4,22,0.182,220,502,0.438,0.431,182,224,0.813,38,118,156,267,97,9,102,146,634
2004,Bimbo Coles,PG,35,MIA,22,1,170,12,34,0.353,0,0,NA,12,34,0.353,0.353,4,6,0.667,2,8,10,15,3,0,9,27,28
2004,Jarron Collins,C,25,UTA,81,31,1732,147,295,0.498,0,1,0,147,294,0.5,0.498,188,262,0.718,117,199,316,77,26,18,79,255,482
2004,Jason Collins,C,25,NJN,78,78,2220,163,384,0.424,0,2,0,163,382,0.427,0.424,136,184,0.739,143,257,400,153,67,56,97,251,462
2004,Brian Cook,C,23,LAL,35,2,442,67,141,0.475,0,5,0,67,136,0.493,0.475,21,28,0.75,31,70,101,20,16,16,17,64,155
2004,Jamal Crawford,SG,23,CHI,80,73,2811,509,1318,0.386,165,521,0.317,344,797,0.432,0.449,200,240,0.833,46,237,283,405,111,29,193,161,1383
2004,Austin Croshere,PF,28,IND,77,0,1051,119,307,0.388,56,144,0.389,63,163,0.387,0.479,93,104,0.894,60,183,243,52,24,14,55,101,387
2004,Michael Curry,SF,35,TOR,70,15,1229,76,196,0.388,3,15,0.2,73,181,0.403,0.395,49,58,0.845,22,65,87,53,23,5,48,153,204
2004,Antonio Daniels,PG,28,SEA,71,32,1512,187,398,0.47,42,116,0.362,145,282,0.514,0.523,155,184,0.842,23,119,142,298,45,6,61,64,571
2004,Antonio Davis,C,35,TOR,15,15,538,46,120,0.383,0,0,NA,46,120,0.383,0.383,37,49,0.755,49,94,143,14,8,8,21,45,129
2004,Antonio Davis,C,35,CHI,65,64,2032,220,540,0.407,0,0,NA,220,540,0.407,0.407,139,181,0.768,158,370,528,123,29,57,93,161,579
2004,Baron Davis,PG,24,NOH,67,66,2686,554,1402,0.395,187,582,0.321,367,820,0.448,0.462,237,352,0.673,66,221,287,501,158,27,215,178,1532
2004,Dale Davis,C,34,POR,76,37,1682,133,281,0.473,0,0,NA,133,281,0.473,0.473,65,106,0.613,158,240,398,72,43,62,40,154,331
2004,Hubert Davis,SG,33,DET,3,0,23,0,2,0,0,1,0,0,1,0,0,0,0,NA,0,0,0,1,0,0,1,4,0
2004,Hubert Davis,SG,33,NJN,14,0,55,1,9,0.111,0,0,NA,1,9,0.111,0.111,2,2,1,2,6,8,3,2,0,2,8,4
2004,Josh Davis,PF,23,ATL,4,1,23,2,5,0.4,0,2,0,2,3,0.667,0.4,1,1,1,1,4,5,0,0,0,2,3,5
2004,Ricky Davis,SG,24,CLE,22,22,796,134,311,0.431,17,48,0.354,117,263,0.445,0.458,51,75,0.68,18,103,121,111,25,8,68,51,336
2004,Ricky Davis,SF,24,BOS,57,5,1678,312,639,0.488,35,92,0.38,277,547,0.506,0.516,145,198,0.732,59,178,237,148,71,14,121,120,804
2004,Andrew DeClercq,C,30,ORL,71,53,1211,93,195,0.477,0,0,NA,93,195,0.477,0.477,44,54,0.815,131,186,317,44,47,32,54,217,230
2004,Tony Delk,SG,30,DAL,33,11,509,70,184,0.38,20,66,0.303,50,118,0.424,0.435,37,44,0.841,16,43,59,28,27,7,17,46,197
2004,Derrick Dial,SG,28,ORL,9,0,86,9,28,0.321,2,9,0.222,7,19,0.368,0.357,6,8,0.75,5,8,13,2,6,0,1,6,26
2004,Boris Diaw,SG,21,ATL,76,37,1919,140,313,0.447,6,26,0.231,134,287,0.467,0.457,56,93,0.602,111,231,342,182,59,37,126,191,342
2004,Dan Dickau,PG,25,ATL,23,0,143,21,49,0.429,3,10,0.3,18,39,0.462,0.459,4,6,0.667,4,12,16,18,9,0,13,22,49
2004,Dan Dickau,PG,25,POR,20,0,151,16,49,0.327,7,20,0.35,9,29,0.31,0.398,7,8,0.875,3,7,10,20,8,0,13,22,46
2004,DeSagana Diop,C,22,CLE,56,3,730,57,147,0.388,0,0,NA,57,147,0.388,0.388,12,20,0.6,72,127,199,34,26,51,29,116,126
2004,Juan Dixon,SG,25,WAS,71,16,1478,247,637,0.388,59,198,0.298,188,439,0.428,0.434,111,139,0.799,30,118,148,137,82,4,104,111,664
2004,Michael Doleac,C,26,NYK,46,0,685,100,225,0.444,0,0,NA,100,225,0.444,0.444,31,36,0.861,60,129,189,30,17,30,37,84,231
2004,Michael Doleac,C,26,DEN,26,0,344,40,97,0.412,0,0,NA,40,97,0.412,0.412,14,16,0.875,28,48,76,14,6,6,11,58,94
2004,Mike Dunleavy,SF,23,GSW,75,69,2336,323,720,0.449,94,254,0.37,229,466,0.491,0.514,137,185,0.741,87,355,442,220,68,13,143,169,877
2004,Ronald Dupree,SF,23,CHI,47,8,893,111,282,0.394,4,9,0.444,107,273,0.392,0.401,66,105,0.629,55,112,167,55,32,18,51,134,292
2004,Howard Eisley,PG,31,NYK,33,23,730,80,202,0.396,28,85,0.329,52,117,0.444,0.465,32,36,0.889,7,59,66,156,30,3,50,85,220
2004,Howard Eisley,PG,31,PHO,34,0,727,86,249,0.345,24,78,0.308,62,171,0.363,0.394,44,53,0.83,13,50,63,117,26,2,48,52,240
2004,Francisco Elson,C,27,DEN,62,14,875,94,199,0.472,0,1,0,94,198,0.475,0.472,30,45,0.667,65,138,203,32,35,39,35,145,218
2004,Melvin Ely,PF,25,LAC,42,2,510,66,153,0.431,0,1,0,66,152,0.434,0.431,25,42,0.595,48,53,101,22,9,17,20,68,157
2004,Reggie Evans,PF,23,SEA,75,27,1280,67,165,0.406,0,3,0,67,162,0.414,0.406,83,148,0.561,156,252,408,33,54,10,65,176,217
2004,Michael Finley,SG,30,DAL,72,72,2778,514,1159,0.443,150,370,0.405,364,789,0.461,0.508,164,193,0.85,78,247,325,212,84,39,83,118,1342
2004,Derek Fisher,SG,29,LAL,82,3,1769,203,576,0.352,52,179,0.291,151,397,0.38,0.398,122,153,0.797,30,122,152,187,103,4,79,115,580
2004,Adonal Foyle,C,28,GSW,44,8,572,59,130,0.454,0,0,NA,59,130,0.454,0.454,19,35,0.543,54,113,167,17,6,46,21,68,137
2004,Richie Frahm,SF,26,SEA,54,0,469,63,139,0.453,34,92,0.37,29,47,0.617,0.576,23,26,0.885,12,44,56,24,16,4,7,50,183
2004,Steve Francis,PG,26,HOU,79,79,3194,450,1117,0.403,73,250,0.292,377,867,0.435,0.436,337,435,0.775,116,317,433,493,139,35,294,257,1310
2004,Dan Gadzuric,C,25,MIL,75,0,1260,183,349,0.524,0,1,0,183,348,0.526,0.524,58,118,0.492,126,220,346,28,51,105,45,186,424
2004,Reece Gaines,PG,23,ORL,38,1,364,25,86,0.291,3,10,0.3,22,76,0.289,0.308,16,25,0.64,8,31,39,40,11,2,18,22,69
2004,Kevin Garnett,PF,27,MIN,82,82,3231,804,1611,0.499,11,43,0.256,793,1568,0.506,0.502,368,465,0.791,245,894,1139,409,120,178,212,202,1987
2004,Pau Gasol,PF,23,MEM,78,78,2458,506,1049,0.482,4,15,0.267,502,1034,0.485,0.484,365,511,0.714,206,394,600,198,44,132,187,185,1381
2004,Eddie Gill,PG,25,POR,22,0,157,15,36,0.417,3,8,0.375,12,28,0.429,0.458,17,20,0.85,4,13,17,16,9,1,12,16,50
2004,Kendall Gill,SG,35,CHI,56,35,1411,215,548,0.392,9,38,0.237,206,510,0.404,0.401,100,136,0.735,61,129,190,89,65,16,83,107,539
2004,Gordan Giriček,SF,26,ORL,48,25,1435,188,427,0.44,46,113,0.407,142,314,0.452,0.494,67,81,0.827,37,127,164,80,41,10,63,98,489
2004,Gordan Giriček,SG,26,UTA,25,18,606,128,297,0.431,14,39,0.359,114,258,0.442,0.455,68,77,0.883,14,48,62,42,15,5,40,46,338
2004,Dion Glover,SG,25,ATL,55,26,1465,205,524,0.391,36,105,0.343,169,419,0.403,0.426,110,142,0.775,54,183,237,115,40,17,83,106,556
2004,Dion Glover,SG,25,TOR,14,4,178,25,65,0.385,4,14,0.286,21,51,0.412,0.415,10,14,0.714,4,25,29,15,10,2,19,17,64
2004,Anthony Goldwire,PG,32,MIN,5,0,66,5,14,0.357,2,6,0.333,3,8,0.375,0.429,1,1,1,1,5,6,10,3,0,2,5,13
2004,Anthony Goldwire,PG,32,NJN,6,0,19,2,8,0.25,0,2,0,2,6,0.333,0.25,0,0,NA,0,1,1,1,2,0,1,0,4
2004,Drew Gooden,PF,22,ORL,79,17,2134,369,829,0.445,9,42,0.214,360,787,0.457,0.451,167,262,0.637,160,356,516,89,62,72,126,196,914
2004,Paul Grant,C,30,UTA,10,0,98,11,23,0.478,0,0,NA,11,23,0.478,0.478,3,8,0.375,7,10,17,3,1,1,7,17,25
2004,Adrian Griffin,SG,29,HOU,19,1,133,5,18,0.278,1,2,0.5,4,16,0.25,0.306,0,4,0,1,18,19,10,7,2,3,17,11
2004,Tom Gugliotta,PF,34,PHO,30,3,304,31,99,0.313,0,1,0,31,98,0.316,0.313,6,8,0.75,15,41,56,21,14,4,20,34,68
2004,Tom Gugliotta,PF,34,UTA,25,24,515,39,104,0.375,1,3,0.333,38,101,0.376,0.38,14,20,0.7,50,81,131,42,17,8,19,47,93
2004,Darvin Ham,SF,30,DET,54,2,484,37,75,0.493,1,2,0.5,36,73,0.493,0.5,21,35,0.6,47,46,93,16,13,8,31,63,96
2004,Zendon Hamilton,C,28,PHI,46,0,473,51,95,0.537,0,0,NA,51,95,0.537,0.537,67,96,0.698,49,97,146,13,8,8,27,74,169
2004,Anfernee Hardaway,SG,32,PHO,34,10,876,120,271,0.443,14,35,0.4,106,236,0.449,0.469,42,49,0.857,27,71,98,97,28,8,42,65,296
2004,Anfernee Hardaway,SG,32,NYK,42,4,1219,159,408,0.39,16,44,0.364,143,364,0.393,0.409,69,89,0.775,42,147,189,79,42,12,65,81,403
2004,Al Harrington,PF,23,IND,79,15,2441,421,909,0.463,21,77,0.273,400,832,0.481,0.475,185,252,0.734,163,345,508,131,80,22,163,250,1048
2004,Othella Harrington,PF,30,NYK,56,3,872,100,202,0.495,0,0,NA,100,202,0.495,0.495,58,78,0.744,58,119,177,29,12,14,65,134,258
2004,Jason Hart,PG,25,SAS,53,5,660,71,159,0.447,2,9,0.222,69,150,0.46,0.453,33,43,0.767,10,69,79,81,28,5,29,59,177
2004,Donnell Harvey,PF,23,ORL,24,1,345,36,89,0.404,0,3,0,36,86,0.419,0.404,26,39,0.667,29,43,72,8,10,11,22,44,98
2004,Donnell Harvey,PF,23,PHO,36,7,438,53,112,0.473,0,0,NA,53,112,0.473,0.473,35,44,0.795,19,73,92,13,14,16,23,85,141
2004,Trenton Hassell,SG,24,MIN,81,74,2264,177,381,0.465,4,13,0.308,173,368,0.47,0.47,48,61,0.787,68,189,257,133,36,54,46,200,406
2004,Brendan Haywood,C,24,WAS,77,59,1484,200,388,0.515,0,1,0,200,387,0.517,0.515,137,234,0.585,186,201,387,43,32,100,80,154,537
2004,Nenê,PF,21,DEN,77,77,2504,334,630,0.53,0,2,0,334,628,0.532,0.53,240,352,0.682,154,349,503,168,116,41,183,280,908
2004,Tyrone Hill,PF,35,MIA,5,0,38,3,5,0.6,0,0,NA,3,5,0.6,0.6,3,4,0.75,5,3,8,0,0,1,2,10,9
2004,Kirk Hinrich,PG,23,CHI,76,66,2706,318,823,0.386,144,369,0.39,174,454,0.383,0.474,135,168,0.804,42,217,259,517,101,21,204,276,915
2004,Robert Horry,PF,33,SAS,81,1,1290,141,348,0.405,41,108,0.38,100,240,0.417,0.464,69,107,0.645,108,164,272,101,48,49,55,165,392
2004,Eddie House,SG,25,LAC,60,10,1188,161,449,0.359,51,136,0.375,110,313,0.351,0.415,36,45,0.8,28,110,138,148,65,4,63,92,409
2004,Josh Howard,SF,23,DAL,67,29,1589,229,532,0.43,20,66,0.303,209,466,0.448,0.449,97,138,0.703,149,219,368,97,69,54,67,168,575
2004,Juwan Howard,PF,30,ORL,81,77,2877,529,1169,0.453,0,1,0,529,1168,0.453,0.453,318,393,0.809,171,399,570,158,54,22,178,284,1376
2004,Larry Hughes,SG,25,WAS,61,61,2061,401,1009,0.397,79,232,0.341,322,777,0.414,0.437,267,335,0.797,96,230,326,148,95,26,152,147,1148
2004,Ryan Humphrey,PF,24,MEM,2,0,11,1,4,0.25,0,1,0,1,3,0.333,0.25,0,0,NA,2,1,3,1,1,0,2,3,2
2004,Allen Iverson,SG,28,PHI,48,47,2040,435,1125,0.387,57,199,0.286,378,926,0.408,0.412,339,455,0.745,34,144,178,324,115,5,209,87,1266
2004,Bobby Jackson,SG,30,SAC,50,0,1185,263,592,0.444,81,219,0.37,182,373,0.488,0.513,82,109,0.752,55,119,174,105,49,8,63,106,689
2004,Jim Jackson,SF,33,HOU,80,80,3119,382,900,0.424,162,405,0.4,220,495,0.444,0.514,107,127,0.843,52,435,487,226,86,23,175,227,1033
2004,Marc Jackson,PF,29,PHI,22,13,598,71,171,0.415,0,1,0,71,170,0.418,0.415,64,81,0.79,45,81,126,18,12,6,24,45,206
2004,Mark Jackson,PG,38,HOU,42,3,577,34,100,0.34,7,41,0.171,27,59,0.458,0.375,28,39,0.718,10,60,70,119,17,1,53,41,103
2004,Stephen Jackson,SF,25,ATL,80,78,2940,536,1261,0.425,145,427,0.34,391,834,0.469,0.483,233,297,0.785,97,273,370,244,142,20,223,216,1450
2004,Casey Jacobsen,SF,22,PHO,78,13,1828,150,360,0.417,75,180,0.417,75,180,0.417,0.521,91,111,0.82,42,159,201,98,48,9,68,144,466
2004,Mike James,PG,28,BOS,55,55,1684,213,510,0.418,86,226,0.381,127,284,0.447,0.502,76,95,0.8,20,156,176,244,70,2,83,113,588
2004,Mike James,PG,28,DET,26,0,512,59,147,0.401,20,55,0.364,39,92,0.424,0.469,27,32,0.844,8,50,58,95,26,1,41,43,165
2004,Antawn Jamison,SF,27,DAL,82,2,2376,488,913,0.535,16,40,0.4,472,873,0.541,0.543,220,294,0.748,233,287,520,70,83,30,81,174,1212
2004,Chris Jefferies,SG,23,TOR,2,0,8,3,6,0.5,1,3,0.333,2,3,0.667,0.583,1,1,1,0,1,1,1,0,0,1,0,8
2004,Chris Jefferies,SF,23,CHI,19,2,187,24,66,0.364,16,39,0.41,8,27,0.296,0.485,12,19,0.632,5,23,28,6,4,7,18,36,76
2004,Richard Jefferson,SF,23,NJN,82,82,3133,555,1115,0.498,48,132,0.364,507,983,0.516,0.519,357,468,0.763,109,355,464,315,92,28,198,224,1515
2004,Jared Jeffries,PF,22,WAS,82,38,1913,177,469,0.377,5,30,0.167,172,439,0.392,0.383,105,171,0.614,180,244,424,93,48,28,107,212,464
2004,Anthony Johnson,PG,29,IND,73,7,1598,167,411,0.406,41,122,0.336,126,289,0.436,0.456,75,94,0.798,28,102,130,202,64,8,75,138,450
2004,Avery Johnson,PG,38,GSW,46,1,637,80,199,0.402,0,3,0,80,196,0.408,0.402,52,78,0.667,3,30,33,111,26,3,51,34,212
2004,Joe Johnson,SG,22,PHO,82,77,3331,555,1291,0.43,83,272,0.305,472,1019,0.463,0.462,174,232,0.75,80,305,385,362,93,26,199,177,1367
2004,Linton Johnson,SF,23,CHI,41,20,734,72,203,0.355,7,33,0.212,65,170,0.382,0.372,22,37,0.595,59,124,183,27,37,32,37,90,173
2004,Dahntay Jones,SG,23,MEM,20,0,154,15,53,0.283,1,4,0.25,14,49,0.286,0.292,5,11,0.455,7,16,23,12,5,6,12,23,36
2004,Damon Jones,PG,27,MIL,82,26,2016,210,524,0.401,98,273,0.359,112,251,0.446,0.494,55,72,0.764,15,155,170,478,30,4,103,92,573
2004,Eddie Jones,SG,32,MIA,81,81,2998,473,1156,0.409,177,479,0.37,296,677,0.437,0.486,278,333,0.835,38,270,308,258,92,34,129,226,1401
2004,Fred Jones,SG,24,IND,81,2,1508,123,311,0.395,27,89,0.303,96,222,0.432,0.439,124,149,0.832,25,101,126,173,65,18,73,132,397
2004,Jason Kidd,PG,30,NJN,67,66,2450,368,959,0.384,94,293,0.321,274,666,0.411,0.433,206,249,0.827,85,343,428,618,122,14,214,110,1036
2004,Brevin Knight,PG,28,PHO,3,0,19,1,3,0.333,0,0,NA,1,3,0.333,0.333,0,0,NA,0,3,3,4,3,1,3,1,2
2004,Brevin Knight,PG,28,WAS,32,12,598,58,138,0.42,1,5,0.2,57,133,0.429,0.424,19,27,0.704,11,50,61,102,52,0,44,50,136
2004,Brevin Knight,PG,28,MIL,21,1,420,46,105,0.438,1,3,0.333,45,102,0.441,0.443,30,38,0.789,3,45,48,98,29,0,25,56,123
2004,Kyle Korver,SF,22,PHI,74,0,882,115,327,0.352,81,207,0.391,34,120,0.283,0.476,19,24,0.792,30,81,111,40,25,8,41,102,330
2004,Toni Kukoč,PF,35,MIL,73,0,1522,211,506,0.417,49,168,0.292,162,338,0.479,0.465,145,199,0.729,60,211,271,200,59,21,110,110,616
2004,Christian Laettner,PF,34,WAS,48,18,984,119,256,0.465,6,21,0.286,113,235,0.481,0.477,40,50,0.8,50,182,232,89,37,28,42,102,284
2004,Raef LaFrentz,C,27,BOS,17,1,328,57,124,0.46,8,40,0.2,49,84,0.583,0.492,10,13,0.769,30,49,79,24,8,13,11,47,132
2004,Maciej Lampe,C,18,PHO,21,0,224,43,88,0.489,0,4,0,43,84,0.512,0.489,10,13,0.769,9,35,44,9,3,3,15,28,96
2004,Dan Langhi,SF,26,GSW,4,0,17,2,6,0.333,0,0,NA,2,6,0.333,0.333,2,2,1,0,3,3,0,0,0,2,5,6
2004,Dan Langhi,SF,26,MIL,2,0,20,3,8,0.375,1,2,0.5,2,6,0.333,0.438,0,0,NA,0,1,1,0,0,0,0,2,7
2004,Voshon Lenard,SG,30,DEN,73,70,2233,394,933,0.422,106,289,0.367,288,644,0.447,0.479,144,182,0.791,46,154,200,151,61,12,101,177,1038
2004,Rashard Lewis,SF,24,SEA,80,80,2931,535,1229,0.435,145,386,0.376,390,843,0.463,0.494,206,270,0.763,133,385,518,175,99,54,135,233,1421
2004,Tyronn Lue,PG,26,ORL,76,69,2332,309,714,0.433,80,209,0.383,229,505,0.453,0.489,101,131,0.771,26,161,187,317,61,5,124,185,799
2004,Jamaal Magloire,C,25,NOH,82,82,2777,383,809,0.473,0,1,0,383,808,0.474,0.473,353,470,0.751,268,579,847,86,43,101,201,278,1119
2004,Stephon Marbury,PG,26,PHO,34,34,1415,262,606,0.432,37,118,0.314,225,488,0.461,0.463,147,185,0.795,19,98,117,281,64,5,97,74,708
2004,Stephon Marbury,PG,26,NYK,47,47,1839,336,780,0.431,50,156,0.321,286,624,0.458,0.463,209,251,0.833,39,107,146,438,65,4,152,98,931
2004,Shawn Marion,SF,25,PHO,79,79,3217,590,1341,0.44,90,265,0.34,500,1076,0.465,0.474,228,268,0.851,212,525,737,214,167,104,156,203,1498
2004,Donyell Marshall,PF,30,CHI,16,8,408,57,136,0.419,11,27,0.407,46,109,0.422,0.46,14,20,0.7,28,71,99,28,13,20,22,47,139
2004,Donyell Marshall,PF,30,TOR,66,66,2580,413,884,0.467,120,298,0.403,293,586,0.5,0.535,120,162,0.741,182,527,709,94,80,104,95,200,1066
2004,Darrick Martin,PG,32,MIN,16,0,172,20,67,0.299,6,26,0.231,14,41,0.341,0.343,9,9,1,2,5,7,23,2,1,7,23,55
2004,Jamal Mashburn,SF,31,NOH,19,18,730,156,398,0.392,19,67,0.284,137,331,0.414,0.416,65,80,0.813,19,98,117,47,14,5,37,42,396
2004,Desmond Mason,SF,26,MIL,82,31,2534,409,867,0.472,9,39,0.231,400,828,0.483,0.477,356,463,0.769,93,266,359,152,60,24,148,191,1183
2004,Roger Mason,SG,23,CHI,3,0,43,1,11,0.091,1,6,0.167,0,5,0,0.136,0,0,NA,0,3,3,3,1,0,2,5,3
2004,Roger Mason,SG,23,TOR,23,3,285,31,87,0.356,12,33,0.364,19,54,0.352,0.425,19,22,0.864,1,27,28,23,10,6,18,31,93
2004,Tony Massenburg,PF,36,SAC,59,0,789,104,219,0.475,0,1,0,104,218,0.477,0.475,43,63,0.683,57,131,188,29,14,18,45,144,251
2004,Walter McCarty,PF,29,BOS,77,23,1900,203,523,0.388,137,366,0.374,66,157,0.42,0.519,62,82,0.756,28,211,239,124,72,22,91,179,605
2004,Antonio McDyess,PF,29,NYK,18,6,421,65,142,0.458,0,0,NA,65,142,0.458,0.458,22,38,0.579,31,88,119,20,12,11,27,46,152
2004,Antonio McDyess,PF,29,PHO,24,14,506,61,126,0.484,0,0,NA,61,126,0.484,0.484,16,31,0.516,39,99,138,16,25,13,30,71,138
2004,Tracy McGrady,SG,24,ORL,67,67,2675,653,1566,0.417,174,513,0.339,479,1053,0.455,0.473,398,500,0.796,95,307,402,370,93,42,179,129,1878
2004,Jeff McInnis,SG,29,POR,39,26,1269,196,416,0.471,15,47,0.319,181,369,0.491,0.489,58,76,0.763,16,78,94,196,36,2,61,94,465
2004,Jeff McInnis,PG,29,CLE,31,31,1096,138,331,0.417,31,80,0.388,107,251,0.426,0.464,56,67,0.836,17,65,82,234,36,4,59,69,363
2004,Aaron McKie,SF,31,PHI,75,41,2112,265,577,0.459,75,172,0.436,190,405,0.469,0.524,84,111,0.757,45,208,253,195,85,23,103,142,689
2004,Keith McLeod,PG,24,MIN,33,0,391,27,82,0.329,1,10,0.1,26,72,0.361,0.335,33,43,0.767,5,29,34,59,16,1,29,39,88
2004,Ron Mercer,SG,27,SAS,39,0,516,90,211,0.427,2,7,0.286,88,204,0.431,0.431,13,17,0.765,10,39,49,22,14,5,26,37,195
2004,Chris Mihm,PF,24,CLE,22,1,391,59,127,0.465,0,0,NA,59,127,0.465,0.465,34,48,0.708,47,93,140,10,9,22,25,58,152
2004,Chris Mihm,C,24,BOS,54,16,939,127,254,0.5,0,0,NA,127,254,0.5,0.5,76,118,0.644,109,164,273,11,28,41,65,150,330
2004,Darius Miles,SF,22,CLE,37,16,888,143,331,0.432,5,30,0.167,138,301,0.458,0.44,39,72,0.542,48,119,167,80,25,27,56,84,330
2004,Darius Miles,SF,22,POR,42,40,1191,222,422,0.526,2,10,0.2,220,412,0.534,0.528,85,121,0.702,64,128,192,82,42,34,74,84,531
2004,Darko Miličić,C,18,DET,34,0,159,17,65,0.262,0,1,0,17,64,0.266,0.262,14,24,0.583,11,32,43,7,7,15,13,33,48
2004,Andre Miller,PG,27,DEN,82,82,2838,430,941,0.457,12,65,0.185,418,876,0.477,0.463,342,411,0.832,127,239,366,501,142,25,215,194,1214
2004,Brad Miller,PF,27,SAC,72,53,2621,373,731,0.51,12,38,0.316,361,693,0.521,0.518,256,329,0.778,191,552,743,312,68,86,144,247,1014
2004,Mike Miller,SF,23,MEM,65,65,1770,270,616,0.438,80,215,0.372,190,401,0.474,0.503,102,141,0.723,42,174,216,232,59,14,107,162,722
2004,Oliver Miller,C,33,MIN,48,1,506,53,100,0.53,0,1,0,53,99,0.535,0.53,15,23,0.652,46,84,130,36,19,26,33,91,121
2004,Cuttino Mobley,SG,28,HOU,80,80,3229,460,1081,0.426,164,420,0.39,296,661,0.448,0.501,176,217,0.811,40,322,362,258,107,33,180,179,1260
2004,Nazr Mohammed,C,26,ATL,53,1,938,138,280,0.493,0,0,NA,138,280,0.493,0.493,69,110,0.627,101,166,267,20,22,27,55,113,345
2004,Nazr Mohammed,C,26,NYK,27,23,673,108,192,0.563,0,0,NA,108,192,0.563,0.563,31,59,0.525,77,130,207,16,33,25,41,82,247
2004,Jérôme Moïso,PF,25,TOR,35,1,417,40,84,0.476,0,1,0,40,83,0.482,0.476,22,38,0.579,41,72,113,8,17,12,25,42,102
2004,Mikki Moore,C,28,NJN,4,0,10,1,5,0.2,0,0,NA,1,5,0.2,0.2,0,0,NA,1,1,2,0,0,0,0,1,2
2004,Mikki Moore,PF,28,UTA,28,0,385,49,94,0.521,0,0,NA,49,94,0.521,0.521,30,35,0.857,28,54,82,19,7,13,22,64,128
2004,Alonzo Mourning,C,33,NJN,12,0,215,33,71,0.465,0,0,NA,33,71,0.465,0.465,30,34,0.882,8,19,27,8,2,6,10,32,96
2004,Troy Murphy,PF,23,GSW,28,0,610,107,243,0.44,5,17,0.294,102,226,0.451,0.451,60,80,0.75,48,125,173,20,12,17,34,58,279
2004,Ronald Murray,PG,24,SEA,82,18,2021,389,915,0.425,67,229,0.293,322,686,0.469,0.462,168,235,0.715,45,159,204,205,81,28,149,158,1013
2004,Tracy Murray,SF,32,POR,7,0,35,3,12,0.25,2,5,0.4,1,7,0.143,0.333,0,1,0,3,2,5,1,1,0,2,3,8
2004,Dikembe Mutombo,C,37,NYK,65,56,1494,141,295,0.478,0,0,NA,141,295,0.478,0.478,81,119,0.681,145,292,437,25,17,123,54,141,363
2004,Mamadou N'Diaye,C,28,DAL,3,0,7,0,1,0,0,0,NA,0,1,0,0,0,0,NA,0,1,1,0,0,1,1,1,0
2004,Mamadou N'Diaye,C,28,ATL,25,1,359,27,68,0.397,0,0,NA,27,68,0.397,0.397,44,59,0.746,43,68,111,0,8,24,17,58,98
2004,Boštjan Nachbar,SF,23,HOU,45,3,516,47,132,0.356,23,63,0.365,24,69,0.348,0.443,21,29,0.724,8,62,70,30,14,14,23,72,138
2004,Lee Nailon,PF,28,ATL,27,0,300,63,138,0.457,0,0,NA,63,138,0.457,0.457,16,19,0.842,26,37,63,17,10,7,24,48,142
2004,Lee Nailon,SF,28,ORL,8,0,83,11,27,0.407,0,0,NA,11,27,0.407,0.407,7,9,0.778,8,6,14,4,1,0,0,9,29
2004,Lee Nailon,SF,28,CLE,22,4,397,73,162,0.451,0,3,0,73,159,0.459,0.451,24,30,0.8,30,36,66,17,4,1,21,36,170
2004,Eduardo Nájera,SF,27,DAL,58,7,720,72,162,0.444,2,4,0.5,70,158,0.443,0.451,30,46,0.652,67,89,156,25,35,19,29,90,176
2004,Ira Newble,SF,29,CLE,64,25,1245,108,276,0.391,2,19,0.105,106,257,0.412,0.395,36,46,0.783,65,90,155,72,25,19,54,109,254
2004,Moochie Norris,PG,30,HOU,30,0,401,27,87,0.31,8,23,0.348,19,64,0.297,0.356,18,24,0.75,2,28,30,48,16,2,30,16,80
2004,Moochie Norris,PG,30,NYK,36,0,446,53,130,0.408,12,35,0.343,41,95,0.432,0.454,36,47,0.766,8,27,35,73,28,3,34,35,154
2004,Jermaine O'Neal,PF,25,IND,78,78,2788,608,1400,0.434,2,18,0.111,606,1382,0.438,0.435,348,460,0.757,193,585,778,164,59,199,181,248,1566
2004,Shaquille O'Neal,C,31,LAL,67,67,2464,554,948,0.584,0,0,NA,554,948,0.584,0.584,331,676,0.49,246,523,769,196,34,166,195,225,1439
2004,Kevin Ollie,PG,31,CLE,82,7,1401,95,257,0.37,4,9,0.444,91,248,0.367,0.377,147,176,0.835,23,147,170,234,51,8,81,119,341
2004,Michael Olowokandi,C,28,MIN,43,25,925,121,285,0.425,0,0,NA,121,285,0.425,0.425,36,61,0.59,78,167,245,24,16,68,54,137,278
2004,Bo Outlaw,PF,32,MEM,82,1,1606,159,312,0.51,0,4,0,159,308,0.516,0.51,61,116,0.526,125,217,342,90,73,70,69,170,379
2004,Travis Outlaw,PF,19,POR,8,0,19,3,7,0.429,0,0,NA,3,7,0.429,0.429,2,4,0.5,2,2,4,1,1,0,1,1,8
2004,Doug Overton,PG,34,NJN,6,0,22,3,8,0.375,0,0,NA,3,8,0.375,0.375,2,2,1,0,1,1,4,1,0,2,4,8
2004,Doug Overton,PG,34,LAC,55,11,1011,96,237,0.405,3,23,0.13,93,214,0.435,0.411,21,29,0.724,16,69,85,134,25,2,56,85,216
2004,Robert Pack,PG,34,NJN,26,0,220,22,52,0.423,0,0,NA,22,52,0.423,0.423,5,6,0.833,4,14,18,27,12,1,16,20,49
2004,Scott Padgett,PF,27,HOU,58,5,547,74,167,0.443,28,65,0.431,46,102,0.451,0.527,24,32,0.75,46,93,139,23,12,13,22,73,200
2004,Milt Palacio,PG,25,TOR,59,13,1211,104,298,0.349,4,26,0.154,100,272,0.368,0.356,45,68,0.662,15,87,102,184,41,11,87,90,257
2004,Jannero Pargo,PG,24,LAL,13,0,63,6,16,0.375,2,4,0.5,4,12,0.333,0.438,0,0,NA,0,6,6,11,2,0,12,5,14
2004,Jannero Pargo,PG,24,TOR,5,0,71,9,29,0.31,0,5,0,9,24,0.375,0.31,0,0,NA,0,4,4,12,4,1,5,7,18
2004,Jannero Pargo,PG,24,CHI,13,1,345,66,154,0.429,20,53,0.377,46,101,0.455,0.494,23,27,0.852,8,19,27,47,7,5,30,38,175
2004,Cherokee Parks,C,31,GSW,12,0,64,4,10,0.4,0,0,NA,4,10,0.4,0.4,4,6,0.667,4,6,10,1,0,3,2,7,12
2004,Ruben Patterson,SF,28,POR,73,1,1651,200,395,0.506,2,12,0.167,198,383,0.517,0.509,105,190,0.553,129,139,268,139,84,21,105,152,507
2004,Sasha Pavlović,SF,20,UTA,79,14,1144,149,376,0.396,19,70,0.271,130,306,0.425,0.422,65,84,0.774,44,115,159,60,41,16,67,187,382
2004,Gary Payton,PG,35,LAL,82,82,2825,482,1024,0.471,55,165,0.333,427,859,0.497,0.498,180,252,0.714,72,270,342,449,96,19,151,169,1199
2004,Anthony Peeler,SG,34,SAC,75,0,1391,156,348,0.448,68,141,0.482,88,207,0.425,0.546,51,61,0.836,31,122,153,120,56,10,77,103,431
2004,Kendrick Perkins,C,19,BOS,10,0,35,8,15,0.533,0,0,NA,8,15,0.533,0.533,6,9,0.667,5,9,14,3,0,2,5,6,22
2004,Wesley Person,SG,32,MEM,16,0,284,33,107,0.308,11,43,0.256,22,64,0.344,0.36,6,8,0.75,2,16,18,23,5,2,16,11,83
2004,Wesley Person,SG,32,POR,33,0,621,80,168,0.476,36,76,0.474,44,92,0.478,0.583,19,25,0.76,12,62,74,38,11,6,18,22,215
2004,Wesley Person,SG,32,ATL,9,0,132,13,39,0.333,8,19,0.421,5,20,0.25,0.436,6,6,1,2,23,25,5,3,1,4,5,40
2004,Mickaël Piétrus,PG,21,GSW,53,22,748,96,231,0.416,35,105,0.333,61,126,0.484,0.491,52,75,0.693,48,71,119,27,32,12,40,100,279
2004,Olden Polynice,C,39,LAC,2,0,12,0,0,NA,0,0,NA,0,0,NA,NA,0,0,NA,1,1,2,1,1,0,4,2,0
2004,James Posey,SG,27,MEM,82,82,2451,368,770,0.478,112,290,0.386,256,480,0.533,0.551,278,335,0.83,92,311,403,122,137,40,112,248,1126
2004,Vitaly Potapenko,C,28,SEA,65,39,1419,200,409,0.489,0,0,NA,200,409,0.489,0.489,59,92,0.641,101,188,289,53,22,28,77,161,459
2004,Tayshaun Prince,SF,23,DET,82,80,2701,338,723,0.467,57,157,0.363,281,566,0.496,0.507,108,141,0.766,93,297,390,191,63,69,119,149,841
2004,Joel Przybilla,C,24,MIL,5,0,33,0,0,NA,0,0,NA,0,0,NA,NA,1,2,0.5,1,9,10,3,0,0,2,5,1
2004,Joel Przybilla,C,24,ATL,12,12,314,18,50,0.36,0,0,NA,18,50,0.36,0.36,12,29,0.414,31,70,101,4,5,17,16,48,48
2004,Vladimir Radmanović,PF,23,SEA,77,38,2321,345,812,0.425,140,377,0.371,205,435,0.471,0.511,95,127,0.748,104,302,406,142,80,42,109,187,925
2004,Zach Randolph,PF,22,POR,81,80,3067,663,1368,0.485,1,5,0.2,662,1363,0.486,0.485,299,393,0.761,242,609,851,163,68,41,247,227,1626
2004,Theo Ratliff,C,30,ATL,53,52,1648,171,373,0.458,0,0,NA,171,373,0.458,0.458,96,147,0.653,105,276,381,51,30,166,86,189,438
2004,Theo Ratliff,C,30,POR,32,31,1016,95,176,0.54,0,0,NA,95,176,0.54,0.54,44,70,0.629,90,143,233,20,24,141,34,111,234
2004,Željko Rebrača,C,31,DET,21,2,222,22,54,0.407,0,0,NA,22,54,0.407,0.407,22,28,0.786,19,30,49,4,5,9,13,45,66
2004,Željko Rebrača,C,31,ATL,3,0,51,12,23,0.522,0,0,NA,12,23,0.522,0.522,1,2,0.5,4,5,9,2,0,2,4,7,25
2004,Jason Richardson,SG,23,GSW,78,78,2936,563,1284,0.438,77,273,0.282,486,1011,0.481,0.468,258,377,0.684,124,400,524,226,86,41,196,182,1461
2004,Luke Ridnour,PG,22,SEA,69,6,1114,145,350,0.414,27,80,0.338,118,270,0.437,0.453,65,79,0.823,35,73,108,163,52,7,80,105,382
2004,Clifford Robinson,PF,37,GSW,82,82,2846,366,945,0.387,112,314,0.357,254,631,0.403,0.447,123,173,0.711,54,268,322,271,68,73,173,237,967
2004,Rodney Rogers,PF,32,NJN,69,15,1409,207,505,0.41,50,152,0.329,157,353,0.445,0.459,75,98,0.765,100,207,307,137,59,27,98,183,539
2004,Sean Rooks,C,34,NOH,35,0,325,34,94,0.362,0,0,NA,34,94,0.362,0.362,12,15,0.8,10,40,50,11,9,5,15,48,80
2004,Sean Rooks,C,34,ORL,20,0,270,20,57,0.351,0,1,0,20,56,0.357,0.351,21,22,0.955,14,33,47,18,5,5,7,41,61
2004,Jalen Rose,SF,31,CHI,16,14,529,75,200,0.375,23,54,0.426,52,146,0.356,0.433,39,51,0.765,7,57,64,56,12,4,37,45,212
2004,Jalen Rose,PG,31,TOR,50,50,1968,308,752,0.41,46,148,0.311,262,604,0.434,0.44,148,180,0.822,27,175,202,273,39,18,171,139,810
2004,Malik Rose,PF,29,SAS,67,13,1256,173,404,0.428,0,3,0,173,401,0.431,0.428,183,225,0.813,110,210,320,69,36,24,112,164,529
2004,Kareem Rush,SG,23,LAL,72,15,1244,190,432,0.44,48,138,0.348,142,294,0.483,0.495,31,52,0.596,20,77,97,59,33,20,48,109,459
2004,John Salmons,SG,24,PHI,77,24,1603,161,416,0.387,50,147,0.34,111,269,0.413,0.447,71,92,0.772,38,158,196,134,62,16,77,122,443
2004,Brian Skinner,C,27,MIL,56,54,1577,255,513,0.497,0,0,NA,255,513,0.497,0.497,79,138,0.572,119,292,411,49,30,61,78,165,589
2004,Jabari Smith,C,26,SAC,31,0,168,26,70,0.371,0,3,0,26,67,0.388,0.371,12,20,0.6,11,20,31,11,2,6,7,25,64
2004,Joe Smith,PF,28,MIL,76,76,2254,311,708,0.439,1,5,0.2,310,703,0.441,0.44,207,241,0.859,230,413,643,78,47,94,82,209,830
2004,Steve Smith,SG,34,NOH,71,4,929,119,293,0.406,43,107,0.402,76,186,0.409,0.48,77,83,0.928,27,54,81,56,15,6,42,91,358
2004,Eric Snow,PG,30,PHI,82,82,2966,295,715,0.413,2,18,0.111,293,697,0.42,0.414,252,316,0.797,62,219,281,563,97,6,187,213,844
2004,Jerry Stackhouse,SF,29,WAS,26,17,774,128,321,0.399,23,65,0.354,105,256,0.41,0.435,83,103,0.806,16,78,94,103,24,3,88,49,362
2004,DeShawn Stevenson,SG,22,UTA,54,54,1511,261,586,0.445,7,30,0.233,254,556,0.457,0.451,89,133,0.669,43,135,178,92,28,16,80,86,618
2004,DeShawn Stevenson,SF,22,ORL,26,24,933,115,285,0.404,12,41,0.293,103,244,0.422,0.425,49,71,0.69,36,84,120,66,24,1,40,54,291
2004,Michael Stewart,PF,28,CLE,8,2,76,3,7,0.429,0,0,NA,3,7,0.429,0.429,2,2,1,5,13,18,0,1,8,1,21,8
2004,Michael Stewart,C,28,BOS,17,0,71,2,5,0.4,0,0,NA,2,5,0.4,0.4,1,2,0.5,3,8,11,0,1,2,2,13,5
2004,Peja Stojaković,SF,26,SAC,81,81,3264,665,1386,0.48,240,554,0.433,425,832,0.511,0.566,394,425,0.927,91,417,508,173,108,14,153,159,1964
2004,Damon Stoudamire,PG,30,POR,82,82,3118,408,1018,0.401,156,427,0.365,252,591,0.426,0.477,127,145,0.876,52,256,308,500,99,9,180,173,1099
2004,Amar'e Stoudemire,PF,21,PHO,55,53,2025,411,865,0.475,1,5,0.2,410,860,0.477,0.476,310,435,0.713,157,339,496,78,64,89,177,188,1133
2004,Erick Strickland,PG,30,MIL,43,0,571,79,196,0.403,29,66,0.439,50,130,0.385,0.477,44,51,0.863,13,58,71,90,26,2,54,63,231
2004,Rod Strickland,PG,37,ORL,46,9,915,122,269,0.454,10,33,0.303,112,236,0.475,0.472,57,76,0.75,24,94,118,185,27,7,67,59,311
2004,Rod Strickland,PG,37,TOR,15,1,282,28,84,0.333,0,3,0,28,81,0.346,0.333,15,22,0.682,10,27,37,59,8,4,18,17,71
2004,Bruno Šundov,C,23,CLE,4,0,29,3,9,0.333,0,0,NA,3,9,0.333,0.333,3,6,0.5,2,8,10,0,0,0,3,7,9
2004,Bruno Šundov,C,23,NYK,1,0,4,1,1,1,0,0,NA,1,1,1,1,0,0,NA,0,0,0,1,0,0,0,2,2
2004,Bob Sura,SG,30,DET,53,0,707,71,173,0.41,9,36,0.25,62,137,0.453,0.436,48,69,0.696,30,73,103,89,37,9,39,86,199
2004,Bob Sura,SG,30,ATL,27,18,956,131,312,0.42,12,43,0.279,119,269,0.442,0.439,123,157,0.783,70,153,223,144,25,5,66,72,397
2004,Stromile Swift,PF,24,MEM,77,10,1528,268,571,0.469,1,4,0.25,267,567,0.471,0.47,190,262,0.725,141,237,378,38,56,118,88,188,727
2004,Wally Szczerbiak,SF,26,MIN,28,0,622,106,236,0.449,20,46,0.435,86,190,0.453,0.492,53,64,0.828,24,64,88,33,12,1,28,42,285
2004,Maurice Taylor,PF,27,HOU,75,10,2081,367,765,0.48,0,2,0,367,763,0.481,0.48,128,174,0.736,131,253,384,107,43,47,149,253,862
2004,Kenny Thomas,PF,26,PHI,74,72,2699,381,813,0.469,1,5,0.2,380,808,0.47,0.469,243,323,0.752,261,489,750,111,82,33,172,219,1006
2004,Kurt Thomas,PF,31,NYK,80,75,2548,392,829,0.473,0,3,0,392,826,0.475,0.473,106,127,0.835,145,517,662,149,56,80,132,298,890
2004,Tim Thomas,SF,26,MIL,42,42,1343,226,510,0.443,47,130,0.362,179,380,0.471,0.489,93,122,0.762,38,167,205,90,40,15,73,127,592
2004,Tim Thomas,SF,26,NYK,24,23,746,137,303,0.452,26,64,0.406,111,239,0.464,0.495,78,96,0.813,26,89,115,34,24,5,43,69,378
2004,Gary Trent,C,29,MIN,68,2,1025,155,328,0.473,0,6,0,155,322,0.481,0.473,69,91,0.758,83,133,216,49,12,17,54,129,379
2004,Cezary Trybański,C,24,PHO,4,0,10,0,2,0,0,0,NA,0,2,0,0,0,0,NA,0,1,1,0,0,1,2,1,0
2004,Cezary Trybański,C,24,NYK,3,0,5,0,2,0,0,0,NA,0,2,0,0,1,2,0.5,0,0,0,0,1,0,0,2,1
2004,Jake Tsakalidis,C,24,MEM,40,28,533,67,133,0.504,0,0,NA,67,133,0.504,0.504,36,61,0.59,37,91,128,18,9,22,23,79,170
2004,Nikoloz Tskitishvili,PF,20,DEN,39,0,307,40,122,0.328,3,11,0.273,37,111,0.333,0.34,23,29,0.793,24,39,63,10,6,8,17,50,106
2004,Hedo Türkoğlu,SF,24,SAS,80,44,2073,262,645,0.406,101,241,0.419,161,404,0.399,0.484,114,161,0.708,52,306,358,154,80,32,94,165,739
2004,Nick Van Exel,PG,32,GSW,39,29,1255,187,479,0.39,46,150,0.307,141,329,0.429,0.438,70,99,0.707,16,88,104,206,20,2,78,57,490
2004,Keith Van Horn,SF,28,NYK,47,47,1574,273,613,0.445,60,161,0.373,213,452,0.471,0.494,163,199,0.819,98,245,343,83,52,18,119,151,769
2004,Keith Van Horn,SF,28,MIL,25,15,766,137,290,0.472,33,72,0.458,104,218,0.477,0.529,86,91,0.945,51,107,158,37,16,15,50,64,393
2004,Dwyane Wade,PG,22,MIA,61,56,2126,371,798,0.465,16,53,0.302,355,745,0.477,0.475,233,312,0.747,85,162,247,275,86,34,196,140,991
2004,Antoine Walker,PF,27,DAL,82,82,2840,483,1129,0.428,82,305,0.269,401,824,0.487,0.464,103,186,0.554,198,486,684,369,65,65,202,212,1151
2004,Ben Wallace,C,29,DET,81,81,3050,315,748,0.421,1,8,0.125,314,740,0.424,0.422,142,290,0.49,324,682,1006,138,143,246,123,162,773
2004,Gerald Wallace,SF,21,SAC,37,1,337,32,89,0.36,0,2,0,32,87,0.368,0.36,11,24,0.458,35,39,74,19,14,14,8,37,75
2004,Rasheed Wallace,PF,29,POR,45,44,1675,296,669,0.442,59,173,0.341,237,496,0.478,0.487,115,155,0.742,69,229,298,114,36,72,87,131,766
2004,Rasheed Wallace,PF,29,ATL,1,1,42,8,24,0.333,1,6,0.167,7,18,0.389,0.354,3,3,1,1,5,6,2,1,5,3,0,20
2004,Rasheed Wallace,PF,29,DET,22,21,673,121,281,0.431,22,69,0.319,99,212,0.467,0.47,38,54,0.704,32,123,155,40,24,45,29,59,302
2004,Luke Walton,PF,23,LAL,72,2,730,65,153,0.425,13,39,0.333,52,114,0.456,0.467,31,44,0.705,39,88,127,113,28,8,44,70,174
2004,Charlie Ward,PG,33,NYK,35,10,827,115,260,0.442,59,138,0.428,56,122,0.459,0.556,16,21,0.762,10,86,96,170,47,8,69,74,305
2004,Charlie Ward,PG,33,SAS,36,0,425,45,130,0.346,25,68,0.368,20,62,0.323,0.442,4,6,0.667,2,46,48,45,17,3,27,33,119
2004,Earl Watson,PG,24,MEM,81,14,1669,172,464,0.371,26,106,0.245,146,358,0.408,0.399,90,138,0.652,49,129,178,402,91,19,146,175,460
2004,Clarence Weatherspoon,PF,33,NYK,15,1,216,18,40,0.45,0,0,NA,18,40,0.45,0.45,18,19,0.947,14,36,50,13,8,2,9,19,54
2004,Clarence Weatherspoon,PF,33,HOU,37,0,652,86,171,0.503,0,1,0,86,170,0.506,0.503,35,53,0.66,60,94,154,17,22,13,26,56,207
2004,Chris Webber,PF,30,SAC,23,23,831,174,421,0.413,1,5,0.2,173,416,0.416,0.414,81,114,0.711,48,152,200,105,31,20,60,76,430
2004,Bonzi Wells,SG,27,POR,13,10,404,68,175,0.389,1,8,0.125,67,167,0.401,0.391,21,27,0.778,21,40,61,35,20,3,32,38,158
2004,Bonzi Wells,SG,27,MEM,59,17,1468,295,675,0.437,21,61,0.344,274,614,0.446,0.453,117,156,0.75,57,142,199,104,71,16,129,159,728
2004,Jiří Welsch,SG,24,BOS,81,68,2179,262,612,0.428,69,181,0.381,193,431,0.448,0.484,153,206,0.743,60,236,296,183,101,7,129,176,746
2004,David Wesley,SG,33,NOH,61,60,2001,311,800,0.389,92,285,0.323,219,515,0.425,0.446,137,182,0.753,28,106,134,175,71,14,100,147,851
2004,Jahidi White,C,27,WAS,1,0,4,0,1,0,0,0,NA,0,1,0,0,0,0,NA,0,0,0,0,0,1,1,0,0
2004,Jahidi White,C,27,PHO,61,17,861,99,189,0.524,0,0,NA,99,189,0.524,0.524,63,126,0.5,97,164,261,7,25,50,65,176,261
2004,Rodney White,SF,23,DEN,72,0,985,215,468,0.459,33,87,0.379,182,381,0.478,0.495,78,104,0.75,44,121,165,60,32,20,78,105,541
2004,Chris Whitney,PG,32,WAS,16,5,186,17,45,0.378,8,18,0.444,9,27,0.333,0.467,5,5,1,3,12,15,14,6,2,6,6,47
2004,Chris Wilcox,C,21,LAC,65,17,1340,227,436,0.521,0,1,0,227,435,0.522,0.521,105,150,0.7,125,180,305,51,29,20,80,183,559
2004,Mike Wilks,PG,24,HOU,26,0,145,17,36,0.472,6,10,0.6,11,26,0.423,0.556,10,12,0.833,3,13,16,17,3,0,7,15,50
2004,Aaron Williams,C,32,NJN,72,7,1337,172,342,0.503,1,3,0.333,171,339,0.504,0.504,105,155,0.677,101,193,294,81,34,46,89,187,450
2004,Alvin Williams,SG,29,TOR,56,54,1730,201,496,0.405,26,89,0.292,175,407,0.43,0.431,66,85,0.776,18,132,150,224,55,10,78,114,494
2004,Eric Williams,SF,31,BOS,21,0,513,77,177,0.435,11,32,0.344,66,145,0.455,0.466,78,109,0.716,21,74,95,25,22,1,31,52,243
2004,Eric Williams,SF,31,CLE,50,36,1373,154,421,0.366,24,95,0.253,130,326,0.399,0.394,137,174,0.787,44,147,191,95,48,8,57,128,469
2004,Jason Williams,PG,28,MEM,72,68,2115,290,713,0.407,120,364,0.33,170,349,0.487,0.491,82,98,0.837,25,122,147,492,92,5,136,97,782
2004,Jerome Williams,PF,30,TOR,15,12,407,28,57,0.491,0,1,0,28,56,0.5,0.491,21,29,0.724,35,93,128,11,19,3,23,30,77
2004,Jerome Williams,PF,30,CHI,53,32,1230,130,279,0.466,0,7,0,130,272,0.478,0.466,85,126,0.675,142,205,347,61,71,5,51,104,345
2004,Mo Williams,SG,21,UTA,57,0,772,115,303,0.38,10,39,0.256,105,264,0.398,0.396,44,56,0.786,23,49,72,76,28,2,51,87,284
2004,Scott Williams,C,35,PHO,16,10,267,53,101,0.525,2,2,1,51,99,0.515,0.535,9,13,0.692,23,49,72,6,15,7,6,45,117
2004,Scott Williams,C,35,DAL,27,11,260,37,85,0.435,0,1,0,37,84,0.44,0.435,7,14,0.5,15,45,60,11,5,9,10,50,81
2004,Shammond Williams,SG,28,ORL,37,2,525,59,151,0.391,25,74,0.338,34,77,0.442,0.474,40,45,0.889,9,34,43,64,23,1,26,40,183
2004,Shammond Williams,PG,28,NOH,16,2,238,28,81,0.346,5,26,0.192,23,55,0.418,0.377,11,13,0.846,0,17,17,52,14,1,21,22,72
2004,Corliss Williamson,PF,30,DET,79,0,1574,304,602,0.505,0,0,NA,304,602,0.505,0.505,144,197,0.731,88,168,256,57,30,20,113,204,752
2004,Kevin Willis,C,41,SAS,48,0,373,70,150,0.467,0,1,0,70,149,0.47,0.467,24,39,0.615,37,61,98,11,21,9,32,61,164
2004,Metta World Peace,SF,24,IND,73,71,2714,468,1112,0.421,75,242,0.31,393,870,0.452,0.455,322,439,0.733,100,285,385,272,152,50,202,194,1333
2004,Lorenzen Wright,C,28,MEM,65,46,1674,257,586,0.439,0,5,0,257,581,0.442,0.439,96,131,0.733,144,301,445,71,45,58,77,192,610
2004,Wang Zhizhi,C,26,LAC,2,0,9,0,1,0,0,0,NA,0,1,0,0,4,4,1,0,4,4,0,0,1,0,0,4
2004,Wang Zhizhi,C,26,MIA,14,0,105,17,45,0.378,4,14,0.286,13,31,0.419,0.422,5,6,0.833,4,10,14,2,3,4,6,13,43
2005,Shareef Abdur-Rahim,PF,28,POR,54,49,1867,337,670,0.503,15,39,0.385,322,631,0.51,0.514,220,254,0.866,123,269,392,111,49,26,117,150,909
2005,Cory Alexander,SG,31,CHA,16,1,201,16,49,0.327,8,19,0.421,8,30,0.267,0.408,9,12,0.75,8,21,29,37,9,1,19,29,49
2005,Malik Allen,PF,26,MIA,14,0,248,35,76,0.461,0,0,NA,35,76,0.461,0.461,13,14,0.929,24,28,52,11,4,11,11,29,83
2005,Malik Allen,PF,26,CHA,22,1,271,49,101,0.485,0,0,NA,49,101,0.485,0.485,13,14,0.929,16,31,47,7,5,11,7,24,111
2005,Ray Allen,SG,29,SEA,78,78,3064,640,1494,0.428,209,556,0.376,431,938,0.459,0.498,378,428,0.883,79,268,347,289,84,5,171,167,1867
2005,Rafer Alston,PG,28,TOR,80,78,2717,403,974,0.414,139,389,0.357,264,585,0.451,0.485,191,258,0.74,42,237,279,514,118,7,170,212,1136
2005,Chris Andersen,C,26,NOH,67,2,1430,191,358,0.534,0,3,0,191,355,0.538,0.534,131,190,0.689,137,273,410,71,14,100,64,144,513
2005,Derek Anderson,SG,30,POR,47,32,1239,152,391,0.389,58,151,0.384,94,240,0.392,0.463,70,87,0.805,25,103,128,143,36,4,70,89,432
2005,Kenny Anderson,PG,34,ATL,39,20,717,81,190,0.426,6,13,0.462,75,177,0.424,0.442,27,37,0.73,23,60,83,98,33,0,46,81,195
2005,Kenny Anderson,PG,34,LAC,4,0,26,4,11,0.364,0,0,NA,4,11,0.364,0.364,0,0,NA,1,4,5,5,0,0,3,6,8
2005,Shandon Anderson,SG,31,NYK,1,0,20,0,2,0,0,1,0,0,1,0,0,0,0,NA,1,0,1,0,0,0,1,2,0
2005,Shandon Anderson,SF,31,MIA,65,5,1151,98,215,0.456,5,28,0.179,93,187,0.497,0.467,54,66,0.818,40,150,190,70,40,14,49,136,255
2005,Carmelo Anthony,SF,20,DEN,75,75,2608,530,1230,0.431,42,158,0.266,488,1072,0.455,0.448,456,573,0.796,141,285,426,194,68,30,224,229,1558
2005,Gilbert Arenas,PG,23,WAS,80,80,3274,656,1523,0.431,205,562,0.365,451,961,0.469,0.498,521,640,0.814,83,295,378,411,139,23,242,245,2038
2005,Trevor Ariza,SF,19,NYK,80,12,1382,172,389,0.442,3,13,0.231,169,376,0.449,0.446,121,174,0.695,89,153,242,85,70,18,73,150,468
2005,Darrell Armstrong,PG,36,NOH,14,9,412,53,159,0.333,17,70,0.243,36,89,0.404,0.387,19,21,0.905,16,32,48,65,15,2,28,30,142
2005,Darrell Armstrong,PG,36,DAL,52,7,576,36,118,0.305,11,41,0.268,25,77,0.325,0.352,39,47,0.83,19,48,67,113,30,6,39,62,122
2005,Carlos Arroyo,PG,25,UTA,30,16,742,93,232,0.401,7,18,0.389,86,214,0.402,0.416,53,63,0.841,11,35,46,152,20,3,55,67,246
2005,Carlos Arroyo,PG,25,DET,40,0,706,74,197,0.376,1,12,0.083,73,185,0.395,0.378,66,86,0.767,15,43,58,128,24,1,52,76,215
2005,Chucky Atkins,PG,30,LAL,82,82,2903,388,910,0.426,176,455,0.387,212,455,0.466,0.523,163,203,0.803,31,166,197,358,73,2,151,181,1115
2005,Stacey Augmon,SF,36,ORL,55,7,663,68,167,0.407,0,0,NA,68,167,0.407,0.407,57,77,0.74,45,54,99,36,23,8,31,83,193
2005,Maurice Baker,PG,25,LAC,1,0,1,0,0,NA,0,0,NA,0,0,NA,NA,0,0,NA,0,0,0,0,0,0,0,0,0
2005,Maurice Baker,PG,25,POR,4,0,18,0,1,0,0,0,NA,0,1,0,0,0,0,NA,1,1,2,1,1,0,1,3,0
2005,Vin Baker,PF,33,NYK,24,0,191,13,38,0.342,0,1,0,13,37,0.351,0.342,7,15,0.467,17,20,37,9,2,4,15,31,33
2005,Vin Baker,C,33,HOU,3,0,13,0,4,0,0,0,NA,0,4,0,0,2,2,1,0,2,2,1,0,0,2,7,2
2005,Marcus Banks,PG,23,BOS,81,2,1145,115,286,0.402,21,59,0.356,94,227,0.414,0.439,121,163,0.742,29,97,126,155,63,13,79,146,372
2005,Leandro Barbosa,PG,22,PHO,63,6,1087,168,354,0.475,51,139,0.367,117,215,0.544,0.547,55,69,0.797,32,98,130,126,30,7,87,127,442
2005,Matt Barnes,SF,24,SAC,43,9,715,62,151,0.411,5,22,0.227,57,129,0.442,0.427,35,58,0.603,49,84,133,57,30,7,45,80,164
2005,Andre Barrett,PG,22,HOU,27,0,314,20,69,0.29,9,37,0.243,11,32,0.344,0.355,7,10,0.7,5,14,19,42,14,0,16,35,56
2005,Andre Barrett,PG,22,ORL,11,1,169,25,55,0.455,5,15,0.333,20,40,0.5,0.5,7,9,0.778,6,15,21,27,5,1,11,16,62
2005,Brent Barry,SG,33,SAS,81,8,1742,194,459,0.423,100,280,0.357,94,179,0.525,0.532,113,135,0.837,29,161,190,178,39,20,64,123,601
2005,Jon Barry,SG,35,ATL,16,0,275,31,77,0.403,11,32,0.344,20,45,0.444,0.474,10,13,0.769,4,17,21,28,14,2,14,28,83
2005,Jon Barry,SG,35,HOU,53,2,1230,130,291,0.447,60,133,0.451,70,158,0.443,0.55,52,58,0.897,22,116,138,139,46,7,53,67,372
2005,Tony Battie,C,28,ORL,81,32,1894,163,354,0.46,0,6,0,163,348,0.468,0.46,68,94,0.723,109,343,452,42,30,81,81,244,394
2005,Shane Battier,SG,26,MEM,80,72,2516,271,613,0.442,70,177,0.395,201,436,0.461,0.499,180,228,0.789,158,255,413,126,91,77,75,201,792
2005,Lonny Baxter,PF,26,NOH,4,0,36,3,11,0.273,0,0,NA,3,11,0.273,0.273,0,2,0,4,4,8,0,0,0,4,10,6
2005,Raja Bell,SG,28,UTA,63,32,1790,303,667,0.454,54,134,0.403,249,533,0.467,0.495,112,150,0.747,48,153,201,91,44,8,79,205,772
2005,Travis Best,PG,32,NJN,76,6,1461,190,452,0.42,26,85,0.306,164,367,0.447,0.449,108,122,0.885,19,88,107,143,66,9,67,148,514
2005,Mike Bibby,PG,26,SAC,80,80,3084,560,1264,0.443,131,364,0.36,429,900,0.477,0.495,320,413,0.775,77,255,332,541,124,30,203,191,1571
2005,Chauncey Billups,PG,28,DET,80,80,2866,404,913,0.442,165,387,0.426,239,526,0.454,0.533,343,382,0.898,48,223,271,464,81,9,180,194,1316
2005,Steve Blake,PG,24,WAS,44,1,648,61,186,0.328,36,93,0.387,25,93,0.269,0.425,33,41,0.805,18,53,71,69,13,0,39,47,191
2005,Mark Blount,C,29,BOS,82,57,2130,327,618,0.529,0,1,0,327,617,0.53,0.529,117,164,0.713,143,254,397,129,33,64,158,229,771
2005,Keith Bogans,SG,24,CHA,74,42,1791,262,688,0.381,57,173,0.329,205,515,0.398,0.422,133,183,0.727,76,150,226,135,68,8,122,167,714
2005,Calvin Booth,C,28,DAL,34,1,262,34,79,0.43,0,1,0,34,78,0.436,0.43,14,16,0.875,16,42,58,4,11,16,8,55,82
2005,Calvin Booth,C,28,MIL,17,0,189,15,29,0.517,0,0,NA,15,29,0.517,0.517,12,16,0.75,13,36,49,4,4,12,8,23,42
2005,Bruce Bowen,SF,33,SAS,82,82,2627,251,598,0.42,102,253,0.403,149,345,0.432,0.505,71,112,0.634,50,235,285,126,55,39,57,175,675
2005,Earl Boykins,PG,28,DEN,82,5,2162,340,824,0.413,56,166,0.337,284,658,0.432,0.447,279,303,0.921,37,106,143,372,78,12,121,122,1015
2005,Michael Bradley,PF,25,ORL,8,0,55,3,7,0.429,0,0,NA,3,7,0.429,0.429,0,0,NA,3,11,14,2,1,2,1,4,6
2005,Michael Bradley,PF,25,SAC,8,0,48,8,12,0.667,0,0,NA,8,12,0.667,0.667,2,6,0.333,5,6,11,2,0,0,3,8,18
2005,Michael Bradley,PF,25,PHI,2,0,16,4,5,0.8,0,1,0,4,4,1,0.8,1,2,0.5,0,3,3,1,0,0,1,0,9
2005,Shawn Bradley,C,32,DAL,77,14,885,84,186,0.452,0,0,NA,84,186,0.452,0.452,43,63,0.683,70,144,214,15,25,63,33,153,211
2005,Torraye Braggs,PF,28,HOU,7,0,24,3,7,0.429,0,0,NA,3,7,0.429,0.429,0,0,NA,7,5,12,0,0,0,2,4,6
2005,Primož Brezec,C,25,CHA,72,72,2276,387,756,0.512,0,0,NA,387,756,0.512,0.512,164,220,0.745,226,305,531,86,33,55,106,183,938
2005,Devin Brown,SG,26,SAS,67,0,1238,173,409,0.423,45,121,0.372,128,288,0.444,0.478,103,130,0.792,37,139,176,92,39,12,53,83,494
2005,Kedrick Brown,SF,23,PHI,8,0,55,2,6,0.333,0,3,0,2,3,0.667,0.333,8,10,0.8,1,10,11,4,3,1,5,4,12
2005,Kwame Brown,PF,22,WAS,42,14,908,109,237,0.46,0,0,NA,109,237,0.46,0.46,74,129,0.574,72,134,206,39,25,15,67,112,292
2005,Rick Brunson,PG,32,LAC,80,39,1945,166,442,0.376,48,130,0.369,118,312,0.378,0.43,57,74,0.77,23,164,187,410,82,7,125,106,437
2005,Caron Butler,SF,24,LAL,77,77,2746,441,991,0.445,38,125,0.304,403,866,0.465,0.464,275,319,0.862,146,304,450,146,110,23,125,213,1195
2005,Rasual Butler,SF,25,MIA,65,15,1203,163,409,0.399,57,153,0.373,106,256,0.414,0.468,37,48,0.771,15,136,151,62,18,29,37,104,420
2005,Žarko Čabarkapa,PF,23,PHO,3,0,11,4,7,0.571,0,0,NA,4,7,0.571,0.571,1,1,1,2,1,3,0,0,0,0,0,9
2005,Žarko Čabarkapa,PF,23,GSW,37,0,464,82,170,0.482,13,36,0.361,69,134,0.515,0.521,52,64,0.813,33,66,99,25,10,5,30,59,229
2005,Marcus Camby,C,30,DEN,66,66,2015,279,600,0.465,0,4,0,279,596,0.468,0.465,125,173,0.723,131,530,661,152,61,199,103,177,683
2005,Elden Campbell,C,36,NJN,10,0,50,0,7,0,0,0,NA,0,7,0,0,2,4,0.5,3,8,11,3,0,1,1,10,2
2005,Elden Campbell,C,36,DET,30,1,340,39,116,0.336,0,2,0,39,114,0.342,0.336,40,51,0.784,25,57,82,16,8,6,28,47,118
2005,Matt Carroll,SG,24,CHA,25,0,430,70,180,0.389,13,39,0.333,57,141,0.404,0.425,71,83,0.855,13,47,60,17,17,2,25,37,224
2005,Anthony Carter,PG,29,MIN,66,12,742,72,177,0.407,2,17,0.118,70,160,0.438,0.412,35,51,0.686,12,57,69,161,35,18,62,88,181
2005,Vince Carter,SG,28,TOR,20,20,608,124,302,0.411,19,59,0.322,105,243,0.432,0.442,50,72,0.694,28,38,66,61,25,15,22,56,317
2005,Vince Carter,SF,28,NJN,57,56,2220,572,1239,0.462,108,254,0.425,464,985,0.471,0.505,317,388,0.817,78,257,335,266,84,33,146,187,1569
2005,Sam Cassell,PG,35,MIN,59,38,1522,319,687,0.464,27,103,0.262,292,584,0.5,0.484,134,155,0.865,25,132,157,301,36,14,109,160,799
2005,Kelvin Cato,C,30,ORL,62,50,1525,160,297,0.539,0,0,NA,160,297,0.539,0.539,112,143,0.783,102,314,416,40,55,82,64,170,432
2005,Tyson Chandler,C,22,CHI,80,10,2189,207,419,0.494,0,2,0,207,417,0.496,0.494,226,336,0.673,261,514,775,65,69,141,118,268,640
2005,Doug Christie,SG,34,SAC,31,31,996,83,204,0.407,10,39,0.256,73,165,0.442,0.431,50,56,0.893,29,94,123,153,43,13,68,61,226
2005,Doug Christie,SG,34,ORL,21,13,529,47,128,0.367,5,23,0.217,42,105,0.4,0.387,20,22,0.909,9,45,54,46,37,5,36,45,119
2005,Speedy Claxton,PG,26,GSW,46,44,1501,216,501,0.431,10,52,0.192,206,449,0.459,0.441,162,213,0.761,32,121,153,286,87,6,92,154,604
2005,Speedy Claxton,PG,26,NOH,16,3,365,41,110,0.373,1,9,0.111,40,101,0.396,0.377,25,41,0.61,5,26,31,88,22,2,27,30,108
2005,Jarron Collins,C,26,UTA,50,38,961,65,157,0.414,0,1,0,65,156,0.417,0.414,83,119,0.697,57,107,164,61,11,6,34,146,213
2005,Jason Collins,C,26,NJN,80,80,2542,186,451,0.412,2,6,0.333,184,445,0.413,0.415,137,209,0.656,153,335,488,105,71,71,91,322,511
2005,Brian Cook,C,24,LAL,72,0,1087,176,422,0.417,78,199,0.392,98,223,0.439,0.509,28,37,0.757,63,153,216,35,23,26,29,139,458
2005,Jamal Crawford,SG,24,NYK,70,67,2688,437,1097,0.398,185,512,0.361,252,585,0.431,0.483,182,216,0.843,33,170,203,302,92,19,148,135,1241
2005,Austin Croshere,PF,29,IND,73,22,1827,188,497,0.378,45,174,0.259,143,323,0.443,0.424,226,256,0.883,103,272,375,98,48,17,104,154,647
2005,Michael Curry,SF,36,IND,18,7,249,13,29,0.448,0,0,NA,13,29,0.448,0.448,4,8,0.5,8,19,27,15,5,4,5,39,30
2005,Antonio Daniels,PG,29,SEA,75,2,2026,273,623,0.438,49,165,0.297,224,458,0.489,0.478,248,304,0.816,20,149,169,309,51,3,78,78,843
2005,Antonio Davis,PF,36,CHI,72,62,1843,193,419,0.461,0,0,NA,193,419,0.461,0.461,115,152,0.757,152,276,428,80,27,41,96,147,501
2005,Baron Davis,PG,25,NOH,18,13,593,111,303,0.366,44,137,0.321,67,166,0.404,0.439,74,96,0.771,16,51,67,129,31,4,38,52,340
2005,Baron Davis,PG,25,GSW,28,19,988,180,449,0.401,74,217,0.341,106,232,0.457,0.483,111,147,0.755,16,92,108,233,50,10,93,74,545
2005,Dale Davis,C,35,GSW,36,3,577,45,109,0.413,0,0,NA,45,109,0.413,0.413,22,38,0.579,61,92,153,23,13,32,20,79,112
2005,Dale Davis,C,35,IND,25,25,730,67,125,0.536,0,0,NA,67,125,0.536,0.536,38,61,0.623,91,131,222,24,19,33,23,83,172
2005,Josh Davis,PF,24,PHI,42,5,328,42,111,0.378,19,53,0.358,23,58,0.397,0.464,14,17,0.824,29,50,79,12,8,4,15,45,117
2005,Ricky Davis,SG,25,BOS,82,11,2696,481,1041,0.462,61,180,0.339,420,861,0.488,0.491,286,351,0.815,66,183,249,246,89,27,205,174,1309
2005,Andrew DeClercq,C,31,ORL,8,0,49,4,9,0.444,0,0,NA,4,9,0.444,0.444,1,3,0.333,7,3,10,0,2,0,1,14,9
2005,Tony Delk,SG,31,ATL,56,1,1340,246,591,0.416,72,202,0.356,174,389,0.447,0.477,103,136,0.757,28,102,130,104,47,3,54,123,667
2005,Luol Deng,SF,19,CHI,61,45,1663,280,645,0.434,31,117,0.265,249,528,0.472,0.458,120,162,0.741,92,230,322,135,48,27,118,98,711
2005,Boris Diaw,SG,22,ATL,66,25,1201,124,294,0.422,9,50,0.18,115,244,0.471,0.437,57,77,0.74,54,116,170,149,37,18,87,123,314
2005,Dan Dickau,PG,26,DAL,4,0,16,1,8,0.125,1,3,0.333,0,5,0,0.188,2,3,0.667,0,1,1,1,0,0,1,1,5
2005,Dan Dickau,PG,26,NOH,67,46,2074,305,748,0.408,84,242,0.347,221,506,0.437,0.464,188,225,0.836,34,145,179,346,76,4,144,200,882
2005,DeSagana Diop,C,23,CLE,39,0,306,20,69,0.29,0,2,0,20,67,0.299,0.29,0,5,0,30,40,70,15,8,27,12,53,40
2005,Juan Dixon,SG,26,WAS,63,4,1054,186,447,0.416,48,147,0.327,138,300,0.46,0.47,87,97,0.897,32,87,119,111,43,4,68,98,507
2005,Michael Doleac,C,27,MIA,80,8,1175,148,331,0.447,0,2,0,148,329,0.45,0.447,25,41,0.61,74,185,259,47,23,22,36,160,321
2005,Mike Dunleavy,SF,24,GSW,79,79,2570,408,905,0.451,107,276,0.388,301,629,0.479,0.51,134,172,0.779,97,338,435,203,79,26,132,198,1057
2005,Ronald Dupree,SF,24,DET,47,0,472,61,127,0.48,1,2,0.5,60,125,0.48,0.484,29,47,0.617,34,61,95,24,7,10,22,60,152
2005,Howard Eisley,PG,32,UTA,74,1,1428,161,405,0.398,27,103,0.262,134,302,0.444,0.431,66,83,0.795,15,75,90,250,45,9,111,156,415
2005,Obinna Ekezie,C,29,ATL,42,31,732,79,182,0.434,0,1,0,79,181,0.436,0.434,72,93,0.774,69,110,179,11,22,12,45,129,230
2005,Francisco Elson,C,28,DEN,67,11,939,101,216,0.468,1,3,0.333,100,213,0.469,0.47,45,79,0.57,61,140,201,34,34,41,40,129,248
2005,Melvin Ely,PF,26,CHA,79,17,1649,227,526,0.432,0,0,NA,227,526,0.432,0.432,122,212,0.575,142,184,326,76,32,69,115,199,576
2005,Maurice Evans,SG,26,SAC,65,11,1233,165,373,0.442,27,82,0.329,138,291,0.474,0.479,59,78,0.756,88,113,201,45,37,8,34,104,416
2005,Reggie Evans,PF,24,SEA,79,79,1881,131,275,0.476,0,2,0,131,273,0.48,0.476,125,234,0.534,254,482,736,58,58,15,104,202,387
2005,Michael Finley,SG,31,DAL,64,64,2358,387,907,0.427,116,285,0.407,271,622,0.436,0.491,113,136,0.831,45,217,262,169,48,18,60,123,1003
2005,Derek Fisher,PG,30,GSW,74,32,2222,297,755,0.393,108,291,0.371,189,464,0.407,0.465,175,203,0.862,38,180,218,301,76,4,129,176,877
2005,Luis Flores,PG,23,GSW,15,0,73,13,27,0.481,4,9,0.444,9,18,0.5,0.556,2,2,1,0,2,2,11,2,0,11,9,32
2005,Luis Flores,PG,23,DEN,1,0,4,1,2,0.5,1,1,1,0,1,0,0.75,0,0,NA,1,0,1,0,0,0,0,0,3
2005,Adonal Foyle,C,29,GSW,78,50,1700,156,311,0.502,0,0,NA,156,311,0.502,0.502,40,72,0.556,165,264,429,56,26,159,58,201,352
2005,Richie Frahm,SG,27,POR,43,0,499,56,140,0.4,31,80,0.388,25,60,0.417,0.511,21,25,0.84,17,44,61,30,15,4,14,35,164
2005,Steve Francis,PG,27,ORL,78,78,2978,563,1330,0.423,38,127,0.299,525,1203,0.436,0.438,499,606,0.823,126,324,450,547,112,28,317,273,1663
2005,Dan Gadzuric,C,26,MIL,81,81,1783,243,451,0.539,0,0,NA,243,451,0.539,0.539,107,199,0.538,261,413,674,30,47,106,81,224,593
2005,Reece Gaines,PG,24,HOU,10,0,108,10,27,0.37,3,12,0.25,7,15,0.467,0.426,3,4,0.75,0,11,11,3,3,0,4,12,26
2005,Reece Gaines,PG,24,MIL,11,0,79,7,23,0.304,1,2,0.5,6,21,0.286,0.326,0,0,NA,1,2,3,4,2,1,3,5,15
2005,Kevin Garnett,PF,28,MIN,82,82,3121,683,1360,0.502,6,25,0.24,677,1335,0.507,0.504,445,549,0.811,247,861,1108,466,121,112,222,207,1817
2005,Pau Gasol,PF,24,MEM,56,53,1790,357,695,0.514,1,6,0.167,356,689,0.517,0.514,282,367,0.768,130,280,410,135,37,93,137,146,997
2005,Eddie Gill,PG,26,IND,73,3,1021,81,242,0.335,36,117,0.308,45,125,0.36,0.409,71,81,0.877,16,96,112,83,59,5,60,105,269
2005,Kendall Gill,SG,36,MIL,14,0,284,32,80,0.4,3,9,0.333,29,71,0.408,0.419,18,20,0.9,11,26,37,27,14,4,9,37,85
2005,Gordan Giriček,SG,27,UTA,81,44,1660,283,632,0.448,38,105,0.362,245,527,0.465,0.478,111,137,0.81,25,157,182,137,46,11,90,155,715
2005,Dion Glover,SG,26,SAS,7,0,68,8,22,0.364,1,8,0.125,7,14,0.5,0.386,8,10,0.8,3,8,11,4,3,3,2,9,25
2005,Anthony Goldwire,PG,33,DET,9,0,55,4,15,0.267,3,9,0.333,1,6,0.167,0.367,7,8,0.875,1,7,8,0,0,0,1,5,18
2005,Anthony Goldwire,PG,33,MIL,24,2,482,53,121,0.438,29,71,0.408,24,50,0.48,0.558,19,23,0.826,9,42,51,78,15,0,14,27,154
2005,Drew Gooden,PF,23,CLE,82,80,2523,464,943,0.492,5,28,0.179,459,915,0.502,0.495,251,310,0.81,207,546,753,130,77,76,133,233,1184
2005,Adrian Griffin,SF,30,CHI,69,1,667,58,161,0.36,2,9,0.222,56,152,0.368,0.366,33,44,0.75,52,94,146,53,43,4,30,78,151
2005,Tom Gugliotta,PF,35,BOS,20,0,218,11,37,0.297,0,0,NA,11,37,0.297,0.297,4,6,0.667,15,28,43,12,9,4,9,23,26
2005,Tom Gugliotta,PF,35,ATL,27,9,748,88,204,0.431,8,26,0.308,80,178,0.449,0.451,29,37,0.784,41,107,148,56,32,13,48,81,213
2005,Darvin Ham,SF,31,DET,47,0,275,17,37,0.459,0,0,NA,17,37,0.459,0.459,12,31,0.387,19,16,35,5,6,7,8,39,46
2005,Zendon Hamilton,C,29,MIL,16,0,159,11,32,0.344,0,0,NA,11,32,0.344,0.344,29,48,0.604,18,24,42,6,5,2,12,26,51
2005,Anfernee Hardaway,SF,33,NYK,37,0,894,110,260,0.423,15,50,0.3,95,210,0.452,0.452,34,46,0.739,19,70,89,74,28,3,50,79,269
2005,Al Harrington,SF,24,ATL,66,66,2550,453,986,0.459,16,74,0.216,437,912,0.479,0.468,236,351,0.672,145,316,461,208,85,16,204,249,1158
2005,Othella Harrington,PF,31,CHI,70,28,1271,217,424,0.512,0,0,NA,217,424,0.512,0.512,127,177,0.718,106,186,292,56,24,18,84,188,561
2005,Devin Harris,PG,21,DAL,76,19,1173,157,366,0.429,44,131,0.336,113,235,0.481,0.489,78,103,0.757,28,74,102,169,77,19,82,139,436
2005,Jason Hart,PG,26,CHA,74,27,1887,257,573,0.449,35,95,0.368,222,478,0.464,0.479,157,200,0.785,18,185,203,367,99,14,102,167,706
2005,Donnell Harvey,PF,24,NJN,3,0,16,2,2,1,0,0,NA,2,2,1,1,4,4,1,2,5,7,1,1,1,1,2,8
2005,Trenton Hassell,SG,25,MIN,82,51,2068,225,475,0.474,1,11,0.091,224,464,0.483,0.475,90,114,0.789,80,139,219,128,30,30,64,200,541
2005,Brendan Haywood,C,25,WAS,68,68,1865,239,427,0.56,0,0,NA,239,427,0.56,0.56,159,261,0.609,202,262,464,57,52,114,96,218,637
2005,Nenê,C,22,DEN,55,18,1317,194,386,0.503,0,2,0,194,384,0.505,0.503,140,212,0.66,104,221,325,84,50,48,94,167,528
2005,Kirk Hinrich,PG,24,CHI,77,77,2800,445,1122,0.397,145,408,0.355,300,714,0.42,0.461,171,216,0.792,32,272,304,494,122,21,176,244,1206
2005,Robert Horry,PF,34,SAS,75,16,1396,157,375,0.419,51,138,0.37,106,237,0.447,0.487,86,109,0.789,91,177,268,80,67,60,69,138,451
2005,Eddie House,SG,26,CHA,13,5,300,61,135,0.452,12,29,0.414,49,106,0.462,0.496,10,13,0.769,2,17,19,24,24,3,13,23,144
2005,Eddie House,SG,26,MIL,5,0,41,6,17,0.353,4,6,0.667,2,11,0.182,0.471,0,0,NA,0,3,3,5,2,0,0,3,16
2005,Eddie House,PG,26,SAC,50,2,550,98,214,0.458,28,62,0.452,70,152,0.461,0.523,13,14,0.929,14,47,61,67,18,3,22,39,237
2005,Josh Howard,SF,24,DAL,76,76,2446,377,793,0.475,34,115,0.296,343,678,0.506,0.497,170,232,0.733,169,315,484,109,116,49,122,211,958
2005,Juwan Howard,PF,31,HOU,61,47,1624,244,541,0.451,0,1,0,244,540,0.452,0.451,97,115,0.843,126,220,346,94,32,5,79,143,585
2005,Larry Hughes,SG,26,WAS,61,61,2358,467,1086,0.43,59,209,0.282,408,877,0.465,0.457,352,453,0.777,74,308,382,285,176,18,153,168,1345
2005,Ryan Humphrey,SF,25,MEM,35,0,317,42,103,0.408,0,2,0,42,101,0.416,0.408,18,37,0.486,50,37,87,6,10,1,23,35,102
2005,Kris Humphries,PF,19,UTA,67,4,873,116,287,0.404,2,6,0.333,114,281,0.406,0.408,44,101,0.436,73,124,197,43,25,18,52,96,278
2005,D.J. Mbenga,C,24,DAL,15,1,58,6,14,0.429,0,0,NA,6,14,0.429,0.429,3,4,0.75,3,5,8,0,0,5,5,13,15
2005,Allen Iverson,PG,29,PHI,75,75,3174,771,1818,0.424,104,338,0.308,667,1480,0.451,0.453,656,786,0.835,51,248,299,596,180,9,344,140,2302
2005,Royal Ivey,PG,23,ATL,62,5,809,85,198,0.429,3,9,0.333,82,189,0.434,0.437,47,67,0.701,19,65,84,103,39,7,58,140,220
2005,Bobby Jackson,SG,31,SAC,25,0,536,109,255,0.427,33,96,0.344,76,159,0.478,0.492,50,58,0.862,23,62,85,59,14,2,28,58,301
2005,Jermaine Jackson,SG,28,NYK,21,0,230,17,33,0.515,0,2,0,17,31,0.548,0.515,8,13,0.615,3,20,23,24,7,1,10,26,42
2005,Jim Jackson,SF,34,HOU,24,24,990,118,283,0.417,54,147,0.367,64,136,0.471,0.512,30,33,0.909,10,105,115,86,23,1,56,67,320
2005,Jim Jackson,SF,34,PHO,40,3,997,130,299,0.435,68,148,0.459,62,151,0.411,0.548,24,25,0.96,23,131,154,97,12,4,59,86,352
2005,Luke Jackson,SF,23,CLE,10,0,43,10,27,0.37,4,6,0.667,6,21,0.286,0.444,5,6,0.833,2,4,6,3,0,0,2,4,29
2005,Marc Jackson,C,30,PHI,81,23,1976,340,731,0.465,0,2,0,340,729,0.466,0.465,289,349,0.828,184,222,406,81,32,18,131,171,969
2005,Stephen Jackson,SF,26,IND,51,49,1806,330,819,0.403,103,286,0.36,227,533,0.426,0.466,190,229,0.83,44,206,250,119,64,14,123,154,953
2005,Casey Jacobsen,SF,23,PHO,40,0,768,65,157,0.414,34,89,0.382,31,68,0.456,0.522,48,62,0.774,17,50,67,37,11,1,27,56,212
2005,Casey Jacobsen,SG,23,NOH,44,1,1030,100,251,0.398,32,88,0.364,68,163,0.417,0.462,103,130,0.792,18,82,100,76,22,7,44,48,335
2005,Mike James,PG,29,MIL,47,0,1167,205,460,0.446,58,152,0.382,147,308,0.477,0.509,67,90,0.744,23,99,122,185,40,4,80,114,535
2005,Mike James,PG,29,HOU,27,5,692,126,291,0.433,42,107,0.393,84,184,0.457,0.505,42,55,0.764,12,74,86,78,25,2,26,60,336
2005,Antawn Jamison,PF,28,WAS,68,68,2605,519,1189,0.437,71,208,0.341,448,981,0.457,0.466,225,296,0.76,160,359,519,154,55,16,118,151,1334
2005,Richard Jefferson,SF,24,NJN,33,33,1355,238,564,0.422,30,89,0.337,208,475,0.438,0.449,227,269,0.844,49,191,240,133,33,17,132,109,733
2005,Jared Jeffries,SF,23,WAS,77,71,2007,203,434,0.468,16,51,0.314,187,383,0.488,0.486,101,173,0.584,152,222,374,151,66,35,114,206,523
2005,Anthony Johnson,PG,30,IND,63,36,1747,203,456,0.445,41,108,0.38,162,348,0.466,0.49,85,113,0.752,32,147,179,302,59,15,96,144,532
2005,Joe Johnson,SF,23,PHO,82,82,3240,544,1179,0.461,177,370,0.478,367,809,0.454,0.536,135,180,0.75,120,302,422,291,79,24,148,167,1400
2005,Linton Johnson,SF,24,SAS,2,0,15,0,2,0,0,1,0,0,1,0,0,0,0,NA,0,3,3,0,1,0,1,1,0
2005,Dahntay Jones,SG,24,MEM,52,7,649,83,190,0.437,23,60,0.383,60,130,0.462,0.497,44,64,0.688,11,58,69,21,13,11,29,81,233
2005,Damon Jones,PG,28,MIA,82,66,2576,331,726,0.456,225,521,0.432,106,205,0.517,0.611,68,86,0.791,14,217,231,350,44,5,98,121,955
2005,Eddie Jones,SF,33,MIA,80,80,2839,351,820,0.428,142,382,0.372,209,438,0.477,0.515,174,216,0.806,38,367,405,212,86,38,99,251,1018
2005,Fred Jones,SG,25,IND,77,14,2268,275,647,0.425,87,229,0.38,188,418,0.45,0.492,176,207,0.85,34,208,242,196,61,31,114,171,813
2005,Jason Kidd,PG,31,NJN,66,65,2435,340,855,0.398,129,358,0.36,211,497,0.425,0.473,142,192,0.74,94,394,488,545,123,9,167,110,951
2005,Brevin Knight,PG,29,CHA,66,61,1944,248,587,0.422,3,20,0.15,245,567,0.432,0.425,167,196,0.852,21,149,170,591,131,5,147,192,666
2005,Kyle Korver,SF,23,PHI,82,57,2667,317,759,0.418,226,558,0.405,91,201,0.453,0.567,82,96,0.854,40,339,379,182,103,33,106,265,942
2005,Nenad Krstić,PF,21,NJN,75,57,1965,281,570,0.493,0,2,0,281,568,0.495,0.493,185,255,0.725,161,240,401,77,32,63,112,280,747
2005,Toni Kukoč,SF,36,MIL,53,6,1099,105,256,0.41,42,116,0.362,63,140,0.45,0.492,44,61,0.721,31,129,160,160,39,13,64,70,296
2005,Christian Laettner,PF,35,MIA,49,0,739,107,184,0.582,1,7,0.143,106,177,0.599,0.584,45,59,0.763,36,95,131,41,32,15,29,78,260
2005,Raef LaFrentz,PF,28,BOS,80,80,2196,341,688,0.496,82,225,0.364,259,463,0.559,0.555,120,148,0.811,154,399,553,98,42,99,70,262,884
2005,Maciej Lampe,C,19,PHO,16,0,119,17,49,0.347,2,3,0.667,15,46,0.326,0.367,8,12,0.667,9,23,32,1,1,2,10,20,44
2005,Maciej Lampe,C,19,NOH,21,0,261,32,83,0.386,0,1,0,32,82,0.39,0.386,7,10,0.7,15,42,57,10,4,5,7,31,71
2005,Voshon Lenard,SG,31,DEN,3,1,54,10,26,0.385,4,12,0.333,6,14,0.429,0.462,5,8,0.625,0,6,6,6,1,0,2,2,29
2005,Rashard Lewis,SF,25,SEA,71,71,2697,532,1151,0.462,173,432,0.4,359,719,0.499,0.537,220,283,0.777,110,278,388,94,75,62,123,158,1457
2005,Shaun Livingston,PG,19,LAC,30,15,814,89,215,0.414,0,2,0,89,213,0.418,0.414,44,59,0.746,22,67,89,151,32,11,75,82,222
2005,Tyronn Lue,PG,27,HOU,21,3,479,48,122,0.393,15,45,0.333,33,77,0.429,0.455,14,18,0.778,0,40,40,58,8,0,24,48,125
2005,Tyronn Lue,PG,27,ATL,49,46,1528,247,532,0.464,40,110,0.364,207,422,0.491,0.502,128,147,0.871,14,95,109,264,25,0,81,120,662
2005,Jamaal Magloire,C,26,NOH,23,22,703,98,227,0.432,0,0,NA,98,227,0.432,0.432,74,123,0.602,79,126,205,29,8,23,59,74,270
2005,Stephon Marbury,PG,27,NYK,82,82,3281,604,1308,0.462,115,325,0.354,489,983,0.497,0.506,458,549,0.834,50,198,248,668,122,6,233,186,1781
2005,Shawn Marion,PF,26,PHO,81,81,3146,613,1289,0.476,114,341,0.334,499,948,0.526,0.52,229,275,0.833,235,680,915,154,163,119,125,199,1569
2005,Donyell Marshall,PF,31,TOR,65,2,1645,262,592,0.443,151,363,0.416,111,229,0.485,0.57,72,91,0.791,95,333,428,81,57,46,42,136,747
2005,Darrick Martin,PG,33,LAC,11,0,190,16,50,0.32,5,18,0.278,11,32,0.344,0.37,5,8,0.625,3,7,10,28,6,0,6,19,42
2005,Kevin Martin,PG,21,SAC,45,0,455,45,117,0.385,5,25,0.2,40,92,0.435,0.406,36,55,0.655,29,29,58,22,16,3,24,35,131
2005,Desmond Mason,SF,27,MIL,80,71,2893,478,1079,0.443,1,8,0.125,477,1071,0.445,0.443,420,524,0.802,85,227,312,217,58,27,164,198,1377
2005,Tony Massenburg,PF,37,SAS,61,6,699,74,182,0.407,0,0,NA,74,182,0.407,0.407,48,63,0.762,54,109,163,14,18,20,40,122,196
2005,Walter McCarty,PF,30,BOS,44,0,553,62,150,0.413,30,90,0.333,32,60,0.533,0.513,8,15,0.533,21,56,77,26,15,9,17,85,162
2005,Walter McCarty,PF,30,PHO,28,0,353,33,85,0.388,25,65,0.385,8,20,0.4,0.535,7,14,0.5,8,53,61,11,10,6,19,59,98
2005,Antonio McDyess,PF,30,DET,77,8,1797,307,598,0.513,0,1,0,307,597,0.514,0.513,126,192,0.656,177,305,482,71,46,52,93,204,740
2005,Tracy McGrady,SF,25,HOU,78,78,3182,715,1660,0.431,142,435,0.326,573,1225,0.468,0.473,431,557,0.774,71,413,484,448,135,52,201,167,2003
2005,Jeff McInnis,PG,30,CLE,76,69,2651,377,915,0.412,91,264,0.345,286,651,0.439,0.462,130,160,0.813,32,125,157,391,56,1,117,177,975
2005,Aaron McKie,SG,32,PHI,68,3,1118,61,142,0.43,20,62,0.323,41,80,0.513,0.5,10,16,0.625,20,152,172,103,48,17,31,116,152
2005,Keith McLeod,PG,25,UTA,53,47,1382,143,408,0.35,18,72,0.25,125,336,0.372,0.373,112,146,0.767,20,93,113,236,63,12,99,138,416
2005,Ron Mercer,SF,28,NJN,18,3,390,65,158,0.411,0,3,0,65,155,0.419,0.411,7,10,0.7,9,31,40,20,16,2,14,20,137
2005,Chris Mihm,C,25,LAL,75,75,1870,280,552,0.507,0,2,0,280,550,0.509,0.507,175,258,0.678,197,305,502,50,14,108,110,237,735
2005,Darius Miles,SF,23,POR,63,22,1699,336,697,0.482,8,23,0.348,328,674,0.487,0.488,129,215,0.6,71,228,299,129,75,78,157,189,809
2005,Darko Miličić,C,19,DET,37,2,254,25,76,0.329,0,0,NA,25,76,0.329,0.329,17,24,0.708,3,40,43,7,2,17,16,31,67
2005,Andre Miller,PG,28,DEN,82,82,2852,427,895,0.477,6,39,0.154,421,856,0.492,0.48,253,302,0.838,100,238,338,569,121,8,220,204,1113
2005,Anthony Miller,PF,33,ATL,2,0,9,2,3,0.667,0,0,NA,2,3,0.667,0.667,0,0,NA,0,1,1,1,1,0,1,2,4
2005,Brad Miller,C,28,SAC,56,56,2089,319,609,0.524,5,19,0.263,314,590,0.532,0.528,233,287,0.812,139,382,521,220,69,68,82,181,876
2005,Mike Miller,SF,24,MEM,76,51,2278,387,766,0.505,140,323,0.433,247,443,0.558,0.597,108,150,0.72,36,264,300,220,54,23,127,197,1022
2005,Cuttino Mobley,SG,29,ORL,23,21,726,128,296,0.432,58,125,0.464,70,171,0.409,0.53,55,69,0.797,11,52,63,42,23,9,41,49,369
2005,Cuttino Mobley,SG,29,SAC,43,43,1662,280,636,0.44,92,217,0.424,188,419,0.449,0.513,113,136,0.831,34,132,166,146,51,21,92,103,765
2005,Nazr Mohammed,C,27,NYK,54,54,1519,234,460,0.509,0,1,0,234,459,0.51,0.509,121,171,0.708,169,270,439,26,53,53,81,172,589
2005,Nazr Mohammed,C,27,SAS,23,5,414,55,142,0.387,0,0,NA,55,142,0.387,0.387,32,56,0.571,78,69,147,8,5,33,27,64,142
2005,Jérôme Moïso,C,26,TOR,8,1,69,3,9,0.333,0,1,0,3,8,0.375,0.333,8,9,0.889,6,17,23,0,2,3,6,7,14
2005,Jérôme Moïso,C,26,NJN,8,0,24,3,4,0.75,0,0,NA,3,4,0.75,0.75,2,4,0.5,3,4,7,0,0,1,1,2,8
2005,Jérôme Moïso,PF,26,CLE,4,0,27,3,5,0.6,0,0,NA,3,5,0.6,0.6,0,0,NA,1,6,7,1,1,2,0,4,6
2005,Mikki Moore,PF,29,LAC,74,4,1178,144,287,0.502,1,5,0.2,143,282,0.507,0.503,107,136,0.787,97,149,246,47,19,32,63,173,396
2005,Alonzo Mourning,PF,34,NJN,18,14,457,68,150,0.453,0,0,NA,68,150,0.453,0.453,51,86,0.593,31,96,127,14,5,41,45,50,187
2005,Alonzo Mourning,C,34,MIA,19,3,245,32,62,0.516,0,0,NA,32,62,0.516,0.516,31,55,0.564,22,49,71,4,3,33,12,32,95
2005,Troy Murphy,PF,24,GSW,70,69,2375,392,947,0.414,59,148,0.399,333,799,0.417,0.445,233,319,0.73,251,505,756,97,53,33,108,190,1076
2005,Ronald Murray,SG,25,SEA,49,6,883,131,363,0.361,24,95,0.253,107,268,0.399,0.394,59,80,0.738,15,83,98,65,30,11,57,59,345
2005,Dikembe Mutombo,C,38,HOU,80,2,1212,108,217,0.498,0,0,NA,108,217,0.498,0.498,106,143,0.741,150,276,426,10,16,101,51,135,322
2005,Mamadou N'Diaye,C,29,LAC,11,0,72,8,20,0.4,0,1,0,8,19,0.421,0.4,4,7,0.571,9,9,18,1,1,5,0,20,20
2005,Boštjan Nachbar,SF,24,HOU,16,2,204,15,43,0.349,10,21,0.476,5,22,0.227,0.465,9,12,0.75,4,26,30,9,1,0,5,30,49
2005,Boštjan Nachbar,PF,24,NOH,55,4,1137,146,368,0.397,65,175,0.371,81,193,0.42,0.485,88,105,0.838,20,132,152,65,28,16,68,153,445
2005,Lee Nailon,SF,29,NOH,68,51,2017,415,869,0.478,0,2,0,415,867,0.479,0.478,133,165,0.806,128,170,298,109,36,16,110,190,963
2005,Eduardo Nájera,PF,28,GSW,42,4,610,70,172,0.407,6,15,0.4,64,157,0.408,0.424,29,45,0.644,53,65,118,37,18,10,32,71,175
2005,Eduardo Nájera,PF,28,DEN,26,0,575,75,150,0.5,0,6,0,75,144,0.521,0.5,29,46,0.63,49,76,125,28,23,14,29,77,179
2005,Jameer Nelson,PG,22,ORL,79,21,1612,286,628,0.455,44,141,0.312,242,487,0.497,0.49,73,107,0.682,52,141,193,237,78,3,117,199,689
2005,Ira Newble,SG,30,CLE,74,69,1832,182,424,0.429,19,53,0.358,163,371,0.439,0.452,55,69,0.797,78,142,220,91,50,18,61,144,438
2005,Andrés Nocioni,SF,25,CHI,81,38,1892,241,601,0.401,25,97,0.258,216,504,0.429,0.422,170,222,0.766,69,317,386,122,37,34,135,208,677
2005,Moochie Norris,PG,31,NYK,32,0,321,32,93,0.344,0,12,0,32,81,0.395,0.344,18,22,0.818,9,33,42,34,17,2,25,42,82
2005,Moochie Norris,PG,31,HOU,6,0,39,3,16,0.188,0,0,NA,3,16,0.188,0.188,2,2,1,1,3,4,5,1,0,2,2,8
2005,Jermaine O'Neal,PF,26,IND,44,41,1530,386,854,0.452,1,6,0.167,385,848,0.454,0.453,295,391,0.754,85,303,388,82,25,88,131,173,1068
2005,Shaquille O'Neal,C,32,MIA,73,73,2492,658,1095,0.601,0,0,NA,658,1095,0.601,0.601,353,765,0.461,253,507,760,200,36,171,203,262,1669
2005,Kevin Ollie,PG,32,PHI,26,0,158,11,31,0.355,0,0,NA,11,31,0.355,0.355,6,9,0.667,3,16,19,19,5,0,6,16,28
2005,Michael Olowokandi,C,29,MIN,62,34,1215,161,353,0.456,0,0,NA,161,353,0.456,0.456,46,69,0.667,106,218,324,29,15,56,68,193,368
2005,Bo Outlaw,PF,33,PHO,39,0,214,12,34,0.353,0,0,NA,12,34,0.353,0.353,5,9,0.556,16,37,53,13,6,12,8,29,29
2005,Travis Outlaw,SF,20,POR,59,2,793,133,267,0.498,4,10,0.4,129,257,0.502,0.506,49,75,0.653,40,81,121,35,30,40,39,77,319
2005,Scott Padgett,PF,28,HOU,66,0,942,98,233,0.421,50,126,0.397,48,107,0.449,0.528,29,40,0.725,47,138,185,55,33,10,30,119,275
2005,Milt Palacio,PG,26,TOR,80,4,1533,175,392,0.446,2,12,0.167,173,380,0.455,0.449,115,155,0.742,26,108,134,279,48,13,104,126,467
2005,Jannero Pargo,PG,25,CHI,32,0,453,82,213,0.385,23,66,0.348,59,147,0.401,0.439,17,23,0.739,12,35,47,76,16,1,45,53,204
2005,Smush Parker,PG,23,DET,11,1,110,11,28,0.393,2,9,0.222,9,19,0.474,0.429,9,13,0.692,2,7,9,11,3,0,10,13,33
2005,Smush Parker,PG,23,PHO,5,0,34,7,15,0.467,1,4,0.25,6,11,0.545,0.5,0,0,NA,2,1,3,4,2,0,9,3,15
2005,Ruben Patterson,SF,29,POR,70,36,1957,319,601,0.531,2,25,0.08,317,576,0.55,0.532,169,282,0.599,126,147,273,138,106,21,143,164,809
2005,Sasha Pavlović,SG,21,CLE,65,9,862,120,276,0.435,30,78,0.385,90,198,0.455,0.489,44,64,0.688,15,56,71,49,29,4,47,121,314
2005,Gary Payton,PG,36,BOS,77,77,2541,339,725,0.468,42,129,0.326,297,596,0.498,0.497,153,201,0.761,48,188,236,469,88,12,148,121,873
2005,Anthony Peeler,SG,35,WAS,40,0,529,56,150,0.373,25,65,0.385,31,85,0.365,0.457,16,18,0.889,14,51,65,57,18,2,28,39,153
2005,Kendrick Perkins,C,20,BOS,60,3,548,56,119,0.471,0,0,NA,56,119,0.471,0.471,37,58,0.638,53,123,176,21,9,37,43,98,149
2005,Wesley Person,SF,33,MIA,16,3,206,25,57,0.439,8,21,0.381,17,36,0.472,0.509,4,4,1,1,21,22,11,6,0,7,6,62
2005,Wesley Person,SF,33,DEN,25,0,461,82,169,0.485,33,68,0.485,49,101,0.485,0.583,5,9,0.556,2,59,61,28,13,4,10,24,202
2005,Mickaël Piétrus,SF,22,GSW,67,3,1340,214,501,0.427,67,195,0.344,147,306,0.48,0.494,141,202,0.698,65,124,189,82,46,18,92,139,636
2005,James Posey,SF,28,MEM,50,18,1382,127,356,0.357,55,178,0.309,72,178,0.404,0.434,96,111,0.865,45,174,219,88,48,23,69,134,405
2005,Vitaly Potapenko,C,29,SEA,33,1,335,45,87,0.517,0,1,0,45,86,0.523,0.517,27,31,0.871,30,48,78,9,7,3,12,53,117
2005,Tayshaun Prince,SF,24,DET,82,82,3039,469,963,0.487,47,138,0.341,422,825,0.512,0.511,221,274,0.807,133,302,435,247,56,71,135,161,1206
2005,Joel Przybilla,C,25,POR,76,50,1858,199,333,0.598,0,0,NA,199,333,0.598,0.598,90,174,0.517,178,410,588,74,24,163,98,239,488
2005,Vladimir Radmanović,PF,24,SEA,63,0,1856,266,650,0.409,128,329,0.389,138,321,0.43,0.508,81,103,0.786,52,237,289,86,57,31,80,172,741
2005,Zach Randolph,PF,23,POR,46,37,1603,332,741,0.448,0,6,0,332,735,0.452,0.448,207,254,0.815,142,300,442,86,34,17,112,112,871
2005,Theo Ratliff,C,31,POR,63,45,1731,115,257,0.447,0,0,NA,115,257,0.447,0.447,74,107,0.692,111,220,331,34,23,158,56,183,304
2005,Željko Rebrača,C,32,LAC,58,2,928,133,234,0.568,0,0,NA,133,234,0.568,0.568,73,85,0.859,49,135,184,26,13,40,49,130,339
2005,Justin Reed,SF,23,BOS,23,0,121,15,29,0.517,0,3,0,15,26,0.577,0.517,11,15,0.733,8,8,16,10,3,1,5,12,41
2005,Jason Richardson,SG,24,GSW,72,72,2724,610,1368,0.446,125,370,0.338,485,998,0.486,0.492,214,309,0.693,125,299,424,281,105,32,169,156,1559
2005,Luke Ridnour,PG,23,SEA,82,82,2571,299,739,0.405,67,178,0.376,232,561,0.414,0.45,159,180,0.883,55,149,204,483,94,23,149,185,824
2005,Bernard Robinson,SG,24,CHA,31,1,328,36,81,0.444,3,8,0.375,33,73,0.452,0.463,18,26,0.692,14,34,48,30,11,4,20,42,93
2005,Clifford Robinson,C,38,GSW,42,29,1090,141,354,0.398,42,127,0.331,99,227,0.436,0.458,35,58,0.603,31,83,114,74,44,39,41,107,359
2005,Clifford Robinson,PF,38,NJN,29,0,599,61,169,0.361,25,66,0.379,36,103,0.35,0.435,27,39,0.692,23,72,95,30,18,14,25,74,174
2005,Rodney Rogers,SF,33,NOH,30,26,882,109,289,0.377,25,92,0.272,84,197,0.426,0.42,32,42,0.762,28,114,142,60,19,12,66,103,275
2005,Rodney Rogers,PF,33,PHI,28,7,485,63,161,0.391,23,76,0.303,40,85,0.471,0.463,20,28,0.714,33,71,104,26,22,8,20,69,169
2005,Jalen Rose,SF,32,TOR,81,65,2710,527,1159,0.455,108,274,0.394,419,885,0.473,0.501,333,390,0.854,44,232,276,209,63,10,180,190,1495
2005,Malik Rose,PF,30,SAS,50,1,862,124,267,0.464,0,4,0,124,263,0.471,0.464,69,99,0.697,95,132,227,41,31,9,56,124,317
2005,Malik Rose,PF,30,NYK,26,4,613,74,174,0.425,1,6,0.167,73,168,0.435,0.428,68,87,0.782,34,80,114,18,15,7,46,84,217
2005,Quinton Ross,SG,23,LAC,78,19,1659,161,373,0.432,1,4,0.25,160,369,0.434,0.433,74,110,0.673,59,151,210,109,51,22,54,165,397
2005,Kareem Rush,SG,24,LAL,14,0,91,4,20,0.2,2,10,0.2,2,10,0.2,0.25,2,2,1,3,7,10,3,2,1,3,7,12
2005,Kareem Rush,SG,24,CHA,34,22,877,153,386,0.396,49,127,0.386,104,259,0.402,0.46,35,46,0.761,17,62,79,65,18,6,44,67,390
2005,John Salmons,SG,25,PHI,58,8,993,85,210,0.405,31,91,0.341,54,119,0.454,0.479,35,48,0.729,12,109,121,114,40,13,51,92,236
2005,Brian Skinner,PF,28,PHI,24,0,246,22,57,0.386,0,1,0,22,56,0.393,0.386,5,17,0.294,23,39,62,5,5,6,13,29,49
2005,Brian Skinner,C,28,SAC,25,23,695,82,148,0.554,0,0,NA,82,148,0.554,0.554,20,53,0.377,84,134,218,38,26,43,27,73,184
2005,J.R. Smith,SG,19,NOH,76,56,1859,295,748,0.394,81,281,0.288,214,467,0.458,0.449,111,161,0.689,39,113,152,142,55,11,109,135,782
2005,Jabari Smith,PF,27,NJN,45,2,648,62,148,0.419,1,2,0.5,61,146,0.418,0.422,41,55,0.745,29,82,111,38,25,14,39,103,166
2005,Joe Smith,PF,29,MIL,74,73,2265,319,621,0.514,0,1,0,319,620,0.515,0.514,175,228,0.768,179,362,541,67,43,38,79,222,813
2005,Josh Smith,SF,19,ATL,74,59,2050,274,602,0.455,4,23,0.174,270,579,0.466,0.458,163,237,0.688,147,310,457,127,59,144,135,157,715
2005,Steve Smith,SG,35,CHA,37,1,636,93,218,0.427,38,90,0.422,55,128,0.43,0.514,67,77,0.87,13,36,49,57,12,7,24,74,291
2005,Steve Smith,SG,35,MIA,13,0,114,9,30,0.3,3,15,0.2,6,15,0.4,0.35,2,3,0.667,2,14,16,14,2,0,3,8,23
2005,Eric Snow,SG,31,CLE,81,15,1844,125,327,0.382,13,45,0.289,112,282,0.397,0.402,59,80,0.738,37,118,155,317,67,16,89,189,322
2005,Kirk Snyder,SG,21,UTA,68,7,906,122,328,0.372,30,85,0.353,92,243,0.379,0.418,64,96,0.667,50,71,121,36,26,19,58,116,338
2005,Jerry Stackhouse,SG,30,DAL,56,7,1617,274,662,0.414,32,120,0.267,242,542,0.446,0.438,253,298,0.849,38,145,183,127,53,10,106,104,833
2005,DeShawn Stevenson,SG,23,ORL,55,27,1089,174,426,0.408,25,67,0.373,149,359,0.415,0.438,56,101,0.554,38,64,102,69,16,9,57,73,429
2005,Michael Stewart,PF,29,ATL,12,1,145,11,21,0.524,0,0,NA,11,21,0.524,0.524,3,7,0.429,21,19,40,5,6,5,6,32,25
2005,Peja Stojaković,SF,27,SAC,66,66,2534,451,1016,0.444,174,433,0.402,277,583,0.475,0.53,253,275,0.92,62,223,285,138,79,12,102,157,1329
2005,Damon Stoudamire,PG,31,POR,81,70,2762,457,1165,0.392,181,490,0.369,276,675,0.409,0.47,182,199,0.915,56,254,310,458,86,2,164,158,1277
2005,Amar'e Stoudemire,C,22,PHO,80,80,2889,747,1336,0.559,3,16,0.188,744,1320,0.564,0.56,583,795,0.733,219,494,713,131,77,130,189,278,2080
2005,Erick Strickland,SG,31,MIL,62,5,1014,114,304,0.375,21,83,0.253,93,221,0.421,0.41,52,64,0.813,11,92,103,115,30,1,64,103,301
2005,Rod Strickland,PG,38,HOU,16,2,196,9,43,0.209,1,2,0.5,8,41,0.195,0.221,9,10,0.9,3,24,27,39,3,2,16,15,28
2005,Bruno Šundov,C,24,NYK,21,0,73,11,37,0.297,1,3,0.333,10,34,0.294,0.311,2,2,1,6,7,13,2,2,2,6,16,25
2005,Bob Sura,PG,31,HOU,61,59,1922,215,504,0.427,55,155,0.355,160,349,0.458,0.481,141,188,0.75,79,258,337,317,65,7,147,168,626
2005,Stromile Swift,PF,25,MEM,60,14,1279,219,488,0.449,0,4,0,219,484,0.452,0.449,166,219,0.758,92,181,273,43,41,92,90,182,604
2005,Wally Szczerbiak,SF,27,MIN,81,37,2558,465,919,0.506,63,169,0.373,402,750,0.536,0.54,260,304,0.855,82,221,303,191,40,16,132,178,1253
2005,Maurice Taylor,PF,28,HOU,38,16,905,127,292,0.435,3,8,0.375,124,284,0.437,0.44,39,60,0.65,41,123,164,53,16,12,63,123,296
2005,Maurice Taylor,C,28,NYK,27,0,431,76,154,0.494,0,1,0,76,153,0.497,0.494,24,43,0.558,26,67,93,14,11,8,31,57,176
2005,Sebastian Telfair,PG,19,POR,68,26,1330,169,430,0.393,17,69,0.246,152,361,0.421,0.413,105,133,0.789,10,94,104,224,35,4,125,120,460
2005,Billy Thomas,SF,29,NJN,25,0,356,34,94,0.362,17,56,0.304,17,38,0.447,0.452,7,9,0.778,7,29,36,17,14,1,9,29,92
2005,James Thomas,PF,24,POR,9,2,112,11,18,0.611,0,0,NA,11,18,0.611,0.611,2,6,0.333,15,20,35,4,4,4,7,12,24
2005,James Thomas,PF,24,ATL,2,0,5,1,2,0.5,0,0,NA,1,2,0.5,0.5,0,0,NA,2,0,2,0,0,0,0,1,2
2005,John Thomas,C,29,MIN,44,8,521,42,86,0.488,0,0,NA,42,86,0.488,0.488,27,46,0.587,39,58,97,17,15,13,18,82,111
2005,Kenny Thomas,PF,27,PHI,47,43,1344,217,476,0.456,1,4,0.25,216,472,0.458,0.457,95,119,0.798,106,202,308,77,40,6,83,151,530
2005,Kenny Thomas,PF,27,SAC,26,15,823,150,305,0.492,0,1,0,150,304,0.493,0.492,78,108,0.722,78,149,227,75,27,11,48,76,378
2005,Kurt Thomas,PF,32,NYK,80,80,2855,424,901,0.471,2,4,0.5,422,897,0.47,0.472,66,84,0.786,170,661,831,160,70,79,99,310,916
2005,Tim Thomas,SF,27,NYK,71,68,1940,315,718,0.439,85,208,0.409,230,510,0.451,0.498,136,173,0.786,45,192,237,110,41,17,113,222,851
2005,Jake Tsakalidis,C,25,MEM,31,1,278,32,64,0.5,0,0,NA,32,64,0.5,0.5,14,18,0.778,21,35,56,10,3,16,12,42,78
2005,Nikoloz Tskitishvili,PF,21,DEN,23,0,158,15,51,0.294,0,7,0,15,44,0.341,0.294,4,7,0.571,11,18,29,4,8,8,14,24,34
2005,Nikoloz Tskitishvili,PF,21,GSW,12,0,62,7,23,0.304,2,10,0.2,5,13,0.385,0.348,0,0,NA,1,11,12,6,0,3,5,9,16
2005,Hedo Türkoğlu,SF,25,ORL,67,11,1757,328,782,0.419,93,245,0.38,235,537,0.438,0.479,188,225,0.836,62,171,233,153,41,18,119,140,937
2005,Beno Udrih,PG,22,SAS,80,2,1149,173,390,0.444,58,142,0.408,115,248,0.464,0.518,67,89,0.753,16,67,83,150,41,10,77,96,471
2005,Nick Van Exel,SG,33,POR,53,34,1619,214,561,0.381,100,257,0.389,114,304,0.375,0.471,58,74,0.784,20,141,161,227,44,0,92,70,586
2005,Keith Van Horn,SF,29,MIL,33,13,818,128,285,0.449,30,78,0.385,98,207,0.473,0.502,56,65,0.862,55,110,165,41,21,11,47,82,342
2005,Keith Van Horn,PF,29,DAL,29,3,684,129,279,0.462,24,64,0.375,105,215,0.488,0.505,72,92,0.783,34,95,129,34,15,10,34,88,354
2005,Anderson Varejão,PF,22,CLE,54,0,863,99,193,0.513,0,2,0,99,191,0.518,0.513,68,127,0.535,109,148,257,27,41,38,26,122,266
2005,Jackson Vroman,PF,23,PHO,10,1,57,6,16,0.375,0,0,NA,6,16,0.375,0.375,4,7,0.571,5,8,13,7,3,2,7,11,16
2005,Jackson Vroman,C,23,NOH,36,17,648,76,183,0.415,0,3,0,76,180,0.422,0.415,44,68,0.647,59,103,162,33,22,17,57,94,196
2005,Sasha Vujačić,SG,20,LAL,35,3,403,33,117,0.282,17,63,0.27,16,54,0.296,0.355,18,19,0.947,13,49,62,51,12,2,15,41,101
2005,Dwyane Wade,SG,23,MIA,77,77,2974,630,1318,0.478,13,45,0.289,617,1273,0.485,0.483,581,762,0.762,110,287,397,520,121,82,321,230,1854
2005,Antoine Walker,PF,28,ATL,53,53,2128,420,1013,0.415,85,268,0.317,335,745,0.45,0.457,157,294,0.534,126,371,497,194,64,32,183,147,1082
2005,Antoine Walker,PF,28,BOS,24,24,827,161,364,0.442,25,73,0.342,136,291,0.467,0.477,44,79,0.557,56,142,198,71,25,26,70,70,391
2005,Ben Wallace,C,30,DET,74,74,2671,295,651,0.453,1,9,0.111,294,642,0.458,0.454,130,304,0.428,292,610,902,123,106,176,82,159,721
2005,Gerald Wallace,SF,22,CHA,70,68,2147,286,637,0.449,17,62,0.274,269,575,0.468,0.462,191,289,0.661,118,268,386,137,117,91,159,182,780
2005,Rasheed Wallace,PF,30,DET,79,79,2687,467,1062,0.44,75,236,0.318,392,826,0.475,0.475,136,195,0.697,174,470,644,142,65,115,127,236,1145
2005,Luke Walton,SF,24,LAL,61,5,768,74,180,0.411,16,61,0.262,58,119,0.487,0.456,34,48,0.708,55,87,142,93,26,11,58,70,198
2005,Charlie Ward,PG,34,HOU,14,13,360,24,77,0.312,16,51,0.314,8,26,0.308,0.416,11,13,0.846,6,33,39,43,15,0,18,22,75
2005,Earl Watson,PG,25,MEM,80,14,1808,236,554,0.426,52,163,0.319,184,391,0.471,0.473,91,138,0.659,35,129,164,359,83,19,167,184,615
2005,Clarence Weatherspoon,PF,34,HOU,40,18,525,47,114,0.412,0,0,NA,47,114,0.412,0.412,29,35,0.829,35,87,122,17,9,6,15,74,123
2005,Chris Webber,PF,31,SAC,46,46,1668,412,917,0.449,11,29,0.379,401,888,0.452,0.455,143,179,0.799,94,353,447,252,68,34,133,144,978
2005,Chris Webber,PF,31,PHI,21,21,702,143,366,0.391,4,15,0.267,139,351,0.396,0.396,38,49,0.776,36,129,165,66,26,19,49,70,328
2005,Bonzi Wells,SG,28,MEM,69,19,1489,272,617,0.441,36,104,0.346,236,513,0.46,0.47,141,188,0.75,49,180,229,80,85,27,90,165,721
2005,Jiří Welsch,SG,25,BOS,55,32,1125,137,320,0.428,32,99,0.323,105,221,0.475,0.478,109,141,0.773,20,119,139,84,39,5,58,105,415
2005,Jiří Welsch,SF,25,CLE,16,0,192,12,51,0.235,2,11,0.182,10,40,0.25,0.255,20,28,0.714,6,22,28,19,5,0,15,16,46
2005,David Wesley,SG,34,NOH,26,26,934,133,342,0.389,28,80,0.35,105,262,0.401,0.43,67,76,0.882,12,73,85,109,35,1,54,65,361
2005,David Wesley,SG,34,HOU,54,53,1840,201,498,0.404,90,235,0.383,111,263,0.422,0.494,95,113,0.841,26,117,143,156,61,8,59,150,587
2005,Delonte West,SG,21,BOS,39,7,507,66,155,0.426,24,67,0.358,42,88,0.477,0.503,19,27,0.704,14,51,65,53,21,8,24,69,175
2005,Jahidi White,C,28,CHA,17,0,135,14,31,0.452,0,0,NA,14,31,0.452,0.452,14,40,0.35,11,23,34,1,2,12,11,31,42
2005,Rodney White,SF,24,DEN,42,2,531,98,227,0.432,19,44,0.432,79,183,0.432,0.474,21,34,0.618,20,54,74,36,30,10,27,51,236
2005,Rodney White,SF,24,GSW,16,0,146,23,62,0.371,5,16,0.313,18,46,0.391,0.411,6,10,0.6,4,11,15,8,2,1,10,13,57
2005,Chris Wilcox,C,22,LAC,54,25,1005,169,329,0.514,0,0,NA,169,329,0.514,0.514,88,144,0.611,63,165,228,38,26,24,77,129,426
2005,Mike Wilks,PG,25,SAS,48,0,278,32,77,0.416,5,16,0.313,27,61,0.443,0.448,12,16,0.75,4,21,25,33,14,1,14,26,81
2005,Aaron Williams,C,33,NJN,19,0,150,14,27,0.519,0,0,NA,14,27,0.519,0.519,9,10,0.9,7,24,31,6,4,5,11,25,37
2005,Aaron Williams,C,33,TOR,23,4,165,15,36,0.417,0,0,NA,15,36,0.417,0.417,6,7,0.857,10,19,29,2,1,3,6,45,36
2005,Eric Williams,SG,32,NJN,21,21,739,87,185,0.47,17,40,0.425,70,145,0.483,0.516,74,108,0.685,28,67,95,42,16,2,34,80,265
2005,Eric Williams,SG,32,TOR,34,18,583,55,145,0.379,11,33,0.333,44,112,0.393,0.417,38,53,0.717,16,61,77,50,22,2,26,67,159
2005,Jason Williams,PG,29,MEM,71,68,1952,266,644,0.413,107,330,0.324,159,314,0.506,0.496,80,101,0.792,19,103,122,399,75,5,130,91,719
2005,Jerome Williams,SF,31,NYK,79,4,1211,122,243,0.502,0,5,0,122,238,0.513,0.502,115,172,0.669,115,168,283,41,55,10,65,155,359
2005,Mo Williams,PG,22,MIL,80,80,2254,323,737,0.438,32,99,0.323,291,638,0.456,0.46,136,160,0.85,50,194,244,484,74,11,196,221,814
2005,Scott Williams,C,36,CLE,19,0,152,12,41,0.293,0,1,0,12,40,0.3,0.293,9,11,0.818,15,15,30,8,4,6,5,30,33
2005,Corliss Williamson,PF,31,PHI,48,5,1056,194,417,0.465,0,2,0,194,415,0.467,0.465,130,165,0.788,73,105,178,43,26,12,60,144,518
2005,Corliss Williamson,PF,31,SAC,24,4,471,79,167,0.473,0,0,NA,79,167,0.473,0.473,65,79,0.823,31,50,81,35,12,3,26,74,223
2005,Kevin Willis,C,42,ATL,29,5,344,35,90,0.389,0,2,0,35,88,0.398,0.389,17,23,0.739,29,47,76,9,8,7,15,53,87
2005,Metta World Peace,SF,25,IND,7,7,291,59,119,0.496,7,17,0.412,52,102,0.51,0.525,47,51,0.922,8,37,45,22,12,6,17,27,172
2005,Lorenzen Wright,C,29,MEM,80,77,2287,320,683,0.469,0,3,0,320,680,0.471,0.469,131,198,0.662,177,436,613,87,58,69,100,251,771
2005,Wang Zhizhi,C,27,MIA,20,0,92,17,36,0.472,2,3,0.667,15,33,0.455,0.5,7,12,0.583,6,12,18,5,3,2,5,9,43
2006,Shareef Abdur-Rahim,PF,29,SAC,72,30,1961,332,632,0.525,5,22,0.227,327,610,0.536,0.529,218,278,0.784,106,251,357,149,48,42,108,227,887
2006,Alex Acker,SG,23,DET,5,0,35,4,16,0.25,1,5,0.2,3,11,0.273,0.281,0,0,NA,1,4,5,4,1,0,4,4,9
2006,Malik Allen,PF,27,CHI,54,20,701,121,247,0.49,1,1,1,120,246,0.488,0.492,23,38,0.605,44,96,140,20,14,16,34,92,266
2006,Ray Allen,SG,30,SEA,78,78,3022,681,1500,0.454,269,653,0.412,412,847,0.486,0.544,324,359,0.903,71,261,332,286,105,16,188,151,1955
2006,Rafer Alston,PG,29,HOU,63,63,2431,280,738,0.379,102,312,0.327,178,426,0.418,0.449,99,143,0.692,36,219,255,425,101,15,157,194,761
2006,Chris Andersen,C,27,NOK,32,2,570,56,98,0.571,0,0,NA,56,98,0.571,0.571,49,103,0.476,61,94,155,6,8,41,26,84,161
2006,Derek Anderson,SG,31,HOU,20,8,582,68,173,0.393,19,67,0.284,49,106,0.462,0.448,61,73,0.836,12,71,83,53,15,4,37,49,216
2006,Derek Anderson,SG,31,MIA,23,3,465,40,130,0.308,21,67,0.313,19,63,0.302,0.388,32,38,0.842,9,51,60,48,8,2,17,49,133
2006,Shandon Anderson,SF,32,MIA,48,1,638,54,126,0.429,5,19,0.263,49,107,0.458,0.448,13,18,0.722,18,63,81,30,17,6,24,75,126
2006,Carmelo Anthony,SF,21,DEN,80,80,2941,756,1572,0.481,37,152,0.243,719,1420,0.506,0.493,573,709,0.808,122,272,394,216,88,42,218,229,2122
2006,Gilbert Arenas,PG,24,WAS,80,80,3384,746,1668,0.447,199,540,0.369,547,1128,0.485,0.507,655,799,0.82,59,221,280,484,161,25,297,286,2346
2006,Trevor Ariza,SF,20,NYK,36,10,709,61,146,0.418,1,3,0.333,60,143,0.42,0.421,42,77,0.545,49,88,137,46,43,9,46,78,165
2006,Trevor Ariza,SF,20,ORL,21,0,290,32,80,0.4,0,2,0,32,78,0.41,0.4,35,50,0.7,29,52,81,15,14,2,16,22,99
2006,Darrell Armstrong,PG,37,DAL,62,2,622,43,128,0.336,11,48,0.229,32,80,0.4,0.379,33,42,0.786,18,63,81,86,27,3,58,71,130
2006,Carlos Arroyo,PG,26,DET,50,0,600,57,157,0.363,2,6,0.333,55,151,0.364,0.369,42,58,0.724,24,46,70,155,19,3,45,77,158
2006,Carlos Arroyo,SG,26,ORL,27,0,594,111,221,0.502,5,14,0.357,106,207,0.512,0.514,64,79,0.81,9,51,60,77,19,1,38,42,291
2006,Chucky Atkins,SG,31,WAS,28,2,552,66,174,0.379,33,92,0.359,33,82,0.402,0.474,22,31,0.71,12,33,45,69,14,0,30,58,187
2006,Chucky Atkins,PG,31,MEM,43,39,1161,160,399,0.401,64,182,0.352,96,217,0.442,0.481,107,132,0.811,11,64,75,129,29,2,57,94,491
2006,Stacey Augmon,SF,37,ORL,36,3,385,25,73,0.342,0,0,NA,25,73,0.342,0.342,21,30,0.7,18,35,53,23,12,6,11,40,71
2006,Vin Baker,C,34,LAC,8,1,85,7,15,0.467,0,0,NA,7,15,0.467,0.467,13,18,0.722,2,17,19,4,4,4,9,13,27
2006,Marcus Banks,PG,24,BOS,18,1,269,33,80,0.413,6,19,0.316,27,61,0.443,0.45,27,30,0.9,4,15,19,32,7,0,23,38,99
2006,Marcus Banks,PG,24,MIN,40,28,1228,186,388,0.479,16,44,0.364,170,344,0.494,0.5,91,117,0.778,19,97,116,188,47,11,96,124,479
2006,Leandro Barbosa,SG,23,PHO,57,11,1592,273,567,0.481,87,196,0.444,186,371,0.501,0.558,111,147,0.755,31,119,150,158,48,6,89,145,744
2006,Matt Barnes,SF,25,NYK,6,5,93,11,30,0.367,1,4,0.25,10,26,0.385,0.383,3,4,0.75,7,17,24,6,4,0,6,8,26
2006,Matt Barnes,PF,25,PHI,50,0,538,59,110,0.536,2,11,0.182,57,99,0.576,0.545,29,43,0.674,41,56,97,22,16,7,24,92,149
2006,Andre Barrett,PG,23,PHO,2,0,21,3,7,0.429,0,1,0,3,6,0.5,0.429,3,3,1,1,2,3,2,0,0,1,1,9
2006,Andre Barrett,PG,23,TOR,17,0,261,35,97,0.361,2,13,0.154,33,84,0.393,0.371,6,9,0.667,8,14,22,50,10,0,14,12,78
2006,Earl Barron,C,24,MIA,8,0,45,5,16,0.313,0,0,NA,5,16,0.313,0.313,3,4,0.75,2,8,10,0,0,0,5,10,13
2006,Brent Barry,SG,34,SAS,74,5,1259,156,345,0.452,80,202,0.396,76,143,0.531,0.568,39,59,0.661,29,130,159,123,39,27,52,99,431
2006,Jon Barry,SG,36,HOU,20,0,342,25,65,0.385,12,32,0.375,13,33,0.394,0.477,24,29,0.828,1,30,31,26,13,1,22,25,86
2006,Tony Battie,C,29,ORL,82,82,2215,280,552,0.507,0,6,0,280,546,0.513,0.507,89,134,0.664,145,312,457,49,46,69,88,250,649
2006,Shane Battier,SF,27,MEM,81,81,2839,303,621,0.488,65,165,0.394,238,456,0.522,0.54,147,208,0.707,164,265,429,136,92,114,90,223,818
2006,Lonny Baxter,C,27,HOU,23,0,281,33,72,0.458,0,0,NA,33,72,0.458,0.458,16,19,0.842,38,46,84,2,9,7,13,48,82
2006,Lonny Baxter,PF,27,CHA,18,0,119,12,32,0.375,0,0,NA,12,32,0.375,0.375,12,16,0.75,7,26,33,2,2,1,7,8,36
2006,Charlie Bell,SG,26,MIL,59,6,1283,180,410,0.439,71,168,0.423,109,242,0.45,0.526,63,89,0.708,21,99,120,130,59,5,41,126,494
2006,Raja Bell,SG,29,PHO,79,79,2959,425,930,0.457,197,446,0.442,228,484,0.471,0.563,115,146,0.788,44,209,253,207,76,22,89,248,1162
2006,Mike Bibby,PG,27,SAC,82,82,3167,597,1382,0.432,192,497,0.386,405,885,0.458,0.501,342,403,0.849,29,211,240,444,82,10,199,169,1728
2006,Chauncey Billups,PG,29,DET,81,81,2925,423,1012,0.418,184,425,0.433,239,587,0.407,0.509,465,520,0.894,41,211,252,699,71,8,170,160,1495
2006,Steve Blake,PG,25,POR,68,57,1781,206,470,0.438,76,184,0.413,130,286,0.455,0.519,72,91,0.791,26,120,146,306,42,5,83,107,560
2006,Mark Blount,C,30,BOS,39,25,1083,194,380,0.511,0,0,NA,194,380,0.511,0.511,97,127,0.764,36,126,162,66,15,36,120,107,485
2006,Mark Blount,C,30,MIN,42,30,1157,179,354,0.506,0,0,NA,179,354,0.506,0.506,71,95,0.747,60,143,203,33,25,40,74,147,429
2006,Keith Bogans,SG,25,CHA,39,9,848,114,288,0.396,33,98,0.337,81,190,0.426,0.453,80,105,0.762,29,77,106,45,39,3,41,78,341
2006,Keith Bogans,SF,25,HOU,33,22,1064,101,256,0.395,32,102,0.314,69,154,0.448,0.457,47,81,0.58,26,123,149,83,32,6,49,89,281
2006,Andrew Bogut,PF,21,MIL,82,77,2348,323,606,0.533,0,3,0,323,603,0.536,0.533,122,194,0.629,189,384,573,192,49,68,125,259,768
2006,Calvin Booth,C,29,WAS,33,2,250,20,47,0.426,1,2,0.5,19,45,0.422,0.436,5,9,0.556,19,33,52,12,9,9,8,44,46
2006,Bruce Bowen,SF,34,SAS,82,82,2755,232,536,0.433,104,245,0.424,128,291,0.44,0.53,51,84,0.607,35,285,320,126,79,30,67,191,619
2006,Earl Boykins,PG,29,DEN,60,0,1542,271,661,0.41,62,179,0.346,209,482,0.434,0.457,152,174,0.874,21,60,81,230,48,4,83,73,756
2006,Michael Bradley,PF,26,PHI,46,1,367,32,79,0.405,1,5,0.2,31,74,0.419,0.411,2,3,0.667,40,67,107,17,5,7,19,39,67
2006,Primož Brezec,C,26,CHA,79,79,2165,409,791,0.517,0,2,0,409,789,0.518,0.517,164,224,0.732,181,259,440,45,19,32,85,227,982
2006,Devin Brown,SG,27,UTA,81,14,1711,207,527,0.393,39,118,0.331,168,409,0.411,0.43,158,212,0.745,73,134,207,104,44,14,99,153,611
2006,Kwame Brown,C,23,LAL,72,49,1978,204,388,0.526,0,1,0,204,387,0.527,0.526,128,235,0.545,182,291,473,72,27,46,100,196,536
2006,Rick Brunson,PG,33,SEA,4,0,31,5,8,0.625,0,1,0,5,7,0.714,0.625,0,0,NA,0,2,2,2,0,0,3,1,10
2006,Rick Brunson,PG,33,HOU,23,0,215,16,46,0.348,5,12,0.417,11,34,0.324,0.402,7,12,0.583,1,19,20,33,8,1,19,21,44
2006,Caron Butler,SF,25,WAS,75,54,2708,494,1086,0.455,41,120,0.342,453,966,0.469,0.474,289,332,0.87,114,352,466,186,127,18,175,238,1318
2006,Rasual Butler,SF,26,NOK,79,20,1875,257,633,0.406,92,242,0.38,165,391,0.422,0.479,79,114,0.693,51,181,232,40,33,45,65,142,685
2006,Andrew Bynum,C,18,LAL,46,0,338,33,82,0.402,0,0,NA,33,82,0.402,0.402,8,27,0.296,34,46,80,9,4,22,17,56,74
2006,Žarko Čabarkapa,PF,24,GSW,61,0,505,67,174,0.385,5,20,0.25,62,154,0.403,0.399,60,84,0.714,37,74,111,20,13,7,35,87,199
2006,José Calderón,SG,24,TOR,64,11,1487,132,312,0.423,7,43,0.163,125,269,0.465,0.434,78,92,0.848,30,111,141,288,42,4,101,93,349
2006,Marcus Camby,C,31,DEN,56,54,1857,302,649,0.465,1,11,0.091,301,638,0.472,0.466,111,156,0.712,132,536,668,115,79,184,92,158,716
2006,Matt Carroll,SG,25,CHA,78,6,1275,192,476,0.403,72,185,0.389,120,291,0.412,0.479,138,168,0.821,34,123,157,35,47,11,48,120,594
2006,Anthony Carter,PG,30,MIN,45,8,589,53,137,0.387,4,15,0.267,49,122,0.402,0.401,40,55,0.727,9,53,62,101,24,9,40,71,150
2006,Vince Carter,SG,29,NJN,79,79,2906,653,1518,0.43,125,367,0.341,528,1151,0.459,0.471,480,601,0.799,135,327,462,338,94,53,213,235,1911
2006,Sam Cassell,PG,36,LAC,78,75,2653,493,1112,0.443,70,190,0.368,423,922,0.459,0.475,289,335,0.863,40,247,287,491,74,11,175,225,1345
2006,Kelvin Cato,C,31,ORL,23,0,299,31,72,0.431,0,0,NA,31,72,0.431,0.431,26,35,0.743,19,44,63,2,6,10,16,48,88
2006,Kelvin Cato,C,31,DET,4,0,34,5,12,0.417,0,0,NA,5,12,0.417,0.417,0,0,NA,1,6,7,2,0,2,2,4,10
2006,Tyson Chandler,C,23,CHI,79,50,2121,160,283,0.565,0,1,0,160,282,0.567,0.565,97,193,0.503,265,449,714,81,41,104,123,298,417
2006,Doug Christie,SG,35,DAL,7,7,185,9,26,0.346,0,1,0,9,25,0.36,0.346,8,12,0.667,2,11,13,14,9,1,6,10,26
2006,Speedy Claxton,PG,27,NOK,71,3,2019,304,736,0.413,17,63,0.27,287,673,0.426,0.425,246,320,0.769,39,154,193,339,108,6,154,177,871
2006,Jarron Collins,C,27,UTA,79,41,1730,129,280,0.461,0,0,NA,129,280,0.461,0.461,157,219,0.717,134,199,333,97,36,27,61,252,415
2006,Jason Collins,C,27,NJN,71,70,1895,104,262,0.397,3,12,0.25,101,250,0.404,0.403,44,86,0.512,93,249,342,70,46,40,61,251,255
2006,Brian Cook,PF,25,LAL,81,46,1535,261,511,0.511,36,84,0.429,225,427,0.527,0.546,84,101,0.832,88,186,274,74,37,32,61,205,642
2006,Jamal Crawford,SG,25,NYK,79,27,2555,366,879,0.416,101,293,0.345,265,586,0.452,0.474,295,357,0.826,36,212,248,301,87,15,175,150,1128
2006,Austin Croshere,PF,30,IND,50,26,1148,132,285,0.463,54,140,0.386,78,145,0.538,0.558,90,102,0.882,62,203,265,62,22,7,48,105,408
2006,Antonio Daniels,SG,30,WAS,80,17,2283,230,550,0.418,23,101,0.228,207,449,0.461,0.439,284,336,0.845,19,153,172,284,52,8,89,96,767
2006,Antonio Davis,PF,37,NYK,36,31,749,68,159,0.428,0,1,0,68,158,0.43,0.428,45,61,0.738,75,97,172,14,20,9,43,99,181
2006,Antonio Davis,C,37,TOR,8,8,191,14,31,0.452,0,0,NA,14,31,0.452,0.452,7,20,0.35,15,21,36,7,3,1,8,26,35
2006,Baron Davis,PG,26,GSW,54,48,1971,335,861,0.389,102,324,0.315,233,537,0.434,0.448,195,289,0.675,45,191,236,480,89,14,159,165,967
2006,Dale Davis,C,36,DET,28,2,178,9,24,0.375,0,1,0,9,23,0.391,0.375,8,15,0.533,21,32,53,6,0,9,4,23,26
2006,Josh Davis,PF,25,MIL,4,0,12,1,4,0.25,0,1,0,1,3,0.333,0.25,0,0,NA,2,1,3,1,1,0,1,2,2
2006,Josh Davis,PF,25,HOU,1,0,0,0,0,NA,0,0,NA,0,0,NA,NA,0,0,NA,0,0,0,0,0,0,0,1,0
2006,Josh Davis,PF,25,PHO,1,0,5,1,3,0.333,0,1,0,1,2,0.5,0.333,2,3,0.667,1,0,1,0,1,0,0,0,4
2006,Ricky Davis,SG,26,BOS,42,42,1747,329,709,0.464,40,125,0.32,289,584,0.495,0.492,129,164,0.787,40,147,187,221,49,9,115,91,827
2006,Ricky Davis,SF,26,MIN,36,36,1460,255,595,0.429,33,117,0.282,222,478,0.464,0.456,146,181,0.807,25,139,164,173,42,8,98,99,689
2006,Tony Delk,SG,32,ATL,1,0,7,0,1,0,0,0,NA,0,1,0,0,2,2,1,1,1,2,0,0,0,0,0,2
2006,Tony Delk,PG,32,DET,23,0,378,71,160,0.444,20,47,0.426,51,113,0.451,0.506,18,25,0.72,13,38,51,33,13,1,19,28,180
2006,Luol Deng,SF,20,CHI,78,56,2604,442,954,0.463,21,78,0.269,421,876,0.481,0.474,207,276,0.75,127,389,516,147,72,50,105,128,1112
2006,Boris Diaw,PF,23,PHO,81,70,2874,449,853,0.526,8,30,0.267,441,823,0.536,0.531,174,238,0.731,159,399,558,503,58,85,189,260,1080
2006,Dan Dickau,PG,27,BOS,19,0,234,17,46,0.37,10,20,0.5,7,26,0.269,0.478,18,18,1,5,11,16,40,11,1,18,40,62
2006,Travis Diener,PG,23,ORL,23,0,246,29,69,0.42,25,57,0.439,4,12,0.333,0.601,5,6,0.833,4,17,21,16,7,0,10,22,88
2006,Ike Diogu,PF,22,GSW,69,14,1031,175,334,0.524,0,0,NA,175,334,0.524,0.524,136,168,0.81,95,134,229,29,15,30,78,164,486
2006,DeSagana Diop,C,24,DAL,81,45,1510,75,154,0.487,1,2,0.5,74,152,0.487,0.49,39,72,0.542,145,229,374,23,44,146,36,253,190
2006,Juan Dixon,SG,27,POR,76,42,1920,357,821,0.435,65,170,0.382,292,651,0.449,0.474,156,194,0.804,30,147,177,149,58,6,113,157,935
2006,Michael Doleac,C,28,MIA,31,3,371,37,88,0.42,0,0,NA,37,88,0.42,0.42,24,30,0.8,23,62,85,8,10,7,14,45,98
2006,Mike Dunleavy,SF,25,GSW,81,68,2578,331,816,0.406,74,260,0.285,257,556,0.462,0.451,196,252,0.778,78,321,399,237,60,32,120,199,932
2006,Ronald Dupree,SF,25,MIN,36,0,265,33,63,0.524,0,1,0,33,62,0.532,0.524,14,41,0.341,21,28,49,14,12,0,14,44,80
2006,Howard Eisley,PG,33,LAC,13,0,112,4,17,0.235,1,4,0.25,3,13,0.231,0.265,0,0,NA,1,13,14,25,3,0,3,11,9
2006,Howard Eisley,PG,33,DEN,19,0,282,30,86,0.349,12,38,0.316,18,48,0.375,0.419,20,24,0.833,2,17,19,44,8,2,18,23,92
2006,Monta Ellis,SG,20,GSW,49,3,886,132,318,0.415,28,82,0.341,104,236,0.441,0.459,42,59,0.712,22,83,105,78,32,11,58,69,334
2006,Francisco Elson,C,29,DEN,72,54,1579,151,284,0.532,1,5,0.2,150,279,0.538,0.533,49,74,0.662,99,240,339,47,54,45,65,211,352
2006,Melvin Ely,PF,27,CHA,57,22,1348,216,425,0.508,0,2,0,216,423,0.511,0.508,128,192,0.667,94,183,277,76,29,44,100,160,560
2006,Maurice Evans,SG,27,DET,80,1,1139,154,341,0.452,43,116,0.371,111,225,0.493,0.515,52,65,0.8,76,87,163,60,41,15,39,122,403
2006,Reggie Evans,PF,25,SEA,41,23,788,88,173,0.509,0,1,0,88,172,0.512,0.509,66,120,0.55,114,162,276,23,24,5,41,95,242
2006,Reggie Evans,PF,25,DEN,26,2,605,43,95,0.453,0,0,NA,43,95,0.453,0.453,49,97,0.505,57,169,226,15,16,5,44,71,135
2006,Raymond Felton,PG,21,CHA,80,54,2406,345,883,0.391,97,271,0.358,248,612,0.405,0.446,161,222,0.725,77,188,265,446,102,8,182,181,948
2006,Michael Finley,SG,32,SAS,77,18,2038,286,695,0.412,110,279,0.394,176,416,0.423,0.491,98,115,0.852,31,216,247,116,37,7,62,97,780
2006,Derek Fisher,PG,31,GSW,82,36,2589,364,887,0.41,117,295,0.397,247,592,0.417,0.476,244,293,0.833,36,175,211,352,125,8,156,237,1089
2006,Adonal Foyle,C,30,GSW,77,72,1824,152,300,0.507,0,0,NA,152,300,0.507,0.507,41,67,0.612,143,281,424,33,44,125,80,215,345
2006,Richie Frahm,SG,28,MIN,25,0,225,24,65,0.369,15,48,0.313,9,17,0.529,0.485,3,5,0.6,3,20,23,15,3,2,4,22,66
2006,Richie Frahm,SG,28,HOU,8,0,117,15,35,0.429,8,22,0.364,7,13,0.538,0.543,4,5,0.8,0,10,10,6,1,0,4,8,42
2006,Steve Francis,PG,28,ORL,46,45,1734,249,575,0.433,18,70,0.257,231,505,0.457,0.449,231,290,0.797,60,159,219,262,51,11,156,142,747
2006,Steve Francis,SG,28,NYK,24,15,659,84,190,0.442,7,13,0.538,77,177,0.435,0.461,83,109,0.761,14,57,71,83,23,6,58,62,258
2006,Channing Frye,C,22,NYK,65,14,1572,305,640,0.477,3,9,0.333,302,631,0.479,0.479,189,229,0.825,138,236,374,53,30,47,97,200,802
2006,Dan Gadzuric,C,27,MIL,74,0,885,171,309,0.553,0,1,0,171,308,0.555,0.553,41,89,0.461,91,141,232,24,25,43,35,171,383
2006,Reece Gaines,PG,25,MIL,12,0,54,6,12,0.5,0,2,0,6,10,0.6,0.5,1,4,0.25,0,0,0,3,1,0,1,1,13
2006,Francisco García,SF,24,SAC,67,11,1301,130,325,0.4,39,137,0.285,91,188,0.484,0.46,78,101,0.772,39,146,185,94,41,47,75,135,377
2006,Kevin Garnett,PF,29,MIN,76,76,2957,626,1191,0.526,8,30,0.267,618,1161,0.532,0.529,396,489,0.81,214,752,966,308,104,107,180,206,1656
2006,Pau Gasol,PF,25,MEM,80,80,3135,600,1194,0.503,3,12,0.25,597,1182,0.505,0.504,425,617,0.689,191,522,713,371,46,153,235,184,1628
2006,Eddie Gill,PG,27,IND,41,0,122,10,45,0.222,7,23,0.304,3,22,0.136,0.3,18,23,0.783,0,15,15,12,11,1,9,13,45
2006,Gordan Giriček,SG,28,UTA,37,36,956,166,383,0.433,18,59,0.305,148,324,0.457,0.457,43,57,0.754,15,55,70,63,16,4,63,87,393
2006,Anthony Goldwire,PG,34,LAC,3,0,22,1,7,0.143,0,2,0,1,5,0.2,0.143,0,0,NA,0,1,1,2,0,0,1,0,2
2006,Drew Gooden,PF,24,CLE,79,79,2174,334,652,0.512,1,3,0.333,333,649,0.513,0.513,176,258,0.682,237,428,665,56,52,49,106,190,845
2006,Stephen Graham,SG,23,HOU,6,0,38,6,16,0.375,1,5,0.2,5,11,0.455,0.406,4,4,1,1,6,7,3,2,0,5,5,17
2006,Stephen Graham,SG,23,CHI,3,0,20,1,5,0.2,1,4,0.25,0,1,0,0.3,2,2,1,0,3,3,1,0,0,1,3,5
2006,Stephen Graham,SG,23,CLE,13,0,117,14,33,0.424,0,1,0,14,32,0.438,0.424,8,9,0.889,4,13,17,3,3,2,7,23,36
2006,Danny Granger,SF,22,IND,78,17,1765,221,478,0.462,30,93,0.323,191,385,0.496,0.494,115,148,0.777,131,253,384,90,58,62,80,211,587
2006,Gerald Green,SG,20,BOS,32,3,374,66,138,0.478,6,20,0.3,60,118,0.508,0.5,29,37,0.784,10,31,41,18,13,4,22,41,167
2006,Adrian Griffin,SG,31,DAL,52,45,1245,98,204,0.48,0,2,0,98,202,0.485,0.48,41,53,0.774,75,152,227,89,51,9,39,113,237
2006,Zendon Hamilton,C,30,CLE,11,0,46,7,13,0.538,0,0,NA,7,13,0.538,0.538,11,16,0.688,3,8,11,0,3,0,6,4,25
2006,Zendon Hamilton,C,30,PHI,1,0,3,0,1,0,0,0,NA,0,1,0,0,1,2,0.5,0,0,0,0,1,0,0,1,1
2006,Anfernee Hardaway,SF,34,NYK,4,0,72,4,14,0.286,0,1,0,4,13,0.308,0.286,2,2,1,0,10,10,8,2,0,6,7,10
2006,Al Harrington,PF,25,ATL,76,76,2782,551,1220,0.452,66,191,0.346,485,1029,0.471,0.479,243,350,0.694,132,391,523,238,85,14,195,301,1411
2006,Othella Harrington,C,32,CHI,72,23,824,135,273,0.495,0,0,NA,135,273,0.495,0.495,77,123,0.626,54,100,154,39,7,13,61,131,347
2006,Devin Harris,PG,22,DAL,56,4,1275,190,405,0.469,5,21,0.238,185,384,0.482,0.475,169,236,0.716,26,99,125,177,53,16,84,121,554
2006,Jason Hart,PG,27,SAC,66,0,818,86,221,0.389,9,31,0.29,77,190,0.405,0.41,37,56,0.661,12,59,71,70,31,5,43,85,218
2006,Trenton Hassell,SG,26,MIN,77,67,2514,286,616,0.464,7,23,0.304,279,593,0.47,0.47,131,176,0.744,82,134,216,203,43,29,124,201,710
2006,Chuck Hayes,PF,22,HOU,40,0,535,59,105,0.562,0,1,0,59,104,0.567,0.562,29,45,0.644,67,112,179,14,26,14,12,76,147
2006,Brendan Haywood,C,26,WAS,79,70,1879,222,432,0.514,0,0,NA,222,432,0.514,0.514,131,224,0.585,200,267,467,46,30,104,97,232,575
2006,Luther Head,SG,23,HOU,80,27,2310,254,630,0.403,113,313,0.361,141,317,0.445,0.493,86,123,0.699,33,233,266,215,89,9,119,169,707
2006,Nenê,PF,23,DEN,1,0,3,0,1,0,0,0,NA,0,1,0,0,0,0,NA,0,0,0,0,0,0,2,1,0
2006,Kirk Hinrich,PG,25,CHI,81,81,2955,451,1078,0.418,126,341,0.37,325,737,0.441,0.477,256,314,0.815,29,259,288,514,94,21,188,251,1284
2006,Julius Hodge,SG,22,DEN,14,0,33,5,13,0.385,0,0,NA,5,13,0.385,0.385,3,8,0.375,5,2,7,6,2,0,8,7,13
2006,Robert Horry,PF,35,SAS,63,3,1182,112,292,0.384,53,144,0.368,59,148,0.399,0.474,44,68,0.647,71,171,242,79,43,51,41,115,321
2006,Eddie House,PG,27,PHO,81,0,1421,320,759,0.422,123,316,0.389,197,443,0.445,0.503,33,41,0.805,15,117,132,148,42,12,76,96,796
2006,Josh Howard,SF,25,DAL,59,58,1915,350,743,0.471,27,63,0.429,323,680,0.475,0.489,196,267,0.734,123,248,371,111,68,26,79,167,923
2006,Juwan Howard,PF,32,HOU,80,80,2537,394,859,0.459,0,4,0,394,855,0.461,0.459,154,191,0.806,168,367,535,112,49,8,133,235,942
2006,Larry Hughes,SG,27,CLE,36,31,1281,192,469,0.409,28,76,0.368,164,393,0.417,0.439,146,193,0.756,26,135,161,131,53,21,99,117,558
2006,Kris Humphries,PF,20,UTA,62,2,619,77,203,0.379,0,5,0,77,198,0.389,0.379,34,65,0.523,56,101,157,30,23,16,31,82,188
2006,D.J. Mbenga,C,25,DAL,43,1,237,32,60,0.533,0,1,0,32,59,0.542,0.533,10,20,0.5,19,37,56,2,6,25,16,47,74
2006,Allen Iverson,PG,30,PHI,72,72,3103,815,1822,0.447,72,223,0.323,743,1599,0.465,0.467,675,829,0.814,44,188,232,532,140,10,248,121,2377
2006,Royal Ivey,PG,24,ATL,73,66,978,116,264,0.439,4,10,0.4,112,254,0.441,0.447,24,33,0.727,31,65,96,74,24,7,23,147,260
2006,Jarrett Jack,SG,22,POR,79,4,1599,189,428,0.442,20,76,0.263,169,352,0.48,0.465,128,160,0.8,18,142,160,219,41,2,102,138,526
2006,Bobby Jackson,PG,32,MEM,71,15,1775,286,748,0.382,129,332,0.389,157,416,0.377,0.469,107,146,0.733,44,179,223,195,61,1,101,155,808
2006,Jermaine Jackson,PG,29,MIL,30,2,202,11,26,0.423,1,4,0.25,10,22,0.455,0.442,12,14,0.857,8,19,27,25,4,1,13,19,35
2006,Jim Jackson,SF,35,PHO,27,1,420,38,129,0.295,14,63,0.222,24,66,0.364,0.349,9,13,0.692,11,53,64,31,10,6,30,46,99
2006,Jim Jackson,SF,35,LAL,13,0,92,9,31,0.29,4,11,0.364,5,20,0.25,0.355,0,0,NA,0,12,12,4,2,0,5,5,22
2006,Luke Jackson,SF,24,CLE,36,0,315,29,85,0.341,12,36,0.333,17,49,0.347,0.412,26,33,0.788,16,24,40,25,11,2,31,30,96
2006,Marc Jackson,C,31,NJN,37,0,433,66,148,0.446,0,0,NA,66,148,0.446,0.446,38,48,0.792,30,59,89,22,5,6,28,70,170
2006,Marc Jackson,C,31,NOK,27,10,594,108,221,0.489,1,2,0.5,107,219,0.489,0.491,28,34,0.824,56,72,128,22,8,2,37,56,245
2006,Stephen Jackson,SG,27,IND,81,81,2910,472,1148,0.411,117,339,0.345,355,809,0.439,0.462,268,341,0.786,48,264,312,225,104,43,203,195,1329
2006,Mike James,PG,30,TOR,79,79,2925,576,1228,0.469,169,382,0.442,407,846,0.481,0.538,283,338,0.837,45,217,262,460,72,3,206,214,1604
2006,Antawn Jamison,SF,29,WAS,82,80,3288,660,1494,0.442,147,373,0.394,513,1121,0.458,0.491,217,297,0.731,167,598,765,158,90,12,137,189,1684
2006,Šarūnas Jasikevičius,PG,29,IND,75,15,1557,170,429,0.396,86,236,0.364,84,193,0.435,0.497,121,133,0.91,19,134,153,227,40,4,116,108,547
2006,Richard Jefferson,SF,25,NJN,78,78,3059,495,1005,0.493,60,188,0.319,435,817,0.532,0.522,471,580,0.812,95,439,534,297,59,17,174,193,1521
2006,Jared Jeffries,PF,24,WAS,77,77,1951,187,415,0.451,16,50,0.32,171,365,0.468,0.47,99,168,0.589,164,215,379,148,58,50,99,223,489
2006,Anthony Johnson,PG,31,IND,75,53,1981,267,603,0.443,51,155,0.329,216,448,0.482,0.485,106,141,0.752,31,137,168,324,63,22,115,132,691
2006,Joe Johnson,SG,24,ATL,82,82,3340,632,1395,0.453,128,360,0.356,504,1035,0.487,0.499,261,330,0.791,98,237,335,536,103,31,267,187,1653
2006,Linton Johnson,SF,25,NJN,9,0,35,5,10,0.5,0,0,NA,5,10,0.5,0.5,1,4,0.25,0,7,7,2,2,0,4,7,11
2006,Linton Johnson,SF,25,NOK,27,7,489,56,139,0.403,13,36,0.361,43,103,0.417,0.45,17,23,0.739,40,75,115,12,10,12,24,54,142
2006,Dahntay Jones,SF,25,MEM,71,4,967,109,263,0.414,3,21,0.143,106,242,0.438,0.42,60,93,0.645,20,84,104,39,38,15,50,108,281
2006,Damon Jones,PG,29,CLE,82,7,2089,190,491,0.387,140,371,0.377,50,120,0.417,0.53,32,50,0.64,14,119,133,169,37,1,55,112,552
2006,Eddie Jones,SG,34,MEM,75,75,2437,292,722,0.404,133,374,0.356,159,348,0.457,0.497,168,215,0.781,35,244,279,177,131,27,93,201,885
2006,Fred Jones,SG,26,IND,68,2,1837,233,559,0.417,63,187,0.337,170,372,0.457,0.473,122,160,0.763,18,152,170,154,55,20,107,142,651
2006,Jason Kidd,PG,32,NJN,80,80,2975,366,905,0.404,139,395,0.352,227,510,0.445,0.481,194,244,0.795,86,494,580,672,150,29,192,157,1065
2006,Brevin Knight,PG,30,CHA,69,67,2351,308,772,0.399,3,13,0.231,305,759,0.402,0.401,252,314,0.803,35,188,223,610,157,4,164,202,871
2006,Kyle Korver,SF,24,PHI,82,43,2563,327,761,0.43,184,438,0.42,143,323,0.443,0.551,101,119,0.849,27,243,270,163,65,26,98,224,939
2006,Nenad Krstić,PF,22,NJN,80,80,2469,447,881,0.507,1,4,0.25,446,877,0.509,0.508,185,265,0.698,182,331,513,88,32,63,133,297,1080
2006,Toni Kukoč,PF,37,MIL,65,0,1018,116,298,0.389,45,147,0.306,71,151,0.47,0.465,40,56,0.714,26,124,150,139,33,17,66,87,317
2006,Raef LaFrentz,PF,29,BOS,82,63,2033,238,552,0.431,112,286,0.392,126,266,0.474,0.533,51,75,0.68,80,326,406,115,29,72,65,273,639
2006,Maciej Lampe,C,20,NOK,2,0,16,0,4,0,0,0,NA,0,4,0,0,0,0,NA,1,3,4,2,0,0,1,2,0
2006,Maciej Lampe,C,20,HOU,4,0,12,2,7,0.286,0,0,NA,2,7,0.286,0.286,0,2,0,3,2,5,0,0,0,2,0,4
2006,David Lee,SF,22,NYK,67,14,1129,137,230,0.596,0,0,NA,137,230,0.596,0.596,71,123,0.577,109,194,303,43,30,20,51,124,345
2006,Voshon Lenard,SG,32,DEN,12,6,238,42,103,0.408,10,35,0.286,32,68,0.471,0.456,5,13,0.385,2,26,28,18,8,2,11,21,99
2006,Voshon Lenard,SG,32,POR,14,0,220,33,88,0.375,15,43,0.349,18,45,0.4,0.46,11,18,0.611,3,16,19,23,13,2,20,18,92
2006,Rashard Lewis,SF,26,SEA,78,77,2876,538,1151,0.467,142,370,0.384,396,781,0.507,0.529,350,428,0.818,111,279,390,182,102,50,141,191,1568
2006,Shaun Livingston,PG,20,LAC,61,14,1525,149,349,0.427,1,8,0.125,148,341,0.434,0.428,53,77,0.688,41,142,183,273,46,32,111,160,352
2006,Tyronn Lue,PG,28,ATL,51,10,1234,192,418,0.459,58,127,0.457,134,291,0.46,0.529,118,138,0.855,13,69,82,157,26,3,75,113,560
2006,Jamaal Magloire,C,27,MIL,82,82,2465,287,615,0.467,0,0,NA,287,615,0.467,0.467,178,333,0.535,220,558,778,56,29,80,166,276,752
2006,Stephon Marbury,PG,28,NYK,60,60,2193,349,774,0.451,33,104,0.317,316,670,0.472,0.472,246,326,0.755,25,150,175,382,63,4,157,143,977
2006,Shawn Marion,PF,27,PHO,81,81,3263,716,1365,0.525,96,290,0.331,620,1075,0.577,0.56,241,298,0.809,249,710,959,143,160,137,125,223,1769
2006,Donyell Marshall,PF,32,CLE,81,0,2077,265,671,0.395,128,395,0.324,137,276,0.496,0.49,92,123,0.748,105,387,492,60,59,41,90,160,750
2006,Darrick Martin,PG,34,TOR,40,0,339,34,97,0.351,16,40,0.4,18,57,0.316,0.433,18,24,0.75,2,18,20,57,17,0,15,42,102
2006,Kevin Martin,SG,22,SAC,72,41,1913,262,546,0.48,66,179,0.369,196,367,0.534,0.54,188,222,0.847,58,203,261,97,55,9,81,138,778
2006,Desmond Mason,SF,28,NOK,70,55,2102,275,690,0.399,1,6,0.167,274,684,0.401,0.399,206,302,0.682,64,234,298,66,42,17,113,136,757
2006,Rashad McCants,SG,21,MIN,79,12,1362,241,535,0.45,67,180,0.372,174,355,0.49,0.513,78,106,0.736,29,114,143,63,44,22,86,176,627
2006,Walter McCarty,SF,31,LAC,36,1,353,33,99,0.333,10,45,0.222,23,54,0.426,0.384,12,21,0.571,15,53,68,23,8,5,19,52,88
2006,Antonio McDyess,PF,31,DET,82,0,1733,285,560,0.509,0,2,0,285,558,0.511,0.509,68,122,0.557,156,280,436,90,46,48,76,220,638
2006,Tracy McGrady,SF,26,HOU,47,47,1745,410,1011,0.406,73,234,0.312,337,777,0.434,0.442,254,340,0.747,46,261,307,225,59,41,120,88,1147
2006,Jeff McInnis,SG,31,NJN,28,1,486,63,143,0.441,3,16,0.188,60,127,0.472,0.451,20,29,0.69,11,39,50,52,11,2,29,37,149
2006,Aaron McKie,PG,33,LAL,14,0,121,3,12,0.25,0,2,0,3,10,0.3,0.25,1,2,0.5,3,17,20,11,5,0,2,7,7
2006,Keith McLeod,PG,26,UTA,66,32,1232,120,340,0.353,24,82,0.293,96,258,0.372,0.388,106,133,0.797,11,67,78,151,42,9,76,131,370
2006,Chris Mihm,C,26,LAL,59,56,1541,230,459,0.501,0,0,NA,230,459,0.501,0.501,144,201,0.716,137,236,373,61,16,73,83,214,604
2006,C.J. Miles,PG,18,UTA,23,0,203,28,76,0.368,5,20,0.25,23,56,0.411,0.401,18,24,0.75,18,20,38,16,7,2,9,20,79
2006,Darius Miles,SF,24,POR,40,23,1286,235,510,0.461,2,10,0.2,233,500,0.466,0.463,87,163,0.534,24,158,182,73,42,39,99,100,559
2006,Darko Miličić,C,20,DET,25,0,140,17,33,0.515,0,2,0,17,31,0.548,0.515,3,8,0.375,10,18,28,9,3,15,15,25,37
2006,Darko Miličić,C,20,ORL,30,1,627,102,201,0.507,0,0,NA,102,201,0.507,0.507,25,42,0.595,34,89,123,32,11,62,36,67,229
2006,Andre Miller,PG,29,DEN,82,82,2937,404,872,0.463,5,27,0.185,399,845,0.472,0.466,313,424,0.738,92,259,351,674,106,18,256,213,1126
2006,Brad Miller,C,29,SAC,79,79,2923,434,877,0.495,34,88,0.386,400,789,0.507,0.514,280,338,0.828,122,493,615,374,61,62,180,234,1182
2006,Mike Miller,SG,25,MEM,74,9,2268,354,760,0.466,138,339,0.407,216,421,0.513,0.557,168,210,0.8,42,355,397,200,52,27,140,173,1014
2006,Cuttino Mobley,SG,30,LAC,79,74,2979,429,1008,0.426,83,245,0.339,346,763,0.453,0.467,229,273,0.839,50,291,341,238,93,36,145,208,1170
2006,Nazr Mohammed,C,28,SAS,80,30,1389,190,377,0.504,0,0,NA,190,377,0.504,0.504,113,144,0.785,163,255,418,40,21,49,91,220,493
2006,Sergei Monia,SF,22,POR,23,15,336,29,85,0.341,9,33,0.273,20,52,0.385,0.394,8,12,0.667,11,40,51,19,6,5,12,41,75
2006,Sergei Monia,SF,22,SAC,3,0,7,0,2,0,0,1,0,0,1,0,0,2,2,1,0,1,1,0,1,0,0,0,2
2006,Mikki Moore,C,30,SEA,47,1,583,54,124,0.435,0,2,0,54,122,0.443,0.435,46,62,0.742,44,86,130,27,7,15,40,92,154
2006,Alonzo Mourning,C,35,MIA,65,20,1302,188,315,0.597,0,1,0,188,314,0.599,0.597,133,224,0.594,125,234,359,11,13,173,79,177,509
2006,Troy Murphy,PF,25,GSW,74,74,2516,363,838,0.433,58,181,0.32,305,657,0.464,0.468,251,319,0.787,195,548,743,101,47,26,108,191,1035
2006,Ronald Murray,SG,26,SEA,48,2,1085,179,451,0.397,17,76,0.224,162,375,0.432,0.416,99,138,0.717,18,68,86,120,30,4,79,69,474
2006,Ronald Murray,SG,26,CLE,28,25,1027,142,317,0.448,20,65,0.308,122,252,0.484,0.479,73,104,0.702,15,52,67,77,38,7,56,64,377
2006,Dikembe Mutombo,C,39,HOU,64,23,955,50,95,0.526,0,0,NA,50,95,0.526,0.526,69,91,0.758,100,206,306,4,17,57,35,128,169
2006,Boštjan Nachbar,PF,25,NOK,25,13,405,42,124,0.339,17,57,0.298,25,67,0.373,0.407,25,36,0.694,4,45,49,22,13,5,20,52,126
2006,Boštjan Nachbar,SF,25,NJN,11,0,97,12,32,0.375,2,14,0.143,10,18,0.556,0.406,5,8,0.625,4,7,11,5,3,0,4,13,31
2006,Lee Nailon,PF,30,PHI,22,0,237,40,80,0.5,0,0,NA,40,80,0.5,0.5,13,15,0.867,23,19,42,7,8,4,10,32,93
2006,Eduardo Nájera,PF,29,DEN,64,3,1449,127,301,0.422,4,12,0.333,123,289,0.426,0.429,89,114,0.781,128,197,325,52,53,34,54,165,347
2006,Jameer Nelson,PG,23,ORL,62,33,1784,347,719,0.483,70,165,0.424,277,554,0.5,0.531,141,181,0.779,39,141,180,302,70,9,148,174,905
2006,Ira Newble,SG,31,CLE,36,3,353,17,57,0.298,3,13,0.231,14,44,0.318,0.325,11,16,0.688,21,35,56,9,5,10,12,47,48
2006,Andrés Nocioni,PF,26,CHI,82,43,2239,383,831,0.461,93,238,0.391,290,593,0.489,0.517,204,242,0.843,89,411,500,117,40,52,120,252,1063
2006,Moochie Norris,PG,32,HOU,29,0,241,26,65,0.4,0,5,0,26,60,0.433,0.4,13,17,0.765,9,25,34,29,14,1,16,31,65
2006,Moochie Norris,PG,32,NOK,16,0,183,20,47,0.426,4,9,0.444,16,38,0.421,0.468,16,25,0.64,3,17,20,21,6,0,17,18,60
2006,Jermaine O'Neal,PF,27,IND,51,47,1802,380,805,0.472,3,10,0.3,377,795,0.474,0.474,261,368,0.709,102,374,476,133,27,117,151,177,1024
2006,Shaquille O'Neal,C,33,MIA,59,58,1806,480,800,0.6,0,0,NA,480,800,0.6,0.6,221,471,0.469,172,369,541,113,23,104,168,230,1181
2006,Kevin Ollie,SG,33,PHI,70,23,1069,75,174,0.431,1,3,0.333,74,171,0.433,0.434,41,49,0.837,13,85,98,101,33,3,29,103,192
2006,Michael Olowokandi,C,30,MIN,32,24,752,87,195,0.446,0,0,NA,87,195,0.446,0.446,19,39,0.487,45,134,179,17,19,27,41,100,193
2006,Michael Olowokandi,C,30,BOS,16,0,167,20,45,0.444,0,0,NA,20,45,0.444,0.444,5,8,0.625,5,36,41,6,3,6,14,22,45
2006,Bo Outlaw,PF,34,ORL,32,0,355,35,58,0.603,0,0,NA,35,58,0.603,0.603,5,8,0.625,31,46,77,14,10,12,17,50,75
2006,Travis Outlaw,PF,21,POR,69,11,1153,162,368,0.44,14,53,0.264,148,315,0.47,0.459,62,89,0.697,48,141,189,34,31,46,37,112,400
2006,Scott Padgett,PF,29,NJN,62,1,718,71,201,0.353,42,121,0.347,29,80,0.363,0.458,27,34,0.794,56,109,165,41,28,12,21,90,211
2006,Milt Palacio,PG,27,UTA,71,18,1376,171,403,0.424,1,16,0.063,170,387,0.439,0.426,98,150,0.653,17,117,134,190,47,14,110,125,441
2006,Jannero Pargo,PG,26,CHI,57,0,646,109,292,0.373,39,103,0.379,70,189,0.37,0.44,17,21,0.81,8,53,61,94,24,2,61,57,274
2006,Smush Parker,PG,24,LAL,82,82,2773,348,779,0.447,120,328,0.366,228,451,0.506,0.524,125,180,0.694,37,234,271,302,140,16,147,213,941
2006,Ruben Patterson,SF,30,POR,45,2,1056,188,379,0.496,0,7,0,188,372,0.505,0.496,138,226,0.611,73,81,154,60,42,12,82,79,514
2006,Ruben Patterson,SG,30,DEN,26,20,736,139,256,0.543,1,6,0.167,138,250,0.552,0.545,65,112,0.58,45,45,90,67,34,9,68,71,344
2006,Sasha Pavlović,SG,22,CLE,53,19,813,87,212,0.41,35,96,0.365,52,116,0.448,0.493,32,49,0.653,16,64,80,25,19,6,42,103,241
2006,Gary Payton,PG,37,MIA,81,25,2305,230,547,0.42,66,230,0.287,164,317,0.517,0.481,100,126,0.794,34,199,233,257,71,10,102,169,626
2006,Kendrick Perkins,C,21,BOS,68,40,1332,137,266,0.515,0,2,0,137,264,0.519,0.515,80,130,0.615,140,264,404,69,21,105,107,199,354
2006,Johan Petro,C,20,SEA,68,41,1282,153,300,0.51,0,0,NA,153,300,0.51,0.51,47,75,0.627,109,187,296,15,25,51,60,213,353
2006,Mickaël Piétrus,SF,23,GSW,52,18,1179,169,418,0.404,56,176,0.318,113,242,0.467,0.471,87,143,0.608,58,105,163,44,33,10,78,132,481
2006,James Posey,SF,29,MIA,67,63,1914,159,395,0.403,117,290,0.403,42,105,0.4,0.551,48,61,0.787,33,286,319,89,54,20,58,196,483
2006,Vitaly Potapenko,C,30,SEA,24,12,321,32,64,0.5,0,0,NA,32,64,0.5,0.5,10,17,0.588,26,36,62,7,2,2,14,44,74
2006,Vitaly Potapenko,C,30,SAC,9,0,32,5,7,0.714,0,0,NA,5,7,0.714,0.714,0,0,NA,1,1,2,2,0,0,2,6,10
2006,Josh Powell,PF,23,DAL,37,2,429,37,81,0.457,0,0,NA,37,81,0.457,0.457,36,45,0.8,28,53,81,9,7,4,22,52,110
2006,Tayshaun Prince,SF,25,DET,82,82,2898,455,999,0.455,64,183,0.35,391,816,0.479,0.487,182,238,0.765,104,242,346,186,62,39,91,96,1156
2006,Joel Przybilla,C,26,POR,56,52,1395,131,239,0.548,0,0,NA,131,239,0.548,0.548,82,154,0.532,146,245,391,43,20,130,76,149,344
2006,Vladimir Radmanović,PF,25,SEA,47,16,1089,154,384,0.401,72,196,0.367,82,188,0.436,0.495,55,62,0.887,39,148,187,72,32,15,53,130,435
2006,Vladimir Radmanović,PF,25,LAC,30,11,885,108,259,0.417,66,158,0.418,42,101,0.416,0.544,38,52,0.731,25,146,171,64,29,14,40,80,320
2006,Shavlik Randolph,PF,22,PHI,57,1,487,44,97,0.454,0,0,NA,44,97,0.454,0.454,43,71,0.606,55,78,133,19,19,12,21,83,131
2006,Zach Randolph,PF,24,POR,74,71,2545,536,1229,0.436,16,55,0.291,520,1174,0.443,0.443,245,343,0.714,193,399,592,144,57,14,165,185,1333
2006,Theo Ratliff,C,32,POR,55,19,1301,108,189,0.571,0,0,NA,108,189,0.571,0.571,54,83,0.651,89,190,279,28,18,88,47,143,270
2006,Željko Rebrača,C,33,LAC,29,2,412,52,96,0.542,0,0,NA,52,96,0.542,0.542,31,41,0.756,13,51,64,9,5,19,24,59,135
2006,Justin Reed,SF,24,BOS,32,0,291,25,74,0.338,0,0,NA,25,74,0.338,0.338,25,40,0.625,13,16,29,7,5,4,15,45,75
2006,Justin Reed,SF,24,MIN,40,6,706,94,221,0.425,0,1,0,94,220,0.427,0.425,62,80,0.775,40,55,95,34,18,11,37,118,250
2006,Jason Richardson,SG,25,GSW,75,75,2877,641,1438,0.446,183,477,0.384,458,961,0.477,0.509,276,410,0.673,105,333,438,232,97,37,167,206,1741
2006,Luke Ridnour,PG,24,SEA,79,77,2625,334,799,0.418,43,149,0.289,291,650,0.448,0.445,199,227,0.877,47,188,235,550,123,22,162,178,910
2006,Anthony Roberson,PG,22,MEM,16,0,88,14,31,0.452,5,10,0.5,9,21,0.429,0.532,2,2,1,0,6,6,5,1,0,3,6,35
2006,Bernard Robinson,SF,25,CHA,66,18,1303,157,365,0.43,2,21,0.095,155,344,0.451,0.433,106,134,0.791,62,157,219,77,81,10,74,141,422
2006,Clifford Robinson,PF,39,NJN,80,13,1863,219,513,0.427,60,175,0.343,159,338,0.47,0.485,52,79,0.658,55,212,267,89,44,40,62,206,550
2006,Nate Robinson,PG,21,NYK,72,26,1544,230,565,0.407,58,146,0.397,172,419,0.411,0.458,152,202,0.752,56,111,167,147,59,1,114,201,670
2006,Jalen Rose,SF,33,TOR,46,22,1236,180,446,0.404,31,115,0.27,149,331,0.45,0.438,166,217,0.765,15,114,129,113,20,10,65,101,557
2006,Jalen Rose,SG,33,NYK,26,23,747,110,239,0.46,28,57,0.491,82,182,0.451,0.519,82,101,0.812,13,69,82,68,10,3,50,55,330
2006,Malik Rose,PF,31,NYK,72,35,1119,105,281,0.374,1,1,1,104,280,0.371,0.375,107,137,0.781,84,175,259,67,43,14,80,145,318
2006,Quinton Ross,SF,24,LAC,67,45,1515,130,308,0.422,0,7,0,130,301,0.432,0.422,57,75,0.76,38,132,170,79,51,16,47,155,317
2006,Kareem Rush,SG,25,CHA,47,25,1111,181,469,0.386,57,164,0.348,124,305,0.407,0.447,55,77,0.714,18,85,103,50,38,13,65,79,474
2006,John Salmons,SG,26,PHI,82,24,2059,219,521,0.42,26,87,0.299,193,434,0.445,0.445,155,200,0.775,48,172,220,223,73,13,125,178,619
2006,James Singleton,SF,24,LAC,59,10,753,77,151,0.51,10,20,0.5,67,131,0.511,0.543,39,50,0.78,63,134,197,29,19,21,28,95,203
2006,Brian Skinner,PF,29,SAC,38,0,429,38,69,0.551,0,0,NA,38,69,0.551,0.551,12,27,0.444,30,71,101,17,11,20,18,54,88
2006,Brian Skinner,C,29,POR,27,5,515,44,91,0.484,0,0,NA,44,91,0.484,0.484,15,29,0.517,46,81,127,13,14,23,27,65,103
2006,Charles Smith,SG,30,POR,21,4,208,30,71,0.423,15,37,0.405,15,34,0.441,0.528,5,8,0.625,3,13,16,9,5,6,4,27,80
2006,Charles Smith,SG,30,DEN,1,0,2,0,1,0,0,1,0,0,0,NA,0,0,0,NA,0,0,0,0,0,0,0,1,0
2006,J.R. Smith,SG,20,NOK,55,25,989,144,366,0.393,52,140,0.371,92,226,0.407,0.464,83,101,0.822,19,91,110,58,37,4,54,90,423
2006,Joe Smith,PF,30,MIL,44,5,887,145,305,0.475,0,2,0,145,303,0.479,0.475,89,115,0.774,83,147,230,31,24,13,40,120,379
2006,Josh Smith,SF,20,ATL,80,73,2559,329,774,0.425,34,110,0.309,295,664,0.444,0.447,210,292,0.719,176,355,531,191,64,208,162,260,902
2006,Eric Snow,PG,32,CLE,82,82,2351,163,399,0.409,1,10,0.1,162,389,0.416,0.41,64,93,0.688,38,160,198,346,76,19,116,218,391
2006,Kirk Snyder,SG,22,NOK,68,45,1310,205,453,0.453,46,129,0.357,159,324,0.491,0.503,86,117,0.735,55,106,161,102,29,23,70,106,542
2006,Jerry Stackhouse,SG,31,DAL,55,11,1525,242,603,0.401,36,130,0.277,206,473,0.436,0.431,195,221,0.882,32,121,153,160,37,10,121,96,715
2006,DeShawn Stevenson,SG,24,ORL,82,82,2648,359,781,0.46,2,15,0.133,357,766,0.466,0.461,180,242,0.744,59,182,241,160,58,17,123,178,900
2006,Peja Stojaković,SF,28,SAC,31,31,1147,171,424,0.403,71,179,0.397,100,245,0.408,0.487,98,105,0.933,34,131,165,68,19,2,51,82,511
2006,Peja Stojaković,SF,28,IND,40,40,1454,274,594,0.461,91,225,0.404,183,369,0.496,0.538,140,155,0.903,45,205,250,68,26,8,52,89,779
2006,Damon Stoudamire,PG,32,MEM,27,27,862,114,287,0.397,36,104,0.346,78,183,0.426,0.46,53,62,0.855,23,72,95,128,19,1,55,49,317
2006,Amar'e Stoudemire,C,23,PHO,3,3,50,9,27,0.333,0,1,0,9,26,0.346,0.333,8,9,0.889,6,10,16,2,1,3,1,4,26
2006,Stromile Swift,C,26,HOU,66,5,1344,225,458,0.491,0,2,0,225,456,0.493,0.491,136,209,0.651,103,188,291,25,38,50,91,198,586
2006,Wally Szczerbiak,SF,28,MIN,40,40,1555,292,590,0.495,58,143,0.406,234,447,0.523,0.544,163,182,0.896,36,154,190,112,21,15,86,90,805
2006,Wally Szczerbiak,SF,28,BOS,32,31,1174,201,422,0.476,44,112,0.393,157,310,0.506,0.528,115,128,0.898,41,82,123,101,19,4,50,60,561
2006,Maurice Taylor,PF,29,NYK,67,13,1210,182,389,0.468,0,1,0,182,388,0.469,0.468,58,83,0.699,65,164,229,53,21,14,103,177,422
2006,Sebastian Telfair,PG,20,POR,68,30,1641,228,578,0.394,57,162,0.352,171,416,0.411,0.444,130,175,0.743,19,101,120,247,66,6,115,167,643
2006,Billy Thomas,SG,30,WAS,17,0,131,13,40,0.325,10,30,0.333,3,10,0.3,0.45,2,2,1,5,9,14,9,10,1,6,19,38
2006,James Thomas,PF,25,PHI,15,0,124,7,13,0.538,0,0,NA,7,13,0.538,0.538,8,14,0.571,8,23,31,1,0,3,7,32,22
2006,James Thomas,PF,25,CHI,7,0,26,3,6,0.5,0,0,NA,3,6,0.5,0.5,0,0,NA,4,4,8,0,0,0,0,3,6
2006,John Thomas,C,30,MEM,3,0,25,2,2,1,0,0,NA,2,2,1,1,0,0,NA,0,0,0,1,0,1,2,3,4
2006,John Thomas,C,30,ATL,11,0,66,3,7,0.429,0,0,NA,3,7,0.429,0.429,3,4,0.75,3,7,10,1,2,0,4,10,9
2006,John Thomas,C,30,NJN,2,0,36,1,6,0.167,0,0,NA,1,6,0.167,0.167,0,0,NA,7,3,10,0,1,1,2,4,2
2006,Kenny Thomas,PF,28,SAC,82,55,2293,305,604,0.505,0,1,0,305,603,0.506,0.505,138,204,0.676,199,419,618,168,72,39,135,196,748
2006,Kurt Thomas,C,33,PHO,53,50,1411,190,391,0.486,0,0,NA,190,391,0.486,0.486,75,92,0.815,102,313,415,57,23,54,57,193,455
2006,Tim Thomas,SF,28,CHI,3,0,32,6,16,0.375,1,6,0.167,5,10,0.5,0.406,0,0,NA,0,4,4,2,0,1,1,1,13
2006,Tim Thomas,PF,28,PHO,26,10,634,107,246,0.435,45,105,0.429,62,141,0.44,0.526,28,42,0.667,22,105,127,18,16,6,32,77,287
2006,Jake Tsakalidis,C,26,MEM,51,19,732,100,165,0.606,0,0,NA,100,165,0.606,0.606,57,87,0.655,78,134,212,13,14,32,39,107,257
2006,Nikoloz Tskitishvili,PF,22,MIN,5,0,13,1,4,0.25,0,0,NA,1,4,0.25,0.25,1,2,0.5,0,2,2,0,0,0,2,0,3
2006,Nikoloz Tskitishvili,SF,22,PHO,12,0,86,12,33,0.364,1,3,0.333,11,30,0.367,0.379,8,12,0.667,9,11,20,3,1,2,4,8,33
2006,Ronny Turiaf,C,23,LAL,23,1,161,15,30,0.5,0,0,NA,15,30,0.5,0.5,15,27,0.556,11,26,37,8,3,10,7,30,45
2006,Hedo Türkoğlu,SF,26,ORL,78,59,2615,398,877,0.454,114,283,0.403,284,594,0.478,0.519,255,296,0.861,70,263,333,216,70,21,130,234,1165
2006,Beno Udrih,PG,23,SAS,54,3,586,106,233,0.455,24,70,0.343,82,163,0.503,0.506,39,50,0.78,18,34,52,92,14,2,53,55,275
2006,Nick Van Exel,PG,34,SAS,65,2,986,136,343,0.397,55,154,0.357,81,189,0.429,0.477,28,41,0.683,6,85,91,123,16,3,57,60,355
2006,Keith Van Horn,SF,30,DAL,53,0,1090,164,387,0.424,50,136,0.368,114,251,0.454,0.488,94,113,0.832,54,138,192,37,31,11,71,121,472
2006,Anderson Varejão,C,23,CLE,48,4,760,79,150,0.527,0,1,0,79,149,0.53,0.527,61,119,0.513,77,158,235,19,31,19,27,118,219
2006,Jackson Vroman,PF,24,NOK,41,2,406,26,66,0.394,0,0,NA,26,66,0.394,0.394,21,44,0.477,33,53,86,11,12,11,21,78,73
2006,Sasha Vujačić,PG,21,LAL,82,4,1449,108,312,0.346,59,172,0.343,49,140,0.35,0.441,46,52,0.885,33,126,159,139,48,3,50,150,321
2006,Dwyane Wade,SG,24,MIA,75,75,2892,699,1413,0.495,13,76,0.171,686,1337,0.513,0.499,629,803,0.783,107,323,430,503,146,58,268,217,2040
2006,Von Wafer,SG,20,LAL,16,0,73,6,38,0.158,2,17,0.118,4,21,0.19,0.184,6,8,0.75,5,3,8,4,3,0,1,12,20
2006,Antoine Walker,PF,29,MIA,82,19,2199,391,898,0.435,137,383,0.358,254,515,0.493,0.512,81,129,0.628,103,318,421,166,47,30,150,187,1000
2006,Ben Wallace,C,31,DET,82,82,2890,237,465,0.51,0,4,0,237,461,0.514,0.51,123,296,0.416,301,622,923,158,146,181,88,164,597
2006,Gerald Wallace,SF,23,CHA,55,52,1895,317,589,0.538,14,50,0.28,303,539,0.562,0.55,188,306,0.614,123,289,412,96,138,115,99,150,836
2006,Rasheed Wallace,PF,31,DET,80,80,2780,459,1067,0.43,155,434,0.357,304,633,0.48,0.503,136,183,0.743,90,457,547,182,82,130,85,232,1209
2006,Luke Walton,SF,25,LAL,69,6,1333,135,328,0.412,18,55,0.327,117,273,0.429,0.439,57,76,0.75,88,159,247,156,41,15,78,119,345
2006,Hakim Warrick,PF,23,MEM,68,2,724,101,228,0.443,0,0,NA,101,228,0.443,0.443,76,115,0.661,43,101,144,30,14,21,56,113,278
2006,Earl Watson,PG,26,DEN,46,10,975,121,282,0.429,68,172,0.395,53,110,0.482,0.55,37,59,0.627,17,69,86,160,37,7,75,95,347
2006,Earl Watson,PG,26,SEA,24,0,603,98,227,0.432,42,100,0.42,56,127,0.441,0.524,38,52,0.731,7,65,72,129,31,3,61,64,276
2006,Chris Webber,PF,32,PHI,75,75,2893,617,1422,0.434,21,77,0.273,596,1345,0.443,0.441,263,348,0.756,184,557,741,256,103,62,182,219,1518
2006,Bonzi Wells,SG,29,SAC,52,41,1684,284,613,0.463,10,45,0.222,274,568,0.482,0.471,129,190,0.679,142,259,401,144,94,25,126,156,707
2006,Jiří Welsch,SF,26,MIL,58,2,866,86,222,0.387,14,49,0.286,72,173,0.416,0.419,65,87,0.747,22,89,111,62,34,1,41,65,251
2006,David Wesley,SG,35,HOU,71,59,2372,226,561,0.403,99,271,0.365,127,290,0.438,0.491,151,187,0.807,24,154,178,204,59,6,120,212,702
2006,Delonte West,PG,22,BOS,71,71,2418,333,684,0.487,84,218,0.385,249,466,0.534,0.548,86,101,0.851,57,232,289,329,84,46,133,197,836
2006,Chris Wilcox,C,23,LAC,48,1,657,90,168,0.536,0,2,0,90,166,0.542,0.536,38,59,0.644,46,127,173,18,15,21,32,103,218
2006,Chris Wilcox,PF,23,SEA,29,23,872,167,282,0.592,0,0,NA,167,282,0.592,0.592,74,94,0.787,72,165,237,34,18,13,40,80,408
2006,Mike Wilks,PG,26,CLE,37,0,243,17,59,0.288,2,14,0.143,15,45,0.333,0.305,6,12,0.5,6,21,27,18,8,1,15,27,42
2006,Mike Wilks,PG,26,SEA,10,0,105,12,31,0.387,1,5,0.2,11,26,0.423,0.403,19,29,0.655,3,9,12,14,6,0,9,7,44
2006,Aaron Williams,C,34,TOR,14,3,99,10,19,0.526,0,0,NA,10,19,0.526,0.526,5,6,0.833,5,10,15,1,4,3,5,28,25
2006,Aaron Williams,C,34,NOK,34,2,692,81,157,0.516,0,0,NA,81,157,0.516,0.516,35,52,0.673,59,107,166,16,13,18,25,110,197
2006,Alvin Williams,PG,31,TOR,1,0,10,0,3,0,0,2,0,0,1,0,0,1,2,0.5,0,3,3,0,0,0,0,0,1
2006,Deron Williams,PG,21,UTA,80,47,2307,339,805,0.421,91,219,0.416,248,586,0.423,0.478,95,135,0.704,35,159,194,359,60,17,145,233,864
2006,Eric Williams,SF,33,TOR,28,11,352,29,75,0.387,5,18,0.278,24,57,0.421,0.42,28,38,0.737,10,40,50,15,7,2,15,55,91
2006,Jason Williams,PG,30,MIA,59,56,1874,268,606,0.442,107,288,0.372,161,318,0.506,0.531,85,98,0.867,6,133,139,287,53,5,100,101,728
2006,Lou Williams,PG,19,PHI,30,0,145,23,52,0.442,2,9,0.222,21,43,0.488,0.462,8,13,0.615,3,16,19,10,5,0,13,13,56
2006,Marvin Williams,PF,19,ATL,79,7,1952,235,531,0.443,13,53,0.245,222,478,0.464,0.455,189,253,0.747,122,261,383,63,48,24,83,227,672
2006,Mo Williams,PG,23,MIL,58,12,1531,267,629,0.424,73,191,0.382,194,438,0.443,0.483,96,113,0.85,30,113,143,230,52,7,105,146,703
2006,Corliss Williamson,SF,32,SAC,37,0,362,43,103,0.417,2,2,1,41,101,0.406,0.427,38,49,0.776,21,46,67,14,7,4,30,56,126
2006,Metta World Peace,SF,26,IND,16,16,603,109,237,0.46,18,54,0.333,91,183,0.497,0.498,74,121,0.612,26,52,78,35,42,11,43,45,310
2006,Metta World Peace,SF,26,SAC,40,40,1604,241,630,0.383,60,199,0.302,181,431,0.42,0.43,132,184,0.717,49,159,208,168,80,30,88,119,674
2006,Antoine Wright,SG,21,NJN,39,0,370,29,81,0.358,1,15,0.067,28,66,0.424,0.364,11,22,0.5,8,22,30,12,4,3,21,42,70
2006,Lorenzen Wright,C,30,MEM,78,58,1689,194,406,0.478,0,2,0,194,404,0.48,0.478,66,117,0.564,142,253,395,48,52,46,67,201,454
2007,Shareef Abdur-Rahim,C,30,SAC,80,45,2015,310,654,0.474,3,20,0.15,307,634,0.484,0.476,170,234,0.726,122,276,398,109,53,40,116,243,793
2007,Maurice Ager,SG,22,DAL,32,1,214,22,70,0.314,5,15,0.333,17,55,0.309,0.35,20,33,0.606,1,20,21,7,4,3,15,27,69
2007,LaMarcus Aldridge,C,21,POR,63,22,1392,241,479,0.503,0,2,0,241,477,0.505,0.503,83,115,0.722,144,168,312,24,22,73,43,186,565
2007,Malik Allen,PF,28,CHI,60,1,638,107,258,0.415,0,1,0,107,257,0.416,0.415,28,34,0.824,42,77,119,16,17,16,21,85,242
2007,Ray Allen,SG,31,SEA,55,55,2219,505,1153,0.438,165,443,0.372,340,710,0.479,0.51,279,309,0.903,57,190,247,228,82,11,154,113,1454
2007,Rafer Alston,PG,30,HOU,82,82,3040,383,1020,0.375,192,529,0.363,191,491,0.389,0.47,130,177,0.734,29,253,282,444,129,10,170,195,1088
2007,Lou Amundson,PF,24,UTA,1,0,2,0,0,NA,0,0,NA,0,0,NA,NA,0,0,NA,0,0,0,0,0,0,0,0,0
2007,Lou Amundson,PF,24,PHI,10,0,87,6,15,0.4,0,0,NA,6,15,0.4,0.4,4,10,0.4,13,15,28,1,1,8,5,15,16
2007,Derek Anderson,SF,32,CHA,50,32,1190,126,294,0.429,54,152,0.355,72,142,0.507,0.52,93,106,0.877,29,84,113,133,52,7,56,115,399
2007,Carmelo Anthony,SF,22,DEN,65,65,2486,691,1453,0.476,40,149,0.268,651,1304,0.499,0.489,459,568,0.808,143,248,391,249,77,23,234,203,1881
2007,Gilbert Arenas,PG,25,WAS,74,73,2942,647,1548,0.418,205,584,0.351,442,964,0.459,0.484,606,718,0.844,61,277,338,443,139,13,236,249,2105
2007,Trevor Ariza,SG,21,ORL,57,7,1278,200,371,0.539,0,7,0,200,364,0.549,0.539,106,171,0.62,98,151,249,65,59,19,84,134,506
2007,Darrell Armstrong,PG,38,IND,81,4,1275,156,377,0.414,72,214,0.336,84,163,0.515,0.509,73,93,0.785,34,101,135,191,70,6,76,102,457
2007,Hilton Armstrong,C,22,NOK,56,5,634,68,125,0.544,0,0,NA,68,125,0.544,0.544,40,67,0.597,58,91,149,10,12,26,35,79,176
2007,Carlos Arroyo,PG,27,ORL,72,5,1304,203,478,0.425,14,51,0.275,189,427,0.443,0.439,132,166,0.795,31,103,134,202,39,2,90,131,552
2007,Chucky Atkins,PG,32,MEM,75,23,2064,310,715,0.434,116,306,0.379,194,409,0.474,0.515,252,311,0.81,18,121,139,346,50,4,127,136,988
2007,Renaldo Balkman,SF,22,NYK,68,1,1064,139,275,0.505,5,27,0.185,134,248,0.54,0.515,51,90,0.567,97,197,294,44,57,44,49,146,334
2007,Marcus Banks,PG,25,PHO,45,1,503,84,196,0.429,5,29,0.172,79,167,0.473,0.441,48,60,0.8,10,28,38,60,23,3,40,70,221
2007,Leandro Barbosa,SG,24,PHO,80,18,2613,529,1111,0.476,190,438,0.434,339,673,0.504,0.562,196,232,0.845,22,192,214,317,96,15,146,210,1444
2007,Matt Barnes,PF,26,GSW,76,23,1813,275,628,0.438,106,290,0.366,169,338,0.5,0.522,90,123,0.732,91,259,350,156,73,41,105,188,746
2007,Andre Barrett,PG,24,CHI,6,0,29,4,8,0.5,0,0,NA,4,8,0.5,0.5,0,0,NA,1,4,5,7,0,0,4,4,8
2007,Earl Barron,C,25,MIA,28,0,203,24,83,0.289,0,1,0,24,82,0.293,0.289,17,18,0.944,19,22,41,5,6,4,11,21,65
2007,Brent Barry,SG,35,SAS,75,28,1631,202,425,0.475,128,287,0.446,74,138,0.536,0.626,103,117,0.88,17,143,160,138,56,12,61,88,635
2007,Tony Battie,PF,30,ORL,66,66,1575,176,360,0.489,0,1,0,176,359,0.49,0.489,52,77,0.675,92,252,344,35,29,30,61,185,404
2007,Shane Battier,SF,28,HOU,82,82,2988,292,654,0.446,157,373,0.421,135,281,0.48,0.567,88,113,0.779,67,271,338,175,79,60,72,190,829
2007,Charlie Bell,SG,27,MIL,82,64,2848,426,974,0.437,127,361,0.352,299,613,0.488,0.503,131,168,0.78,57,181,238,247,97,4,104,213,1110
2007,Raja Bell,SG,30,PHO,78,78,2917,410,950,0.432,205,496,0.413,205,454,0.452,0.539,118,152,0.776,48,203,251,196,50,22,83,233,1143
2007,Mike Bibby,PG,28,SAC,82,82,2784,471,1166,0.404,173,481,0.36,298,685,0.435,0.478,288,347,0.83,39,224,263,388,88,6,197,139,1403
2007,Chauncey Billups,PG,30,DET,70,70,2533,348,815,0.427,109,316,0.345,239,499,0.479,0.494,386,437,0.883,23,214,237,502,84,17,140,161,1191
2007,Steve Blake,PG,26,MIL,33,2,583,45,129,0.349,19,68,0.279,26,61,0.426,0.422,11,20,0.55,7,38,45,84,10,3,28,49,120
2007,Steve Blake,PG,26,DEN,49,40,1642,164,380,0.432,48,140,0.343,116,240,0.483,0.495,32,44,0.727,14,110,124,324,51,5,101,72,408
2007,Mark Blount,C,31,MIN,82,81,2544,427,839,0.509,9,31,0.29,418,808,0.517,0.514,147,195,0.754,136,369,505,67,43,58,159,239,1010
2007,Keith Bogans,SG,26,ORL,59,18,990,99,245,0.404,53,137,0.387,46,108,0.426,0.512,47,63,0.746,16,77,93,59,28,2,46,98,298
2007,Andrew Bogut,C,22,MIL,66,66,2258,348,629,0.553,1,5,0.2,347,624,0.556,0.554,112,194,0.577,168,416,584,198,49,35,150,216,809
2007,Calvin Booth,C,30,WAS,44,1,380,31,66,0.47,1,2,0.5,30,64,0.469,0.477,6,10,0.6,27,54,81,18,4,29,9,71,69
2007,Bruce Bowen,SF,35,SAS,82,82,2464,189,467,0.405,89,232,0.384,100,235,0.426,0.5,43,73,0.589,23,200,223,117,62,25,65,175,510
2007,Earl Boykins,PG,30,DEN,31,4,877,156,378,0.413,41,110,0.373,115,268,0.429,0.467,119,131,0.908,23,40,63,132,25,2,52,31,472
2007,Earl Boykins,PG,30,MIL,35,19,1154,167,391,0.427,54,129,0.419,113,262,0.431,0.496,101,114,0.886,26,50,76,159,31,0,68,61,489
2007,Ronnie Brewer,SG,21,UTA,56,14,675,102,193,0.528,0,9,0,102,184,0.554,0.528,56,83,0.675,37,38,75,24,37,6,24,44,260
2007,Primož Brezec,C,27,CHA,58,40,838,122,274,0.445,1,3,0.333,121,271,0.446,0.447,43,68,0.632,80,104,184,23,11,23,38,161,288
2007,Dee Brown,PG,22,UTA,49,0,450,32,98,0.327,6,28,0.214,26,70,0.371,0.357,24,37,0.649,8,32,40,83,22,7,31,51,94
2007,Devin Brown,SG,28,NOK,58,49,1662,233,555,0.42,81,227,0.357,152,328,0.463,0.493,123,155,0.794,55,196,251,149,44,9,91,139,670
2007,Kwame Brown,C,24,LAL,41,28,1132,143,242,0.591,0,1,0,143,241,0.593,0.591,59,134,0.44,81,163,244,75,39,49,76,124,345
2007,Shannon Brown,SG,21,CLE,23,5,202,28,74,0.378,7,25,0.28,21,49,0.429,0.426,10,14,0.714,6,15,21,10,7,3,14,24,73
2007,Caron Butler,SF,26,WAS,63,63,2474,451,975,0.463,18,72,0.25,433,903,0.48,0.472,283,328,0.863,147,320,467,233,134,17,181,188,1203
2007,Rasual Butler,SF,27,NOK,81,38,2223,314,788,0.398,134,363,0.369,180,425,0.424,0.484,56,87,0.644,42,214,256,63,40,54,67,148,818
2007,Andrew Bynum,C,19,LAL,82,53,1793,247,443,0.558,0,3,0,247,440,0.561,0.558,143,214,0.668,139,345,484,94,12,128,115,249,637
2007,José Calderón,PG,25,TOR,77,11,1614,263,505,0.521,25,75,0.333,238,430,0.553,0.546,117,143,0.818,21,113,134,387,63,5,110,136,668
2007,Marcus Camby,C,32,DEN,70,70,2369,312,659,0.473,0,2,0,312,657,0.475,0.473,161,221,0.729,164,652,816,223,87,231,122,183,785
2007,Rodney Carney,SF,22,PHI,67,35,1169,182,392,0.464,25,72,0.347,157,320,0.491,0.496,53,87,0.609,39,89,128,26,38,23,43,118,442
2007,Matt Carroll,SG,26,CHA,72,47,1878,285,658,0.433,111,267,0.416,174,391,0.445,0.517,188,208,0.904,35,172,207,91,53,9,73,176,869
2007,Anthony Carter,PG,31,DEN,2,0,37,3,8,0.375,0,2,0,3,6,0.5,0.375,0,0,NA,0,3,3,11,0,1,6,4,6
2007,Vince Carter,SG,30,NJN,82,82,3126,726,1598,0.454,156,437,0.357,570,1161,0.491,0.503,462,576,0.802,114,378,492,393,82,30,217,266,2070
2007,Sam Cassell,PG,37,LAC,58,30,1407,261,625,0.418,32,109,0.294,229,516,0.444,0.443,160,182,0.879,27,140,167,270,28,8,101,126,714
2007,Kelvin Cato,C,32,NYK,18,0,95,7,22,0.318,0,0,NA,7,22,0.318,0.318,8,12,0.667,12,19,31,0,3,10,6,10,22
2007,Tyson Chandler,C,24,NOK,73,73,2525,292,468,0.624,0,1,0,292,467,0.625,0.624,106,201,0.527,320,584,904,66,37,129,126,244,690
2007,Doug Christie,SG,36,LAC,7,0,82,5,17,0.294,1,6,0.167,4,11,0.364,0.324,2,3,0.667,3,8,11,8,3,1,5,11,13
2007,Speedy Claxton,PG,28,ATL,42,31,1054,91,278,0.327,6,28,0.214,85,250,0.34,0.338,33,60,0.55,12,69,81,185,72,4,75,131,221
2007,Jarron Collins,C,28,UTA,82,9,913,75,170,0.441,0,0,NA,75,170,0.441,0.441,54,83,0.651,71,100,171,60,13,8,37,147,204
2007,Jason Collins,PF,28,NJN,80,78,1844,55,151,0.364,0,2,0,55,149,0.369,0.364,59,127,0.465,90,226,316,46,40,38,73,273,169
2007,Mardy Collins,SF,22,NYK,52,9,777,87,228,0.382,13,47,0.277,74,181,0.409,0.41,48,82,0.585,28,76,104,83,32,3,57,75,235
2007,Will Conroy,SG,24,MEM,3,0,17,0,0,NA,0,0,NA,0,0,NA,NA,0,0,NA,1,1,2,1,0,0,0,1,0
2007,Will Conroy,PG,24,LAC,4,0,35,0,3,0,0,0,NA,0,3,0,0,0,4,0,2,3,5,8,0,0,2,6,0
2007,Brian Cook,PF,26,LAL,65,24,1018,185,408,0.453,46,115,0.4,139,293,0.474,0.51,34,47,0.723,61,154,215,65,25,27,51,134,450
2007,Jamal Crawford,SG,26,NYK,59,36,2198,354,886,0.4,103,322,0.32,251,564,0.445,0.458,228,272,0.838,44,145,189,259,57,8,162,114,1039
2007,Austin Croshere,PF,31,DAL,61,2,727,78,222,0.351,26,91,0.286,52,131,0.397,0.41,45,52,0.865,33,153,186,44,14,6,33,68,227
2007,Antonio Daniels,SG,31,WAS,80,8,1761,172,389,0.442,19,63,0.302,153,326,0.469,0.467,208,250,0.832,18,133,151,290,39,9,69,79,571
2007,Baron Davis,PG,27,GSW,63,62,2221,452,1030,0.439,85,280,0.304,367,750,0.489,0.48,275,369,0.745,51,225,276,509,135,29,193,181,1264
2007,Dale Davis,C,37,DET,46,6,464,33,74,0.446,0,0,NA,33,74,0.446,0.446,17,26,0.654,59,78,137,12,10,34,15,59,83
2007,Ricky Davis,SF,27,MIN,81,81,3021,506,1089,0.465,123,310,0.397,383,779,0.492,0.521,239,285,0.839,54,261,315,385,80,23,210,189,1374
2007,Luol Deng,SF,21,CHI,82,82,3071,630,1218,0.517,1,7,0.143,629,1211,0.519,0.518,279,359,0.777,148,431,579,204,97,48,153,167,1540
2007,Boris Diaw,PF,24,PHO,73,59,2268,306,569,0.538,15,45,0.333,291,524,0.555,0.551,82,120,0.683,91,226,317,352,28,38,154,177,709
2007,Dan Dickau,PG,28,POR,50,3,444,54,151,0.358,16,61,0.262,38,90,0.422,0.411,42,53,0.792,7,36,43,70,14,1,27,55,166
2007,Travis Diener,PG,24,ORL,26,0,288,34,80,0.425,18,50,0.36,16,30,0.533,0.538,12,15,0.8,3,15,18,35,4,0,13,27,98
2007,Ike Diogu,PF,23,GSW,17,0,222,44,83,0.53,0,0,NA,44,83,0.53,0.53,35,44,0.795,21,42,63,5,3,11,18,35,123
2007,Ike Diogu,PF,23,IND,42,2,538,83,183,0.454,0,0,NA,83,183,0.454,0.454,77,96,0.802,54,86,140,20,5,15,49,87,243
2007,DeSagana Diop,C,25,DAL,81,9,1480,71,151,0.47,0,1,0,71,150,0.473,0.47,48,86,0.558,166,272,438,30,40,113,63,244,190
2007,Juan Dixon,SG,28,POR,55,1,1243,189,444,0.426,52,143,0.364,137,301,0.455,0.484,60,72,0.833,16,69,85,82,49,7,77,112,490
2007,Juan Dixon,SG,28,TOR,26,5,683,110,259,0.425,27,83,0.325,83,176,0.472,0.477,41,44,0.932,11,62,73,41,27,2,24,65,288
2007,Michael Doleac,C,29,MIA,56,0,698,82,175,0.469,0,1,0,82,174,0.471,0.469,36,41,0.878,44,111,155,22,18,15,30,96,200
2007,Quincy Douby,PG,22,SAC,42,0,359,48,126,0.381,12,50,0.24,36,76,0.474,0.429,11,15,0.733,11,26,37,15,15,4,15,21,119
2007,Mike Dunleavy,PF,26,GSW,39,6,1051,166,370,0.449,36,104,0.346,130,266,0.489,0.497,78,101,0.772,40,147,187,117,38,12,71,83,446
2007,Mike Dunleavy,SG,26,IND,43,43,1529,218,480,0.454,34,120,0.283,184,360,0.511,0.49,133,168,0.792,44,200,244,111,46,10,78,120,603
2007,Ronald Dupree,SF,26,DET,19,0,94,11,31,0.355,0,0,NA,11,31,0.355,0.355,3,9,0.333,5,12,17,5,5,1,3,12,25
2007,Monta Ellis,SG,21,GSW,77,53,2638,480,1010,0.475,39,143,0.273,441,867,0.509,0.495,273,358,0.763,62,181,243,319,132,21,221,210,1272
2007,Francisco Elson,C,30,SAS,70,41,1332,144,282,0.511,0,2,0,144,280,0.514,0.511,62,80,0.775,81,255,336,55,31,59,86,184,350
2007,Melvin Ely,PF,28,CHA,24,0,244,23,60,0.383,0,0,NA,23,60,0.383,0.383,24,35,0.686,12,27,39,14,2,6,23,39,70
2007,Melvin Ely,C,28,SAS,6,0,65,6,20,0.3,0,0,NA,6,20,0.3,0.3,7,12,0.583,3,11,14,4,4,2,5,12,19
2007,Maurice Evans,SG,28,LAL,76,10,1732,234,542,0.432,48,133,0.361,186,409,0.455,0.476,122,155,0.787,93,128,221,74,38,14,57,126,638
2007,Reggie Evans,PF,26,DEN,66,11,1127,117,215,0.544,0,0,NA,117,215,0.544,0.544,91,183,0.497,156,304,460,45,42,16,95,144,325
2007,Raymond Felton,PG,22,CHA,78,75,2832,393,1024,0.384,103,312,0.33,290,712,0.407,0.434,204,256,0.797,51,216,267,545,118,10,230,180,1093
2007,Michael Finley,SF,33,SAS,82,16,1823,273,663,0.412,104,286,0.364,169,377,0.448,0.49,90,98,0.918,34,189,223,108,32,16,46,76,740
2007,Derek Fisher,SG,32,UTA,82,61,2287,258,675,0.382,48,156,0.308,210,519,0.405,0.418,262,307,0.853,30,119,149,274,83,6,120,234,826
2007,Randy Foye,PG,23,MIN,82,12,1879,300,691,0.434,68,185,0.368,232,506,0.458,0.483,164,192,0.854,49,169,218,232,53,21,152,184,832
2007,Adonal Foyle,C,31,GSW,48,6,475,48,85,0.565,0,0,NA,48,85,0.565,0.565,11,25,0.44,51,75,126,19,11,50,23,61,107
2007,Steve Francis,SG,29,NYK,44,30,1237,140,343,0.408,42,111,0.378,98,232,0.422,0.469,175,211,0.829,33,124,157,170,41,12,100,126,497
2007,Channing Frye,PF,23,NYK,72,59,1896,298,689,0.433,3,18,0.167,295,671,0.44,0.435,85,108,0.787,91,304,395,67,36,42,100,216,684
2007,Dan Gadzuric,C,28,MIL,54,8,840,108,228,0.474,0,1,0,108,227,0.476,0.474,42,90,0.467,94,152,246,29,22,32,49,141,258
2007,Francisco García,SF,25,SAC,79,5,1410,163,380,0.429,53,149,0.356,110,231,0.476,0.499,95,114,0.833,53,152,205,87,45,43,70,190,474
2007,Kevin Garnett,PF,30,MIN,76,76,2995,638,1341,0.476,12,56,0.214,626,1285,0.487,0.48,416,498,0.835,183,792,975,313,89,126,205,184,1704
2007,Pau Gasol,C,26,MEM,59,59,2133,462,858,0.538,3,11,0.273,459,847,0.542,0.54,299,400,0.748,149,432,581,201,29,126,162,137,1226
2007,Rudy Gay,SF,20,MEM,78,43,2103,321,760,0.422,52,143,0.364,269,617,0.436,0.457,152,209,0.727,93,255,348,100,71,74,140,192,846
2007,Gordan Giriček,SG,29,UTA,61,6,1188,176,381,0.462,52,122,0.426,124,259,0.479,0.53,71,87,0.816,24,105,129,63,28,5,64,122,475
2007,Drew Gooden,PF,25,CLE,80,80,2238,371,784,0.473,1,6,0.167,370,778,0.476,0.474,142,199,0.714,263,418,681,88,70,28,115,210,885
2007,Stephen Graham,SG,24,POR,14,1,165,17,40,0.425,3,11,0.273,14,29,0.483,0.463,8,9,0.889,6,15,21,5,4,1,13,25,45
2007,Danny Granger,SF,23,IND,82,57,2785,398,868,0.459,110,288,0.382,288,580,0.497,0.522,236,294,0.803,114,267,381,114,67,61,135,245,1142
2007,Gerald Green,SF,21,BOS,81,26,1780,310,739,0.419,95,258,0.368,215,481,0.447,0.484,128,159,0.805,68,140,208,83,41,24,120,198,843
2007,Adrian Griffin,SF,32,CHI,54,1,585,61,129,0.473,0,6,0,61,123,0.496,0.473,15,19,0.789,40,69,109,59,32,4,38,78,137
2007,Al Harrington,PF,26,IND,36,36,1208,223,487,0.458,54,118,0.458,169,369,0.458,0.513,72,101,0.713,71,155,226,51,25,10,91,116,572
2007,Al Harrington,PF,26,GSW,42,42,1355,272,596,0.456,73,175,0.417,199,421,0.473,0.518,96,141,0.681,80,190,270,98,40,14,78,153,713
2007,Othella Harrington,PF,33,CHA,26,0,220,25,56,0.446,0,0,NA,25,56,0.446,0.446,17,22,0.773,13,25,38,6,1,1,15,49,67
2007,Devin Harris,PG,23,DAL,80,61,2081,292,593,0.492,14,50,0.28,278,543,0.512,0.504,215,261,0.824,45,151,196,296,96,21,146,242,813
2007,Jason Hart,PG,28,SAC,13,0,100,15,30,0.5,3,6,0.5,12,24,0.5,0.55,10,11,0.909,2,13,15,10,3,0,4,23,43
2007,Jason Hart,PG,28,LAC,23,22,746,85,194,0.438,4,23,0.174,81,171,0.474,0.448,32,36,0.889,12,71,83,93,41,1,34,60,206
2007,Trenton Hassell,SG,27,MIN,76,68,2223,217,443,0.49,6,25,0.24,211,418,0.505,0.497,72,92,0.783,83,160,243,203,22,26,80,144,512
2007,Chuck Hayes,PF,23,HOU,78,43,1714,192,335,0.573,0,0,NA,192,335,0.573,0.573,55,89,0.618,204,317,521,47,70,18,64,281,439
2007,Brendan Haywood,C,27,WAS,77,49,1740,198,355,0.558,0,0,NA,198,355,0.558,0.558,115,210,0.548,195,282,477,47,34,88,90,208,511
2007,Luther Head,SG,24,HOU,80,10,2211,306,700,0.437,177,401,0.441,129,299,0.431,0.564,83,105,0.79,31,221,252,194,76,5,137,133,872
2007,Walter Herrmann,PF,27,CHA,48,12,936,174,330,0.527,53,115,0.461,121,215,0.563,0.608,41,53,0.774,28,111,139,26,17,7,32,76,442
2007,Nenê,C,24,DEN,64,42,1715,294,516,0.57,0,1,0,294,515,0.571,0.57,195,283,0.689,150,299,449,77,62,59,127,209,783
2007,Kirk Hinrich,PG,26,CHI,80,80,2839,475,1061,0.448,140,337,0.415,335,724,0.463,0.514,237,284,0.835,32,242,274,500,100,23,191,274,1327
2007,Julius Hodge,SG,23,DEN,4,1,37,2,5,0.4,0,0,NA,2,5,0.4,0.4,2,2,1,1,2,3,10,3,0,1,3,6
2007,Julius Hodge,SG,23,MIL,5,0,28,4,7,0.571,0,0,NA,4,7,0.571,0.571,1,2,0.5,1,4,5,2,1,0,2,3,9
2007,Ryan Hollins,C,22,CHA,27,0,185,20,36,0.556,0,0,NA,20,36,0.556,0.556,24,40,0.6,11,20,31,1,4,7,16,40,64
2007,Robert Horry,PF,36,SAS,68,8,1124,90,251,0.359,50,149,0.336,40,102,0.392,0.458,38,64,0.594,73,156,229,77,45,41,44,105,268
2007,Eddie House,SG,28,NJN,56,1,946,180,421,0.428,75,175,0.429,105,246,0.427,0.517,33,36,0.917,14,78,92,67,27,3,27,69,468
2007,Josh Howard,SF,26,DAL,70,69,2455,493,1075,0.459,92,239,0.385,401,836,0.48,0.501,243,294,0.827,130,345,475,127,82,56,123,180,1321
2007,Juwan Howard,PF,33,HOU,80,38,2123,309,665,0.465,0,0,NA,309,665,0.465,0.465,155,188,0.824,138,332,470,131,29,8,112,205,773
2007,Larry Hughes,SG,28,CLE,70,68,2596,381,953,0.4,74,222,0.333,307,731,0.42,0.439,209,309,0.676,41,226,267,256,89,26,154,164,1045
2007,Kris Humphries,PF,21,TOR,60,2,670,87,185,0.47,0,0,NA,87,185,0.47,0.47,53,79,0.671,78,109,187,18,14,21,32,98,227
2007,D.J. Mbenga,C,26,DAL,21,0,79,5,16,0.313,0,0,NA,5,16,0.313,0.313,7,8,0.875,3,8,11,6,3,5,5,17,17
2007,Ersan İlyasova,PF,19,MIL,66,14,973,139,363,0.383,54,148,0.365,85,215,0.395,0.457,70,89,0.787,58,131,189,49,27,17,51,147,402
2007,Allen Iverson,PG,31,PHI,15,15,640,151,366,0.413,12,53,0.226,139,313,0.444,0.429,154,174,0.885,7,34,41,109,33,1,66,21,468
2007,Allen Iverson,SG,31,DEN,50,49,2121,430,947,0.454,50,144,0.347,380,803,0.473,0.48,331,436,0.759,16,136,152,359,90,12,202,74,1241
2007,Royal Ivey,PG,25,ATL,53,18,539,64,143,0.448,5,16,0.313,59,127,0.465,0.465,24,35,0.686,15,36,51,45,24,4,31,62,157
2007,Jarrett Jack,PG,23,POR,79,79,2651,320,705,0.454,63,180,0.35,257,525,0.49,0.499,243,279,0.871,18,190,208,417,86,9,187,202,946
2007,Bobby Jackson,SG,33,NOK,56,2,1330,204,518,0.394,54,165,0.327,150,353,0.425,0.446,130,168,0.774,42,136,178,141,50,6,78,98,592
2007,Luke Jackson,SF,25,LAC,3,0,16,1,8,0.125,1,4,0.25,0,4,0,0.188,0,0,NA,0,1,1,4,0,0,1,3,3
2007,Luke Jackson,SF,25,TOR,10,2,122,18,35,0.514,4,13,0.308,14,22,0.636,0.571,5,9,0.556,2,7,9,9,5,1,6,12,45
2007,Marc Jackson,PF,32,NOK,56,25,1025,159,388,0.41,0,1,0,159,387,0.411,0.41,90,103,0.874,62,130,192,58,21,7,65,89,408
2007,Stephen Jackson,SG,28,IND,37,32,1186,180,430,0.419,41,138,0.297,139,292,0.476,0.466,120,146,0.822,17,78,95,114,33,20,81,87,521
2007,Stephen Jackson,SF,28,GSW,38,37,1293,229,514,0.446,59,173,0.341,170,341,0.499,0.503,123,153,0.804,44,83,127,173,51,14,102,113,640
2007,Mike James,PG,31,MIN,82,65,2069,297,703,0.422,80,215,0.372,217,488,0.445,0.479,154,184,0.837,25,138,163,297,55,7,129,171,828
2007,Antawn Jamison,PF,30,WAS,70,70,2662,512,1139,0.45,138,379,0.364,374,760,0.492,0.51,226,307,0.736,134,428,562,136,80,36,104,194,1388
2007,Šarūnas Jasikevičius,SG,30,IND,37,1,664,91,221,0.412,32,86,0.372,59,135,0.437,0.484,59,64,0.922,10,38,48,111,13,0,59,53,273
2007,Šarūnas Jasikevičius,PG,30,GSW,26,2,309,37,101,0.366,12,44,0.273,25,57,0.439,0.426,27,31,0.871,5,16,21,61,13,1,31,22,113
2007,Richard Jefferson,SF,26,NJN,55,53,1956,303,665,0.456,52,145,0.359,251,520,0.483,0.495,239,326,0.733,48,192,240,148,34,8,120,123,897
2007,Jared Jeffries,SF,25,NYK,55,43,1307,95,206,0.461,2,20,0.1,93,186,0.5,0.466,31,68,0.456,111,127,238,67,44,30,61,150,223
2007,Anthony Johnson,PG,32,DAL,40,0,562,60,146,0.411,11,29,0.379,49,117,0.419,0.449,21,29,0.724,13,35,48,78,16,1,31,68,152
2007,Anthony Johnson,PG,32,ATL,27,17,739,82,197,0.416,14,44,0.318,68,153,0.444,0.452,25,32,0.781,9,44,53,123,17,2,45,51,203
2007,Joe Johnson,SG,25,ATL,57,57,2359,536,1139,0.471,119,312,0.381,417,827,0.504,0.523,235,314,0.748,53,186,239,249,60,11,176,115,1426
2007,Linton Johnson,PF,26,NOK,54,0,720,93,190,0.489,10,30,0.333,83,160,0.519,0.516,30,37,0.811,52,111,163,18,33,18,27,101,226
2007,Bobby Jones,SF,23,PHI,44,5,336,43,93,0.462,1,9,0.111,42,84,0.5,0.468,23,41,0.561,22,35,57,16,11,1,18,59,110
2007,Dahntay Jones,SG,26,MEM,78,25,1671,220,461,0.477,5,12,0.417,215,449,0.479,0.483,138,174,0.793,47,106,153,68,39,22,92,192,583
2007,Damon Jones,PG,30,CLE,60,0,1173,137,355,0.386,89,231,0.385,48,124,0.387,0.511,30,44,0.682,9,57,66,94,16,2,36,53,393
2007,Eddie Jones,SG,35,MEM,29,14,561,57,151,0.377,22,74,0.297,35,77,0.455,0.45,25,34,0.735,14,47,61,33,22,2,23,54,161
2007,Eddie Jones,SG,35,MIA,35,27,1033,121,271,0.446,56,148,0.378,65,123,0.528,0.55,34,41,0.829,17,112,129,76,46,8,24,70,332
2007,Fred Jones,SG,27,TOR,39,9,870,96,249,0.386,32,101,0.317,64,148,0.432,0.45,73,88,0.83,16,66,82,55,30,12,50,80,297
2007,Fred Jones,SG,27,POR,24,3,449,43,112,0.384,7,27,0.259,36,85,0.424,0.415,22,26,0.846,7,26,33,53,18,4,17,41,115
2007,Solomon Jones,PF,22,ATL,58,8,666,65,128,0.508,0,1,0,65,127,0.512,0.508,59,75,0.787,49,87,136,11,11,42,25,124,189
2007,Jason Kidd,PG,33,NJN,80,80,2933,369,908,0.406,124,361,0.343,245,547,0.448,0.475,179,230,0.778,135,520,655,736,127,23,213,146,1041
2007,Brevin Knight,PG,31,CHA,45,25,1273,152,363,0.419,1,18,0.056,151,345,0.438,0.42,103,128,0.805,14,101,115,296,67,3,95,113,408
2007,Kyle Korver,SF,25,PHI,74,1,2288,372,845,0.44,132,307,0.43,240,538,0.446,0.518,191,209,0.914,30,229,259,105,57,20,117,188,1067
2007,Nenad Krstić,C,23,NJN,26,26,848,170,323,0.526,0,1,0,170,322,0.528,0.526,86,121,0.711,51,125,176,46,10,24,52,88,426
2007,Raef LaFrentz,PF,30,POR,27,9,352,39,102,0.382,2,23,0.087,37,79,0.468,0.392,20,26,0.769,25,45,70,8,7,11,13,57,100
2007,David Lee,PF,23,NYK,58,12,1731,240,400,0.6,0,0,NA,240,400,0.6,0.6,141,173,0.815,196,406,602,104,48,23,92,155,621
2007,Rashard Lewis,SF,27,SEA,60,60,2348,463,1005,0.461,151,387,0.39,312,618,0.505,0.536,265,315,0.841,91,305,396,145,68,39,118,143,1342
2007,Shaun Livingston,PG,21,LAC,54,31,1611,208,449,0.463,5,16,0.313,203,433,0.469,0.469,82,116,0.707,56,128,184,274,59,29,108,135,503
2007,Kyle Lowry,PG,20,MEM,10,0,175,14,38,0.368,3,8,0.375,11,30,0.367,0.408,25,28,0.893,12,19,31,32,14,1,12,20,56
2007,Tyronn Lue,PG,29,ATL,56,17,1488,218,524,0.416,56,161,0.348,162,363,0.446,0.469,144,163,0.883,19,85,104,201,24,0,85,101,636
2007,Jamaal Magloire,C,28,POR,81,23,1703,199,395,0.504,0,0,NA,199,395,0.504,0.504,131,242,0.541,151,341,492,30,21,66,129,226,529
2007,Stephon Marbury,PG,29,NYK,74,74,2748,395,952,0.415,123,345,0.357,272,607,0.448,0.48,297,386,0.769,36,177,213,403,71,10,179,185,1210
2007,Shawn Marion,SF,28,PHO,80,80,3010,561,1071,0.524,80,252,0.317,481,819,0.587,0.561,201,248,0.81,172,613,785,134,156,122,114,216,1403
2007,Donyell Marshall,PF,33,CLE,81,0,1360,209,493,0.424,95,271,0.351,114,222,0.514,0.52,53,80,0.663,86,237,323,46,39,43,67,130,566
2007,Darrick Martin,PG,35,TOR,31,0,220,33,94,0.351,13,37,0.351,20,57,0.351,0.42,15,21,0.714,2,10,12,43,3,0,12,22,94
2007,Kevin Martin,SG,23,SAC,80,80,2818,505,1067,0.473,127,333,0.381,378,734,0.515,0.533,481,570,0.844,69,273,342,173,98,11,135,181,1618
2007,Desmond Mason,SF,29,NOK,75,75,2575,407,900,0.452,0,0,NA,407,900,0.452,0.452,214,323,0.663,124,221,345,115,52,22,192,174,1028
2007,Roger Mason,SG,26,WAS,62,0,492,59,179,0.33,33,102,0.324,26,77,0.338,0.422,14,16,0.875,7,38,45,35,13,6,19,66,165
2007,Rashad McCants,SG,22,MIN,37,0,554,62,177,0.35,20,75,0.267,42,102,0.412,0.407,40,58,0.69,14,33,47,38,26,7,40,71,184
2007,Antonio McDyess,PF,32,DET,82,3,1729,284,540,0.526,0,0,NA,284,540,0.526,0.526,96,139,0.691,165,331,496,72,61,65,75,240,664
2007,Tracy McGrady,SG,27,HOU,71,71,2539,638,1480,0.431,126,381,0.331,512,1099,0.466,0.474,345,488,0.707,56,322,378,458,92,36,213,136,1747
2007,Jeff McInnis,PG,32,CHA,38,3,702,71,181,0.392,1,8,0.125,70,173,0.405,0.395,22,32,0.688,14,48,62,124,14,0,42,72,165
2007,Aaron McKie,SF,34,LAL,10,0,131,11,17,0.647,0,0,NA,11,17,0.647,0.647,0,0,NA,1,17,18,13,4,0,8,14,22
2007,Keith McLeod,PG,27,GSW,26,2,379,41,105,0.39,9,23,0.391,32,82,0.39,0.433,47,53,0.887,3,18,21,45,17,3,23,21,138
2007,Keith McLeod,PG,27,IND,22,7,339,32,83,0.386,7,22,0.318,25,61,0.41,0.428,22,25,0.88,1,21,22,45,7,2,23,30,93
2007,Pops Mensah-Bonsu,PF,23,DAL,12,0,71,11,17,0.647,0,0,NA,11,17,0.647,0.647,7,18,0.389,9,12,21,0,1,0,9,8,29
2007,C.J. Miles,SG,19,UTA,37,13,373,40,116,0.345,7,32,0.219,33,84,0.393,0.375,14,23,0.609,11,24,35,25,11,4,28,60,101
2007,Darko Miličić,PF,21,ORL,80,16,1913,249,548,0.454,0,1,0,249,547,0.455,0.454,141,230,0.613,145,292,437,90,44,140,124,219,639
2007,Andre Miller,PG,30,DEN,23,23,822,117,248,0.472,4,16,0.25,113,232,0.487,0.48,62,85,0.729,25,79,104,209,37,4,70,58,300
2007,Andre Miller,PG,30,PHI,57,56,2144,307,661,0.464,1,19,0.053,306,642,0.477,0.465,160,198,0.808,72,176,248,416,73,6,152,126,775
2007,Brad Miller,C,30,SAC,63,56,1783,224,494,0.453,5,33,0.152,219,461,0.475,0.459,115,149,0.772,79,322,401,224,38,39,108,155,568
2007,Mike Miller,SG,26,MEM,70,69,2740,465,1010,0.46,202,498,0.406,263,512,0.514,0.56,161,203,0.793,52,326,378,298,54,18,179,138,1293
2007,Cuttino Mobley,SG,31,LAC,78,73,2841,388,882,0.44,101,246,0.411,287,636,0.451,0.497,200,239,0.837,52,215,267,198,92,24,145,186,1077
2007,Nazr Mohammed,C,29,DET,51,33,773,118,222,0.532,0,0,NA,118,222,0.532,0.532,50,82,0.61,89,140,229,9,27,40,43,133,286
2007,Mikki Moore,C,31,NJN,79,55,2082,308,506,0.609,0,1,0,308,505,0.61,0.609,160,235,0.681,145,258,403,74,46,60,113,261,776
2007,Adam Morrison,PF,22,CHA,78,23,2326,355,944,0.376,87,258,0.337,268,686,0.391,0.422,120,169,0.71,54,176,230,163,28,6,130,179,917
2007,Alonzo Mourning,C,36,MIA,77,43,1572,238,425,0.56,0,0,NA,238,425,0.56,0.56,185,308,0.601,126,224,350,18,13,178,129,219,661
2007,Troy Murphy,PF,26,GSW,26,17,667,81,180,0.45,22,59,0.373,59,121,0.488,0.511,47,66,0.712,37,120,157,60,21,17,29,63,231
2007,Troy Murphy,PF,26,IND,42,31,1185,185,401,0.461,36,88,0.409,149,313,0.476,0.506,61,79,0.772,63,194,257,66,25,25,49,133,467
2007,Ronald Murray,SG,27,DET,69,18,1477,177,438,0.404,24,83,0.289,153,355,0.431,0.432,87,120,0.725,26,87,113,187,49,13,90,96,465
2007,Dikembe Mutombo,C,40,HOU,75,33,1289,85,153,0.556,0,0,NA,85,153,0.556,0.556,60,87,0.69,164,324,488,13,22,76,38,156,230
2007,Boštjan Nachbar,SF,26,NJN,76,1,1532,226,495,0.457,112,265,0.423,114,230,0.496,0.57,132,164,0.805,27,226,253,61,30,26,69,183,696
2007,Eduardo Nájera,PF,30,DEN,75,36,1658,204,354,0.576,1,12,0.083,203,342,0.594,0.578,88,123,0.715,131,179,310,64,73,26,56,207,497
2007,Jameer Nelson,PG,24,ORL,77,77,2331,376,875,0.43,65,194,0.335,311,681,0.457,0.467,183,221,0.828,50,186,236,330,73,5,184,225,1000
2007,Ira Newble,SF,32,CLE,15,1,129,16,37,0.432,8,15,0.533,8,22,0.364,0.541,6,10,0.6,13,17,30,2,6,0,3,17,46
2007,Andrés Nocioni,PF,27,CHI,53,31,1406,273,584,0.467,80,209,0.383,193,375,0.515,0.536,123,145,0.848,42,259,301,57,27,24,104,164,749
2007,Steve Novak,SF,23,HOU,35,1,191,18,50,0.36,13,39,0.333,5,11,0.455,0.49,2,2,1,4,22,26,6,5,0,4,21,51
2007,Patrick O'Bryant,C,20,GSW,16,0,119,10,32,0.313,0,0,NA,10,32,0.313,0.313,11,17,0.647,7,14,21,9,6,8,8,26,31
2007,Jermaine O'Neal,C,28,IND,69,69,2459,498,1141,0.436,0,7,0,498,1134,0.439,0.436,343,447,0.767,153,508,661,167,50,182,203,232,1339
2007,Shaquille O'Neal,C,34,MIA,40,39,1135,283,479,0.591,0,0,NA,283,479,0.591,0.591,124,294,0.422,97,200,297,79,8,55,95,139,690
2007,Kevin Ollie,PG,34,PHI,53,23,919,81,187,0.433,0,2,0,81,185,0.438,0.433,37,45,0.822,8,66,74,130,21,1,47,76,199
2007,Michael Olowokandi,C,31,BOS,24,0,234,19,46,0.413,0,0,NA,19,46,0.413,0.413,2,3,0.667,14,34,48,5,8,13,17,48,40
2007,Bo Outlaw,PF,35,ORL,41,0,460,34,51,0.667,0,0,NA,34,51,0.667,0.667,13,22,0.591,47,59,106,16,17,6,21,57,81
2007,Travis Outlaw,PF,22,POR,67,1,1532,246,567,0.434,10,37,0.27,236,530,0.445,0.443,143,181,0.79,65,152,217,52,61,74,66,150,645
2007,Scott Padgett,PF,30,HOU,24,0,198,15,49,0.306,8,29,0.276,7,20,0.35,0.388,6,11,0.545,11,34,45,8,4,3,8,33,44
2007,Scott Padgett,PF,30,MEM,7,0,33,1,7,0.143,0,4,0,1,3,0.333,0.143,0,2,0,5,4,9,0,1,0,1,2,2
2007,Jannero Pargo,PG,27,NOK,82,7,1710,283,692,0.409,81,209,0.388,202,483,0.418,0.467,104,122,0.852,20,160,180,203,53,4,122,121,751
2007,Smush Parker,PG,25,LAL,82,80,2457,342,785,0.436,110,301,0.365,232,484,0.479,0.506,113,175,0.646,45,161,206,228,119,10,153,211,907
2007,Ruben Patterson,SF,31,MIL,81,53,2508,475,867,0.548,3,19,0.158,472,848,0.557,0.55,241,376,0.641,190,250,440,232,110,25,199,232,1194
2007,Sasha Pavlović,SG,23,CLE,67,28,1534,222,490,0.453,60,148,0.405,162,342,0.474,0.514,100,126,0.794,23,135,158,105,55,17,102,145,604
2007,Gary Payton,PG,38,MIA,68,28,1503,144,366,0.393,32,123,0.26,112,243,0.461,0.437,38,57,0.667,18,114,132,201,43,3,66,117,358
2007,Kendrick Perkins,C,22,BOS,72,53,1576,132,269,0.491,0,3,0,132,266,0.496,0.491,60,100,0.6,113,259,372,94,23,96,113,214,324
2007,Johan Petro,C,21,SEA,81,13,1510,226,438,0.516,0,0,NA,226,438,0.516,0.516,50,77,0.649,92,243,335,45,39,47,82,237,502
2007,Mickaël Piétrus,SF,24,GSW,72,38,1937,286,586,0.488,93,240,0.388,193,346,0.558,0.567,136,210,0.648,81,246,327,62,48,55,105,220,801
2007,James Posey,SF,30,MIA,71,19,1919,186,432,0.431,97,259,0.375,89,173,0.514,0.543,81,98,0.827,66,291,357,94,71,23,55,193,550
2007,Vitaly Potapenko,C,31,SAC,3,0,13,0,4,0,0,0,NA,0,4,0,0,0,0,NA,0,2,2,0,0,0,2,3,0
2007,Leon Powe,C,23,BOS,63,2,720,79,177,0.446,0,2,0,79,175,0.451,0.446,106,144,0.736,97,118,215,10,14,22,47,104,264
2007,Josh Powell,PF,24,IND,7,0,64,2,15,0.133,0,0,NA,2,15,0.133,0.133,8,12,0.667,7,12,19,3,0,0,5,18,12
2007,Josh Powell,PF,24,GSW,30,0,289,41,78,0.526,0,0,NA,41,78,0.526,0.526,22,30,0.733,17,52,69,18,5,12,24,43,104
2007,Tayshaun Prince,SF,26,DET,82,82,3001,459,997,0.46,81,210,0.386,378,787,0.48,0.501,172,224,0.768,144,285,429,227,51,55,98,116,1171
2007,Joel Przybilla,C,27,POR,43,43,701,37,78,0.474,0,0,NA,37,78,0.474,0.474,10,27,0.37,59,109,168,12,10,67,40,124,84
2007,Vladimir Radmanović,PF,26,LAL,55,15,986,134,316,0.424,40,118,0.339,94,198,0.475,0.487,53,73,0.726,53,127,180,66,25,18,69,125,361
2007,Shavlik Randolph,PF,23,PHI,13,6,179,23,48,0.479,0,0,NA,23,48,0.479,0.479,12,22,0.545,19,35,54,4,7,10,9,23,58
2007,Zach Randolph,PF,25,POR,68,67,2425,600,1286,0.467,14,48,0.292,586,1238,0.473,0.472,394,481,0.819,199,489,688,147,53,15,215,184,1608
2007,Theo Ratliff,C,33,BOS,2,2,44,1,3,0.333,0,0,NA,1,3,0.333,0.333,3,4,0.75,2,5,7,0,1,3,1,6,5
2007,J.J. Redick,PG,22,ORL,42,0,622,80,195,0.41,38,98,0.388,42,97,0.433,0.508,54,60,0.9,10,42,52,36,12,0,21,52,252
2007,Justin Reed,PF,25,MIN,41,3,318,40,107,0.374,0,0,NA,40,107,0.374,0.374,26,30,0.867,15,31,46,17,5,3,22,44,106
2007,Jason Richardson,SG,26,GSW,51,49,1675,306,734,0.417,110,301,0.365,196,433,0.453,0.492,92,140,0.657,71,188,259,172,54,32,82,129,814
2007,Jeremy Richardson,SG,22,ATL,5,0,19,3,6,0.5,2,3,0.667,1,3,0.333,0.667,0,0,NA,1,1,2,0,1,0,1,2,8
2007,Jeremy Richardson,SF,22,POR,1,0,1,0,0,NA,0,0,NA,0,0,NA,NA,0,0,NA,0,0,0,0,0,0,0,0,0
2007,Luke Ridnour,PG,25,SEA,71,58,2091,301,695,0.433,49,139,0.353,252,556,0.453,0.468,128,159,0.805,28,136,164,368,83,19,156,181,779
2007,Anthony Roberson,PG,23,GSW,20,1,227,44,104,0.423,21,55,0.382,23,49,0.469,0.524,2,3,0.667,2,19,21,10,12,0,13,27,111
2007,Bernard Robinson,SG,26,CHA,21,0,241,16,54,0.296,0,2,0,16,52,0.308,0.296,19,22,0.864,9,33,42,17,13,1,16,28,51
2007,Bernard Robinson,SF,26,NJN,10,0,37,3,8,0.375,0,0,NA,3,8,0.375,0.375,4,5,0.8,1,5,6,2,4,1,0,4,10
2007,Clifford Robinson,C,40,NJN,50,1,955,81,218,0.372,25,66,0.379,56,152,0.368,0.429,16,36,0.444,31,91,122,51,12,23,30,98,203
2007,Nate Robinson,PG,22,NYK,64,5,1356,227,523,0.434,83,213,0.39,144,310,0.465,0.513,108,139,0.777,55,97,152,90,50,6,72,160,645
2007,Sergio Rodríguez,PG,20,POR,67,1,862,101,239,0.423,24,85,0.282,77,154,0.5,0.473,21,26,0.808,20,71,91,218,35,2,77,72,247
2007,Rajon Rondo,PG,20,BOS,78,25,1831,188,450,0.418,6,29,0.207,182,421,0.432,0.424,119,184,0.647,74,218,292,297,128,8,137,181,501
2007,Jalen Rose,SF,34,PHO,29,0,246,38,86,0.442,21,47,0.447,17,39,0.436,0.564,11,12,0.917,3,20,23,16,5,2,9,22,108
2007,Malik Rose,PF,32,NYK,65,2,810,74,186,0.398,2,8,0.25,72,178,0.404,0.403,42,52,0.808,47,128,175,65,26,9,65,120,192
2007,Quinton Ross,SG,25,LAC,81,43,1700,177,379,0.467,2,10,0.2,175,369,0.474,0.47,68,87,0.782,60,130,190,86,70,32,33,179,424
2007,John Salmons,SG,27,SAC,79,19,2135,236,517,0.456,40,112,0.357,196,405,0.484,0.495,159,204,0.779,47,217,264,254,73,27,119,177,671
2007,Thabo Sefolosha,SG,22,CHI,71,4,868,109,256,0.426,15,42,0.357,94,214,0.439,0.455,23,45,0.511,35,118,153,60,33,11,60,100,256
2007,Mouhamed Sene,C,20,SEA,28,3,169,18,49,0.367,0,0,NA,18,49,0.367,0.367,17,29,0.586,16,29,45,0,3,12,11,33,53
2007,Cedric Simmons,PF,21,NOK,43,4,534,55,132,0.417,0,0,NA,55,132,0.417,0.417,16,33,0.485,44,63,107,12,8,23,22,75,126
2007,James Singleton,PF,25,LAC,53,0,376,30,82,0.366,3,14,0.214,27,68,0.397,0.384,22,29,0.759,36,70,106,17,15,17,17,45,85
2007,Brian Skinner,PF,30,MIL,67,44,1523,124,253,0.49,0,0,NA,124,253,0.49,0.49,46,79,0.582,106,279,385,58,18,64,75,195,294
2007,J.R. Smith,SG,21,DEN,63,24,1471,284,644,0.441,149,382,0.39,135,262,0.515,0.557,102,126,0.81,30,113,143,91,49,9,85,147,819
2007,Joe Smith,PF,31,DEN,11,0,148,23,48,0.479,0,1,0,23,47,0.489,0.479,10,12,0.833,13,27,40,3,6,7,13,23,56
2007,Joe Smith,PF,31,PHI,54,11,1355,191,429,0.445,0,4,0,191,425,0.449,0.445,115,136,0.846,107,253,360,46,31,20,63,125,497
2007,Josh Smith,SF,21,ATL,72,72,2647,436,993,0.439,38,152,0.25,398,841,0.473,0.458,268,387,0.693,165,456,621,236,101,207,227,241,1178
2007,Eric Snow,PG,33,CLE,82,45,1929,135,324,0.417,0,4,0,135,320,0.422,0.417,72,113,0.637,35,153,188,330,55,16,111,185,342
2007,Kirk Snyder,SF,23,HOU,39,1,563,66,146,0.452,11,44,0.25,55,102,0.539,0.49,49,75,0.653,17,66,83,39,11,12,26,51,192
2007,Jerry Stackhouse,SF,32,DAL,67,8,1615,280,654,0.428,62,162,0.383,218,492,0.443,0.476,182,215,0.847,39,106,145,187,51,10,117,78,804
2007,DeShawn Stevenson,SG,25,WAS,82,82,2419,347,753,0.461,74,183,0.404,273,570,0.479,0.51,152,216,0.704,55,161,216,218,65,19,119,155,920
2007,Peja Stojaković,SF,29,NOK,13,13,425,83,196,0.423,34,84,0.405,49,112,0.438,0.51,31,38,0.816,11,43,54,11,8,4,19,29,231
2007,Damon Stoudamire,PG,33,MEM,62,51,1501,171,437,0.391,59,175,0.337,112,262,0.427,0.459,66,83,0.795,31,108,139,299,47,2,101,95,467
2007,Amar'e Stoudemire,C,24,PHO,82,78,2689,607,1055,0.575,0,3,0,607,1052,0.577,0.575,457,585,0.781,222,564,786,84,78,110,232,295,1671
2007,Stromile Swift,C,27,MEM,54,18,1029,161,346,0.465,0,5,0,161,341,0.472,0.465,97,134,0.724,85,165,250,17,30,62,69,146,419
2007,Wally Szczerbiak,SF,29,BOS,32,19,900,161,388,0.415,44,106,0.415,117,282,0.415,0.472,113,126,0.897,16,82,98,55,18,3,54,65,479
2007,Maurice Taylor,PF,30,SAC,12,2,103,8,28,0.286,0,0,NA,8,28,0.286,0.286,8,13,0.615,10,18,28,5,4,1,6,16,24
2007,Sebastian Telfair,PG,21,BOS,78,30,1578,176,474,0.371,37,128,0.289,139,346,0.402,0.41,90,110,0.818,17,91,108,218,43,11,98,166,479
2007,Kenny Thomas,PF,29,SAC,62,53,1412,146,303,0.482,0,1,0,146,302,0.483,0.482,39,76,0.513,134,243,377,76,43,16,90,141,331
2007,Kurt Thomas,C,34,PHO,67,13,1208,126,259,0.486,0,1,0,126,258,0.488,0.486,56,71,0.789,86,293,379,24,24,29,35,156,308
2007,Tim Thomas,PF,29,LAC,76,24,2054,299,723,0.414,136,356,0.382,163,367,0.444,0.508,102,144,0.708,63,315,378,171,55,28,106,228,836
2007,Tyrus Thomas,PF,20,CHI,72,4,966,134,282,0.475,0,2,0,134,280,0.479,0.475,106,175,0.606,89,180,269,40,46,76,94,162,374
2007,Jake Tsakalidis,C,27,MEM,23,7,258,20,50,0.4,0,0,NA,20,50,0.4,0.4,14,24,0.583,24,40,64,2,7,11,21,34,54
2007,Jake Tsakalidis,C,27,HOU,13,0,132,9,22,0.409,0,0,NA,9,22,0.409,0.409,12,15,0.8,18,22,40,3,1,1,3,17,30
2007,P.J. Tucker,SF,21,TOR,17,0,83,11,22,0.5,0,0,NA,11,22,0.5,0.5,8,14,0.571,11,12,23,3,2,0,6,12,30
2007,Ronny Turiaf,C,24,LAL,72,1,1087,147,268,0.549,0,1,0,147,267,0.551,0.549,89,134,0.664,88,171,259,63,17,78,52,202,383
2007,Hedo Türkoğlu,SF,27,ORL,73,73,2268,345,823,0.419,109,281,0.388,236,542,0.435,0.485,171,219,0.781,57,236,293,233,70,16,143,221,970
2007,Beno Udrih,PG,24,SAS,73,1,948,127,344,0.369,33,115,0.287,94,229,0.41,0.417,53,60,0.883,11,71,82,122,27,1,56,70,340
2007,Anderson Varejão,C,24,CLE,81,6,1932,191,401,0.476,0,9,0,191,392,0.487,0.476,165,268,0.616,191,354,545,75,76,52,67,269,547
2007,Sasha Vujačić,SG,22,LAL,73,4,935,105,268,0.392,60,161,0.373,45,107,0.421,0.504,43,49,0.878,28,79,107,64,41,1,30,103,313
2007,Dwyane Wade,SG,25,MIA,51,50,1931,472,962,0.491,21,79,0.266,451,883,0.511,0.502,432,535,0.807,51,188,239,384,107,62,216,117,1397
2007,Von Wafer,SF,21,LAC,1,0,1,0,1,0,0,1,0,0,0,NA,0,0,0,NA,0,0,0,0,0,0,0,0,0
2007,Antoine Walker,PF,30,MIA,78,15,1818,265,668,0.397,84,305,0.275,181,363,0.499,0.46,46,105,0.438,92,247,339,130,48,17,141,173,660
2007,Ben Wallace,C,32,CHI,77,77,2697,192,424,0.453,1,5,0.2,191,419,0.456,0.454,109,267,0.408,303,518,821,186,111,156,101,153,494
2007,Gerald Wallace,SF,24,CHA,72,71,2640,478,952,0.502,39,120,0.325,439,832,0.528,0.523,309,447,0.691,142,376,518,185,144,69,160,209,1304
2007,Rasheed Wallace,C,32,DET,75,72,2419,357,843,0.423,104,296,0.351,253,547,0.463,0.485,108,137,0.788,90,453,543,127,75,118,94,225,926
2007,Luke Walton,SF,26,LAL,60,60,1982,264,557,0.474,48,124,0.387,216,433,0.499,0.517,108,145,0.745,87,215,302,257,60,21,118,117,684
2007,Hakim Warrick,PF,24,MEM,82,43,2152,373,712,0.524,0,8,0,373,704,0.53,0.524,299,388,0.771,130,290,420,75,43,30,161,232,1045
2007,Earl Watson,PG,27,SEA,77,25,2152,263,687,0.383,92,280,0.329,171,407,0.42,0.45,108,147,0.735,34,151,185,437,99,23,167,152,726
2007,Chris Webber,PF,33,PHI,18,18,544,89,230,0.387,2,5,0.4,87,225,0.387,0.391,18,28,0.643,37,112,149,61,18,15,33,36,198
2007,Chris Webber,PF,33,DET,43,42,1277,200,409,0.489,2,6,0.333,198,403,0.491,0.491,84,132,0.636,87,201,288,127,42,26,74,107,486
2007,Bonzi Wells,SF,30,HOU,28,1,590,85,207,0.411,1,7,0.143,84,200,0.42,0.413,46,82,0.561,26,94,120,31,24,13,57,62,217
2007,David Wesley,SG,36,CLE,35,5,352,22,75,0.293,9,38,0.237,13,37,0.351,0.353,20,28,0.714,3,32,35,37,12,4,17,32,73
2007,Delonte West,SG,23,BOS,69,47,2219,306,717,0.427,65,178,0.365,241,539,0.447,0.472,168,197,0.853,32,176,208,304,74,34,140,152,845
2007,Chris Wilcox,PF,24,SEA,82,81,2586,433,819,0.529,0,6,0,433,813,0.533,0.529,240,351,0.684,178,451,629,82,70,38,127,248,1106
2007,Mike Wilks,PG,27,SEA,47,4,534,66,141,0.468,5,15,0.333,61,126,0.484,0.486,33,42,0.786,15,39,54,79,15,4,31,53,170
2007,Aaron Williams,PF,35,LAC,38,7,374,29,53,0.547,0,1,0,29,52,0.558,0.547,18,22,0.818,27,58,85,7,7,14,18,56,76
2007,Alvin Williams,PG,32,LAC,2,0,10,0,2,0,0,1,0,0,1,0,0,2,4,0.5,1,0,1,3,2,0,3,0,2
2007,Deron Williams,PG,22,UTA,80,80,2950,494,1083,0.456,82,255,0.322,412,828,0.498,0.494,227,296,0.767,41,226,267,745,78,13,246,254,1297
2007,Eric Williams,SF,34,SAS,16,0,88,15,34,0.441,8,17,0.471,7,17,0.412,0.559,4,7,0.571,1,13,14,6,2,0,5,6,42
2007,Eric Williams,SF,34,CHA,5,0,33,4,13,0.308,0,2,0,4,11,0.364,0.308,4,7,0.571,2,1,3,1,1,0,2,6,12
2007,Jason Williams,PG,31,MIA,61,55,1865,235,569,0.413,100,295,0.339,135,274,0.493,0.501,94,103,0.913,18,123,141,322,58,1,100,68,664
2007,Justin Williams,C,22,SAC,26,1,333,54,88,0.614,0,1,0,54,87,0.621,0.614,23,63,0.365,51,64,115,2,5,16,15,51,131
2007,Lou Williams,PG,20,PHI,61,0,688,93,211,0.441,12,37,0.324,81,174,0.466,0.469,64,92,0.696,17,53,70,110,22,1,46,42,262
2007,Marcus Williams,PG,21,NJN,79,2,1315,208,526,0.395,46,163,0.282,162,363,0.446,0.439,72,85,0.847,29,134,163,260,29,2,142,96,534
2007,Marvin Williams,PF,20,ATL,64,63,2179,306,706,0.433,11,45,0.244,295,661,0.446,0.441,216,265,0.815,84,253,337,121,52,30,127,191,839
2007,Mo Williams,PG,24,MIL,68,68,2472,468,1049,0.446,79,228,0.346,389,821,0.474,0.484,159,186,0.855,54,275,329,416,85,6,203,201,1174
2007,Shammond Williams,PG,31,LAL,30,0,345,35,86,0.407,20,50,0.4,15,36,0.417,0.523,4,6,0.667,11,29,40,31,12,0,13,20,94
2007,Shawne Williams,SG,20,IND,46,3,556,75,160,0.469,19,52,0.365,56,108,0.519,0.528,11,20,0.55,33,50,83,22,6,8,24,69,180
2007,Shelden Williams,PF,23,ATL,81,31,1514,166,365,0.455,2,4,0.5,164,361,0.454,0.458,110,144,0.764,131,304,435,44,52,39,96,199,444
2007,Corliss Williamson,PF,33,SAC,68,1,1337,236,463,0.51,0,2,0,236,461,0.512,0.51,148,207,0.715,63,158,221,39,29,15,97,183,620
2007,Kevin Willis,PF,44,DAL,5,0,43,5,13,0.385,0,0,NA,5,13,0.385,0.385,2,2,1,2,6,8,1,2,1,2,11,12
2007,Metta World Peace,SF,27,SAC,70,65,2641,458,1040,0.44,93,260,0.358,365,780,0.468,0.485,307,415,0.74,102,352,454,235,149,43,146,205,1316
2007,Antoine Wright,SG,22,NJN,63,23,1137,110,251,0.438,19,59,0.322,91,192,0.474,0.476,44,73,0.603,38,137,175,55,30,10,43,120,283
2007,Lorenzen Wright,C,31,ATL,67,31,1035,82,183,0.448,0,0,NA,82,183,0.448,0.448,9,32,0.281,85,131,216,40,28,28,39,204,173
2008,Shareef Abdur-Rahim,PF,31,SAC,6,0,51,3,14,0.214,0,0,NA,3,14,0.214,0.214,4,4,1,6,4,10,4,1,0,1,9,10
2008,Arron Afflalo,SG,22,DET,75,9,970,99,241,0.411,10,48,0.208,89,193,0.461,0.432,68,87,0.782,36,101,137,52,31,8,34,83,276
2008,Maurice Ager,SG,23,DAL,12,3,77,5,27,0.185,0,8,0,5,19,0.263,0.185,5,6,0.833,1,3,4,4,0,1,3,11,15
2008,Maurice Ager,SG,23,NJN,14,0,88,16,38,0.421,3,11,0.273,13,27,0.481,0.461,1,6,0.167,3,6,9,4,0,0,3,6,36
2008,LaMarcus Aldridge,PF,22,POR,76,76,2649,561,1160,0.484,1,7,0.143,560,1153,0.486,0.484,227,298,0.762,220,358,578,122,55,94,126,240,1350
2008,Malik Allen,PF,29,NJN,48,12,763,124,261,0.475,1,2,0.5,123,259,0.475,0.477,12,13,0.923,42,86,128,29,15,21,32,89,261
2008,Malik Allen,PF,29,DAL,25,4,333,33,66,0.5,0,0,NA,33,66,0.5,0.5,11,12,0.917,24,44,68,15,4,10,13,60,77
2008,Ray Allen,SG,32,BOS,73,73,2624,439,986,0.445,180,452,0.398,259,534,0.485,0.537,215,237,0.907,75,193,268,225,65,16,127,147,1273
2008,Rafer Alston,PG,31,HOU,74,74,2526,364,924,0.394,143,407,0.351,221,517,0.427,0.471,98,137,0.715,28,232,260,392,98,18,160,139,969
2008,Lou Amundson,PF,25,PHI,16,0,64,8,16,0.5,0,0,NA,8,16,0.5,0.5,2,7,0.286,7,5,12,0,1,1,2,13,18
2008,Chris Andersen,C,29,NOH,5,0,34,2,7,0.286,0,0,NA,2,7,0.286,0.286,2,4,0.5,2,7,9,0,0,4,1,6,6
2008,Derek Anderson,SG,33,CHA,28,0,396,47,125,0.376,19,52,0.365,28,73,0.384,0.452,28,38,0.737,9,43,52,44,12,1,25,49,141
2008,Carmelo Anthony,SF,23,DEN,77,77,2806,728,1481,0.492,58,164,0.354,670,1317,0.509,0.511,464,590,0.786,178,393,571,259,98,39,253,253,1978
2008,Joel Anthony,PF,25,MIA,24,1,498,28,60,0.467,0,0,NA,28,60,0.467,0.467,29,49,0.592,38,55,93,3,9,31,17,55,85
2008,Gilbert Arenas,PG,26,WAS,13,8,425,78,196,0.398,22,78,0.282,56,118,0.475,0.454,74,96,0.771,6,45,51,66,23,1,49,30,252
2008,Trevor Ariza,SF,22,ORL,11,0,115,14,31,0.452,0,3,0,14,28,0.5,0.452,8,15,0.533,5,19,24,8,5,3,5,9,36
2008,Trevor Ariza,SF,22,LAL,24,3,431,55,105,0.524,5,15,0.333,50,90,0.556,0.548,41,60,0.683,25,59,84,36,26,8,18,36,156
2008,Darrell Armstrong,PG,39,NJN,50,2,549,40,110,0.364,23,69,0.333,17,41,0.415,0.468,20,30,0.667,17,50,67,73,28,2,41,53,123
2008,Hilton Armstrong,C,23,NOH,65,3,732,67,148,0.453,0,0,NA,67,148,0.453,0.453,44,70,0.629,65,98,163,23,15,34,59,130,178
2008,Carlos Arroyo,PG,28,ORL,62,20,1269,157,348,0.451,29,84,0.345,128,264,0.485,0.493,87,102,0.853,10,103,113,219,26,2,77,85,430
2008,Chucky Atkins,SG,33,DEN,24,0,352,42,122,0.344,25,79,0.316,17,43,0.395,0.447,4,9,0.444,3,28,31,47,9,1,10,27,113
2008,Renaldo Balkman,SF,23,NYK,65,0,952,91,186,0.489,1,12,0.083,90,174,0.517,0.492,41,95,0.432,83,133,216,40,44,30,37,132,224
2008,Marcus Banks,PG,26,PHO,24,1,310,44,109,0.404,25,65,0.385,19,44,0.432,0.518,12,16,0.75,3,17,20,25,8,8,16,38,125
2008,Marcus Banks,PG,26,MIA,12,2,259,42,82,0.512,15,37,0.405,27,45,0.6,0.604,15,19,0.789,1,24,25,36,6,5,21,27,114
2008,Leandro Barbosa,SG,25,PHO,82,12,2421,472,1021,0.462,164,422,0.389,308,599,0.514,0.543,175,213,0.822,40,191,231,216,75,18,117,195,1283
2008,Matt Barnes,PF,27,GSW,73,18,1414,187,442,0.423,53,181,0.293,134,261,0.513,0.483,59,79,0.747,94,230,324,139,48,36,85,159,486
2008,Andre Barrett,PG,25,LAC,4,0,25,2,5,0.4,1,3,0.333,1,2,0.5,0.5,1,2,0.5,0,1,1,7,0,0,1,1,6
2008,Earl Barron,C,26,MIA,46,15,889,132,327,0.404,1,13,0.077,131,314,0.417,0.405,61,87,0.701,67,131,198,29,19,8,48,114,326
2008,Brent Barry,SF,36,SAS,31,1,554,77,160,0.481,48,112,0.429,29,48,0.604,0.631,19,20,0.95,12,43,55,54,17,3,18,43,221
2008,Shane Battier,SF,29,HOU,80,78,2907,265,619,0.428,139,369,0.377,126,250,0.504,0.54,75,101,0.743,131,276,407,155,77,90,78,196,744
2008,Marco Belinelli,SG,21,GSW,33,0,241,36,93,0.387,16,41,0.39,20,52,0.385,0.473,7,9,0.778,3,11,14,15,5,0,12,15,95
2008,Charlie Bell,SG,28,MIL,68,5,1628,185,486,0.381,74,217,0.341,111,269,0.413,0.457,70,87,0.805,31,136,167,210,52,2,76,121,514
2008,Raja Bell,SG,31,PHO,75,75,2646,317,753,0.421,176,439,0.401,141,314,0.449,0.538,79,91,0.868,47,227,274,168,54,27,65,220,889
2008,Mike Bibby,PG,29,SAC,15,12,473,78,192,0.406,24,61,0.393,54,131,0.412,0.469,23,31,0.742,11,45,56,75,19,2,38,34,203
2008,Mike Bibby,PG,29,ATL,33,32,1100,170,411,0.414,69,187,0.369,101,224,0.451,0.498,55,69,0.797,5,99,104,215,35,2,81,63,464
2008,Chauncey Billups,PG,31,DET,78,78,2522,393,877,0.448,137,342,0.401,256,535,0.479,0.526,401,437,0.918,42,170,212,529,101,17,160,130,1324
2008,Steve Blake,PG,27,POR,81,78,2424,261,640,0.408,121,298,0.406,140,342,0.409,0.502,49,64,0.766,31,164,195,413,55,4,113,133,692
2008,Mark Blount,C,32,MIA,69,46,1542,238,515,0.462,17,44,0.386,221,471,0.469,0.479,88,138,0.638,69,194,263,41,33,34,70,133,581
2008,Keith Bogans,SG,27,ORL,82,35,2198,241,588,0.41,148,409,0.362,93,179,0.52,0.536,81,110,0.736,42,224,266,104,59,10,53,164,711
2008,Andrew Bogut,C,23,MIL,78,78,2720,465,910,0.511,0,7,0,465,903,0.515,0.511,189,322,0.587,245,518,763,199,64,135,172,254,1119
2008,Calvin Booth,C,31,PHI,31,0,204,9,27,0.333,0,0,NA,9,27,0.333,0.333,6,10,0.6,6,32,38,8,6,18,4,35,24
2008,Bruce Bowen,SF,36,SAS,81,81,2448,174,428,0.407,90,215,0.419,84,213,0.394,0.512,45,69,0.652,33,201,234,91,54,22,46,177,483
2008,Earl Boykins,PG,31,CHA,36,0,577,61,172,0.355,14,44,0.318,47,128,0.367,0.395,49,59,0.831,9,25,34,96,13,0,41,21,185
2008,Corey Brewer,SF,21,MIN,79,35,1803,182,486,0.374,7,36,0.194,175,450,0.389,0.382,88,110,0.8,82,210,292,111,76,25,89,188,459
2008,Ronnie Brewer,SG,22,UTA,76,76,2088,354,634,0.558,11,50,0.22,343,584,0.587,0.567,195,257,0.759,97,121,218,134,129,19,69,110,914
2008,Primož Brezec,C,28,CHA,20,18,267,17,43,0.395,0,0,NA,17,43,0.395,0.395,3,5,0.6,14,30,44,6,0,3,15,35,37
2008,Primož Brezec,C,28,DET,17,0,98,10,13,0.769,0,0,NA,10,13,0.769,0.769,7,14,0.5,7,12,19,4,2,2,5,23,27
2008,Primož Brezec,C,28,TOR,13,0,110,17,38,0.447,0,0,NA,17,38,0.447,0.447,14,21,0.667,9,9,18,1,1,2,4,25,48
2008,Aaron Brooks,PG,23,HOU,51,0,608,93,225,0.413,36,109,0.33,57,116,0.491,0.493,42,49,0.857,13,43,56,87,13,5,44,69,264
2008,Devin Brown,SG,29,CLE,78,20,1762,217,531,0.409,45,146,0.308,172,385,0.447,0.451,107,142,0.754,65,198,263,175,52,7,99,144,586
2008,Kwame Brown,C,25,LAL,23,14,509,53,103,0.515,0,0,NA,53,103,0.515,0.515,26,64,0.406,31,100,131,28,16,19,37,58,132
2008,Kwame Brown,C,25,MEM,15,1,204,19,39,0.487,0,0,NA,19,39,0.487,0.487,14,34,0.412,20,37,57,17,6,4,14,24,52
2008,Shannon Brown,SG,22,CLE,15,4,218,41,111,0.369,9,29,0.31,32,82,0.39,0.41,14,23,0.609,5,13,18,17,10,1,19,27,105
2008,Shannon Brown,SG,22,CHI,6,0,22,3,15,0.2,0,1,0,3,14,0.214,0.2,3,6,0.5,1,1,2,0,1,2,5,2,9
2008,Caron Butler,SF,27,WAS,58,58,2314,439,943,0.466,66,185,0.357,373,758,0.492,0.501,236,262,0.901,93,295,388,284,128,20,150,160,1180
2008,Rasual Butler,SF,28,NOH,51,8,875,91,260,0.35,44,133,0.331,47,127,0.37,0.435,26,31,0.839,16,84,100,36,15,21,10,66,252
2008,Andrew Bynum,C,20,LAL,35,25,1008,189,297,0.636,0,0,NA,189,297,0.636,0.636,82,118,0.695,105,251,356,61,12,72,52,98,460
2008,José Calderón,PG,26,TOR,82,56,2484,367,707,0.519,79,184,0.429,288,523,0.551,0.575,109,120,0.908,34,202,236,678,87,6,126,134,922
2008,Marcus Camby,C,33,DEN,79,79,2758,286,635,0.45,6,20,0.3,280,615,0.455,0.455,143,202,0.708,230,807,1037,259,85,285,118,216,721
2008,Rodney Carney,SF,23,PHI,70,6,1039,158,392,0.403,38,120,0.317,120,272,0.441,0.452,55,81,0.679,50,99,149,32,39,23,34,96,409
2008,Matt Carroll,SG,27,CHA,80,18,2016,252,589,0.428,105,241,0.436,147,348,0.422,0.517,111,138,0.804,33,193,226,73,46,19,58,187,720
2008,Anthony Carter,PG,32,DEN,70,67,1960,218,476,0.458,45,129,0.349,173,347,0.499,0.505,64,85,0.753,27,173,200,388,107,28,124,172,545
2008,Vince Carter,SG,31,NJN,76,72,2959,587,1287,0.456,98,273,0.359,489,1014,0.482,0.494,350,429,0.816,112,341,453,389,93,33,181,241,1622
2008,Sam Cassell,PG,38,LAC,38,33,975,183,402,0.455,14,54,0.259,169,348,0.486,0.473,106,119,0.891,12,93,105,179,28,3,78,69,486
2008,Sam Cassell,PG,38,BOS,17,1,299,50,130,0.385,9,22,0.409,41,108,0.38,0.419,21,25,0.84,5,26,31,35,9,3,19,29,130
2008,Tyson Chandler,C,25,NOH,79,79,2783,377,605,0.623,0,1,0,377,604,0.624,0.623,175,295,0.593,322,606,928,81,45,84,136,243,929
2008,Wilson Chandler,SF,20,NYK,35,16,685,106,242,0.438,9,30,0.3,97,212,0.458,0.457,34,54,0.63,38,89,127,33,15,16,27,83,255
2008,Jarron Collins,C,29,UTA,70,9,702,36,82,0.439,0,1,0,36,81,0.444,0.439,46,74,0.622,40,76,116,37,10,6,22,106,118
2008,Jason Collins,C,29,NJN,43,23,684,23,54,0.426,0,0,NA,23,54,0.426,0.426,14,36,0.389,35,54,89,19,11,8,23,110,60
2008,Jason Collins,C,29,MEM,31,3,488,30,59,0.508,0,1,0,30,58,0.517,0.508,20,38,0.526,29,60,89,6,12,17,25,84,80
2008,Mardy Collins,SG,23,NYK,46,8,634,57,175,0.326,8,32,0.25,49,143,0.343,0.349,23,38,0.605,19,56,75,89,24,8,56,56,145
2008,Brian Cook,PF,27,LAL,6,2,70,4,21,0.19,2,10,0.2,2,11,0.182,0.238,4,4,1,4,6,10,3,2,0,4,6,14
2008,Brian Cook,PF,27,ORL,45,0,559,84,213,0.394,41,105,0.39,43,108,0.398,0.491,15,17,0.882,24,75,99,24,11,12,35,87,224
2008,Daequan Cook,SG,20,MIA,59,19,1441,196,514,0.381,79,238,0.332,117,276,0.424,0.458,47,57,0.825,20,157,177,75,23,9,63,157,518
2008,Jamal Crawford,SG,27,NYK,80,80,3190,570,1391,0.41,176,494,0.356,394,897,0.439,0.473,329,381,0.864,37,170,207,398,81,17,192,144,1645
2008,Javaris Crittenton,SG,20,LAL,22,0,171,26,53,0.491,1,3,0.333,25,50,0.5,0.5,19,28,0.679,7,14,21,18,7,0,22,12,72
2008,Javaris Crittenton,SG,20,MEM,28,0,508,72,180,0.4,9,34,0.265,63,146,0.432,0.425,53,76,0.697,20,69,89,33,12,2,33,35,206
2008,Austin Croshere,PF,32,GSW,44,0,457,61,137,0.445,22,61,0.361,39,76,0.513,0.526,29,32,0.906,33,71,104,30,8,6,22,60,173
2008,Antonio Daniels,PG,32,WAS,71,63,2161,205,447,0.459,17,74,0.23,188,373,0.504,0.478,170,219,0.776,23,180,203,340,69,2,91,78,597
2008,Baron Davis,PG,28,GSW,82,82,3196,650,1526,0.426,173,525,0.33,477,1001,0.477,0.483,318,424,0.75,96,289,385,623,191,43,232,247,1791
2008,Glen Davis,C,22,BOS,69,1,940,107,221,0.484,0,0,NA,107,221,0.484,0.484,99,150,0.66,95,113,208,28,31,20,65,160,313
2008,Ricky Davis,SF,28,MIA,82,47,2963,420,971,0.433,135,333,0.405,285,638,0.447,0.502,155,197,0.787,55,298,353,276,87,14,191,187,1130
2008,Luol Deng,SF,22,CHI,63,59,2128,429,896,0.479,8,22,0.364,421,874,0.482,0.483,204,265,0.77,136,258,394,155,57,29,120,117,1070
2008,Boris Diaw,PF,25,PHO,82,19,2308,308,646,0.477,13,41,0.317,295,605,0.488,0.487,96,129,0.744,97,281,378,317,61,39,155,166,725
2008,Dan Dickau,PG,29,LAC,67,8,1040,124,296,0.419,36,108,0.333,88,188,0.468,0.48,68,82,0.829,13,84,97,172,32,3,55,108,352
2008,Travis Diener,PG,25,IND,66,21,1356,159,430,0.37,74,233,0.318,85,197,0.431,0.456,64,71,0.901,26,89,115,251,35,4,55,107,456
2008,Ike Diogu,PF,24,IND,30,1,305,64,134,0.478,0,0,NA,64,134,0.478,0.478,40,47,0.851,38,47,85,10,7,3,20,43,168
2008,DeSagana Diop,C,26,DAL,52,18,894,67,115,0.583,0,0,NA,67,115,0.583,0.583,24,40,0.6,111,159,270,26,20,63,42,100,158
2008,DeSagana Diop,C,26,NJN,27,5,401,27,65,0.415,0,0,NA,27,65,0.415,0.415,14,30,0.467,49,73,122,14,6,25,16,46,68
2008,Juan Dixon,PG,29,TOR,36,0,424,59,160,0.369,17,39,0.436,42,121,0.347,0.422,18,19,0.947,9,38,47,65,21,2,35,38,153
2008,Juan Dixon,PG,29,DET,17,0,244,47,98,0.48,13,33,0.394,34,65,0.523,0.546,3,7,0.429,6,22,28,32,0,0,19,24,110
2008,Michael Doleac,C,30,MIN,24,8,257,28,63,0.444,0,0,NA,28,63,0.444,0.444,1,2,0.5,16,33,49,7,10,10,12,44,57
2008,Quincy Douby,PG,23,SAC,74,0,876,132,335,0.394,42,122,0.344,90,213,0.423,0.457,48,52,0.923,17,66,83,53,30,12,59,80,354
2008,Jared Dudley,PF,22,CHA,73,14,1384,163,348,0.468,9,41,0.22,154,307,0.502,0.481,87,118,0.737,121,165,286,81,55,10,50,128,422
2008,Mike Dunleavy,SG,27,IND,82,82,2953,532,1117,0.476,165,389,0.424,367,728,0.504,0.55,336,403,0.834,59,365,424,288,86,31,190,208,1565
2008,Ronald Dupree,SF,27,DET,1,0,3,0,0,NA,0,0,NA,0,0,NA,NA,0,0,NA,0,0,0,0,0,0,0,0,0
2008,Ronald Dupree,SF,27,SEA,4,0,18,1,3,0.333,0,0,NA,1,3,0.333,0.333,2,2,1,1,7,8,1,1,0,0,0,4
2008,Monta Ellis,SG,22,GSW,81,72,3071,652,1227,0.531,12,52,0.231,640,1175,0.545,0.536,320,417,0.767,133,271,404,315,124,27,173,195,1636
2008,Francisco Elson,C,31,SAS,41,3,534,62,148,0.419,0,0,NA,62,148,0.419,0.419,20,24,0.833,33,102,135,16,9,14,30,62,144
2008,Francisco Elson,C,31,SEA,22,2,279,30,88,0.341,0,1,0,30,87,0.345,0.341,6,13,0.462,17,48,65,8,6,6,17,34,66
2008,Melvin Ely,C,29,NOH,52,1,621,85,180,0.472,0,0,NA,85,180,0.472,0.472,32,58,0.552,28,117,145,22,7,18,42,79,202
2008,Maurice Evans,SG,29,LAL,7,0,96,9,28,0.321,1,7,0.143,8,21,0.381,0.339,12,15,0.8,4,5,9,12,5,1,0,10,31
2008,Maurice Evans,SG,29,ORL,68,47,1624,253,517,0.489,80,202,0.396,173,315,0.549,0.567,47,68,0.691,88,121,209,69,41,9,40,132,633
2008,Reggie Evans,PF,27,PHI,81,61,1879,152,346,0.439,1,1,1,151,345,0.438,0.441,120,257,0.467,224,387,611,65,86,8,108,213,425
2008,Nick Fazekas,PF,22,DAL,4,0,9,2,5,0.4,0,0,NA,2,5,0.4,0.4,0,0,NA,1,2,3,0,0,0,0,0,4
2008,Nick Fazekas,PF,22,LAC,22,0,260,44,77,0.571,0,2,0,44,75,0.587,0.571,15,22,0.682,33,53,86,11,8,11,13,25,103
2008,Raymond Felton,PG,23,CHA,79,79,2972,412,997,0.413,56,200,0.28,356,797,0.447,0.441,260,325,0.8,37,199,236,583,96,12,213,184,1140
2008,Michael Finley,SG,34,SAS,82,61,2204,315,761,0.414,132,357,0.37,183,404,0.453,0.501,64,80,0.8,27,227,254,114,29,10,56,93,826
2008,Derek Fisher,PG,33,LAL,82,82,2249,339,777,0.436,112,276,0.406,227,501,0.453,0.508,166,188,0.883,24,146,170,239,86,3,90,188,956
2008,Randy Foye,PG,24,MIN,39,31,1259,198,462,0.429,61,148,0.412,137,314,0.436,0.495,53,65,0.815,13,115,128,164,36,3,79,102,510
2008,Adonal Foyle,C,32,ORL,82,0,774,70,153,0.458,0,0,NA,70,153,0.458,0.458,16,34,0.471,71,137,208,18,16,45,32,94,156
2008,Richie Frahm,SG,30,LAC,10,2,163,20,54,0.37,7,25,0.28,13,29,0.448,0.435,0,2,0,4,10,14,8,2,0,6,7,47
2008,Steve Francis,PG,30,HOU,10,3,199,19,57,0.333,4,17,0.235,15,40,0.375,0.368,13,23,0.565,8,15,23,30,9,5,14,25,55
2008,Channing Frye,C,24,POR,78,20,1342,221,453,0.488,3,10,0.3,218,443,0.492,0.491,85,109,0.78,107,247,354,57,29,27,55,208,530
2008,Dan Gadzuric,C,29,MIL,51,4,534,64,154,0.416,0,1,0,64,153,0.418,0.416,33,63,0.524,67,77,144,11,20,24,34,83,161
2008,Francisco García,SF,26,SAC,79,20,2096,348,752,0.463,113,289,0.391,235,463,0.508,0.538,162,208,0.779,52,212,264,128,96,50,128,232,971
2008,Kevin Garnett,PF,31,BOS,71,71,2328,534,990,0.539,0,11,0,534,979,0.545,0.539,269,336,0.801,135,520,655,244,100,89,138,163,1337
2008,Pau Gasol,C,27,MEM,39,39,1433,279,557,0.501,4,15,0.267,275,542,0.507,0.504,176,215,0.819,94,248,342,116,16,56,80,85,738
2008,Pau Gasol,C,27,LAL,27,27,918,196,333,0.589,0,1,0,196,332,0.59,0.589,116,147,0.789,61,150,211,95,14,42,44,54,508
2008,Rudy Gay,SF,21,MEM,81,81,3000,625,1355,0.461,134,387,0.346,491,968,0.507,0.511,248,316,0.785,140,359,499,158,111,79,190,230,1632
2008,Eddie Gill,PG,29,NJN,13,1,149,12,29,0.414,5,14,0.357,7,15,0.467,0.5,9,9,1,1,21,22,21,7,2,8,18,38
2008,Eddie Gill,PG,29,SEA,1,0,5,0,2,0,0,1,0,0,1,0,0,0,0,NA,0,0,0,1,0,0,1,0,0
2008,Gordan Giriček,SG,30,UTA,22,0,279,41,102,0.402,12,34,0.353,29,68,0.426,0.461,1,1,1,6,25,31,16,13,1,21,24,95
2008,Gordan Giriček,SG,30,PHI,12,0,110,13,41,0.317,5,15,0.333,8,26,0.308,0.378,6,8,0.75,1,13,14,11,3,1,8,9,37
2008,Gordan Giriček,SG,30,PHO,22,0,442,79,159,0.497,19,50,0.38,60,109,0.55,0.557,16,17,0.941,9,42,51,35,8,2,23,49,193
2008,Drew Gooden,PF,26,CLE,51,51,1564,232,523,0.444,0,3,0,232,520,0.446,0.444,110,151,0.728,117,306,423,50,35,30,91,144,574
2008,Drew Gooden,PF,26,CHI,18,14,558,100,217,0.461,0,3,0,100,214,0.467,0.461,52,64,0.813,58,109,167,31,13,23,31,59,252
2008,Marcin Gortat,C,23,ORL,6,0,41,8,17,0.471,0,0,NA,8,17,0.471,0.471,2,3,0.667,8,8,16,2,1,1,2,4,18
2008,Stephen Graham,SF,25,IND,22,0,128,34,58,0.586,7,14,0.5,27,44,0.614,0.647,12,16,0.75,4,18,22,9,4,1,10,14,87
2008,Danny Granger,SF,24,IND,80,80,2876,537,1205,0.446,171,423,0.404,366,782,0.468,0.517,322,378,0.852,93,393,486,166,95,84,171,290,1567
2008,Aaron Gray,C,23,CHI,61,1,613,103,204,0.505,0,1,0,103,203,0.507,0.505,56,99,0.566,70,98,168,41,21,16,57,117,262
2008,Gerald Green,SF,22,MIN,29,0,358,49,148,0.331,15,39,0.385,34,109,0.312,0.382,34,41,0.829,11,51,62,29,8,4,32,43,147
2008,Gerald Green,SF,22,HOU,1,0,4,3,3,1,0,0,NA,3,3,1,1,0,0,NA,2,0,2,0,0,0,0,2,6
2008,Jeff Green,SF,21,SEA,80,52,2253,320,749,0.427,21,76,0.276,299,673,0.444,0.441,177,238,0.744,101,278,379,119,46,49,158,198,838
2008,Taurean Green,PG,21,POR,8,0,44,4,16,0.25,1,8,0.125,3,8,0.375,0.281,8,8,1,0,4,4,8,1,0,7,3,17
2008,Taurean Green,SG,21,DEN,9,0,30,3,9,0.333,1,3,0.333,2,6,0.333,0.389,3,4,0.75,0,6,6,3,1,0,2,2,10
2008,Adrian Griffin,SG,33,CHI,22,2,222,24,60,0.4,0,0,NA,24,60,0.4,0.4,3,7,0.429,19,18,37,22,12,1,16,19,51
2008,Adrian Griffin,SF,33,SEA,13,0,85,6,16,0.375,0,0,NA,6,16,0.375,0.375,2,2,1,9,13,22,5,5,1,5,8,14
2008,Anfernee Hardaway,SF,36,MIA,16,8,325,22,60,0.367,8,19,0.421,14,41,0.341,0.433,8,9,0.889,3,32,35,35,19,1,13,24,60
2008,Al Harrington,C,27,GSW,81,59,2190,401,923,0.434,153,408,0.375,248,515,0.482,0.517,147,190,0.774,107,332,439,132,74,16,90,266,1102
2008,Othella Harrington,C,34,CHA,22,0,166,18,42,0.429,0,0,NA,18,42,0.429,0.429,10,16,0.625,11,31,42,4,1,4,11,34,46
2008,Devin Harris,PG,24,DAL,39,39,1184,187,387,0.483,25,70,0.357,162,317,0.511,0.516,161,196,0.821,17,74,91,206,56,2,93,127,560
2008,Devin Harris,PG,24,NJN,25,22,838,134,306,0.438,31,97,0.32,103,209,0.493,0.489,87,105,0.829,11,71,82,163,34,8,68,63,386
2008,Mike Harris,PF,24,HOU,17,0,159,27,54,0.5,0,2,0,27,52,0.519,0.5,8,13,0.615,24,30,54,3,6,3,9,16,62
2008,Jason Hart,PG,29,UTA,57,0,606,58,180,0.322,11,31,0.355,47,149,0.315,0.353,38,45,0.844,5,50,55,86,30,3,28,75,165
2008,Trenton Hassell,SG,28,DAL,37,6,463,37,80,0.463,1,4,0.25,36,76,0.474,0.469,1,2,0.5,11,33,44,26,9,1,14,55,76
2008,Trenton Hassell,SG,28,NJN,26,0,310,20,55,0.364,1,5,0.2,19,50,0.38,0.373,6,8,0.75,9,30,39,15,4,2,8,35,47
2008,Spencer Hawes,C,19,SAC,71,8,931,146,318,0.459,4,21,0.19,142,297,0.478,0.465,38,58,0.655,68,162,230,44,14,40,56,128,334
2008,Chuck Hayes,PF,24,HOU,79,44,1575,113,221,0.511,0,3,0,113,218,0.518,0.511,11,24,0.458,132,295,427,91,85,43,62,212,237
2008,Brendan Haywood,C,28,WAS,80,80,2228,316,599,0.528,0,0,NA,316,599,0.528,0.528,216,294,0.735,273,303,576,71,31,133,108,216,848
2008,Luther Head,SG,25,HOU,73,17,1379,206,477,0.432,79,225,0.351,127,252,0.504,0.515,66,81,0.815,18,117,135,138,44,9,70,75,557
2008,Walter Herrmann,PF,28,CHA,17,0,174,25,65,0.385,9,26,0.346,16,39,0.41,0.454,9,10,0.9,10,26,36,4,4,0,4,12,68
2008,Walter Herrmann,PF,28,DET,28,0,199,31,79,0.392,11,38,0.289,20,41,0.488,0.462,12,15,0.8,12,25,37,14,3,1,8,12,85
2008,Nenê,PF,25,DEN,16,1,266,29,71,0.408,0,1,0,29,70,0.414,0.408,27,49,0.551,30,57,87,15,9,14,21,46,85
2008,Kirk Hinrich,PG,27,CHI,75,72,2380,330,797,0.414,84,240,0.35,246,557,0.442,0.467,118,142,0.831,28,216,244,452,87,19,157,224,862
2008,Ryan Hollins,PF,23,CHA,60,1,532,46,94,0.489,0,0,NA,46,94,0.489,0.489,55,82,0.671,53,54,107,14,10,30,25,96,147
2008,Robert Horry,PF,37,SAS,45,5,583,38,119,0.319,18,70,0.257,20,49,0.408,0.395,18,28,0.643,35,74,109,47,21,19,22,55,112
2008,Eddie House,PG,29,BOS,78,2,1480,217,531,0.409,117,298,0.393,100,233,0.429,0.519,33,36,0.917,19,148,167,152,59,10,76,114,584
2008,Josh Howard,SF,27,DAL,76,76,2757,567,1247,0.455,67,210,0.319,500,1037,0.482,0.482,312,384,0.813,120,412,532,164,59,32,114,202,1513
2008,Juwan Howard,PF,34,DAL,50,0,353,23,64,0.359,0,0,NA,23,64,0.359,0.359,11,14,0.786,21,60,81,17,5,2,17,62,57
2008,Larry Hughes,PG,29,CLE,40,32,1210,180,478,0.377,43,126,0.341,137,352,0.389,0.422,88,108,0.815,27,116,143,94,60,11,72,91,491
2008,Larry Hughes,SG,29,CHI,28,25,810,125,323,0.387,24,68,0.353,101,255,0.396,0.424,62,80,0.775,12,75,87,87,39,6,44,48,336
2008,Kris Humphries,PF,22,TOR,70,0,925,161,333,0.483,0,2,0,161,331,0.486,0.483,75,124,0.605,90,169,259,28,25,28,47,107,397
2008,D.J. Mbenga,C,27,GSW,16,0,130,9,23,0.391,0,0,NA,9,23,0.391,0.391,1,2,0.5,13,18,31,4,3,10,4,32,19
2008,D.J. Mbenga,C,27,LAL,26,0,196,30,61,0.492,0,0,NA,30,61,0.492,0.492,4,10,0.4,15,26,41,6,4,16,8,38,64
2008,Allen Iverson,SG,32,DEN,82,82,3424,712,1556,0.458,95,275,0.345,617,1281,0.482,0.488,645,797,0.809,47,196,243,586,160,12,245,109,2164
2008,Royal Ivey,PG,26,MIL,75,20,1437,149,378,0.394,35,107,0.327,114,271,0.421,0.44,85,117,0.726,38,80,118,160,45,7,75,166,418
2008,Jarrett Jack,SG,24,POR,82,16,2229,267,620,0.431,65,190,0.342,202,430,0.47,0.483,215,248,0.867,31,203,234,313,61,1,178,129,814
2008,Bobby Jackson,SG,34,NOH,46,0,891,116,296,0.392,53,144,0.368,63,152,0.414,0.481,40,49,0.816,23,87,110,76,32,3,31,59,325
2008,Bobby Jackson,PG,34,HOU,26,5,498,88,210,0.419,28,82,0.341,60,128,0.469,0.486,24,32,0.75,10,61,71,63,13,2,28,37,228
2008,Luke Jackson,SF,26,MIA,14,1,228,26,80,0.325,11,30,0.367,15,50,0.3,0.394,16,23,0.696,7,26,33,17,8,0,9,22,79
2008,Stephen Jackson,SF,29,GSW,73,73,2855,488,1204,0.405,182,501,0.363,306,703,0.435,0.481,308,370,0.832,67,251,318,300,92,29,197,171,1466
2008,Casey Jacobsen,SG,26,MEM,53,0,547,39,115,0.339,16,72,0.222,23,43,0.535,0.409,13,17,0.765,12,53,65,20,5,1,16,34,107
2008,Mike James,PG,32,HOU,33,1,537,79,226,0.35,24,74,0.324,55,152,0.362,0.403,33,42,0.786,11,41,52,54,17,2,29,44,215
2008,Mike James,PG,32,NOH,21,0,183,22,64,0.344,7,23,0.304,15,41,0.366,0.398,6,6,1,3,14,17,6,4,0,7,12,57
2008,Antawn Jamison,PF,31,WAS,79,79,3061,618,1417,0.436,120,354,0.339,498,1063,0.468,0.478,333,438,0.76,215,591,806,120,106,34,113,195,1689
2008,Richard Jefferson,SF,27,NJN,82,82,3200,619,1328,0.466,77,213,0.362,542,1115,0.486,0.495,542,679,0.798,93,249,342,252,76,21,199,225,1857
2008,Jared Jeffries,SF,26,NYK,73,19,1325,108,270,0.4,4,25,0.16,104,245,0.424,0.407,49,93,0.527,118,125,243,66,36,23,64,132,269
2008,Anthony Johnson,PG,33,ATL,42,41,1121,115,267,0.431,27,63,0.429,88,204,0.431,0.481,26,32,0.813,17,81,98,202,42,8,50,86,283
2008,Anthony Johnson,PG,33,SAC,27,11,410,40,88,0.455,15,30,0.5,25,58,0.431,0.54,9,11,0.818,5,34,39,60,10,1,34,29,104
2008,Joe Johnson,SG,26,ATL,82,82,3343,647,1497,0.432,169,444,0.381,478,1053,0.454,0.489,316,379,0.834,83,284,367,474,84,18,223,168,1779
2008,Linton Johnson,PF,27,PHO,6,0,53,7,14,0.5,1,2,0.5,6,12,0.5,0.536,0,0,NA,5,8,13,3,0,1,2,10,15
2008,Linton Johnson,PF,27,TOR,2,0,10,2,5,0.4,0,1,0,2,4,0.5,0.4,2,2,1,0,1,1,1,0,0,3,1,6
2008,Bobby Jones,SF,24,DEN,25,0,222,26,64,0.406,9,23,0.391,17,41,0.415,0.477,23,28,0.821,11,27,38,11,5,1,14,46,84
2008,Bobby Jones,SF,24,MEM,9,2,137,14,36,0.389,3,13,0.231,11,23,0.478,0.431,9,10,0.9,10,17,27,11,5,2,5,17,40
2008,Bobby Jones,SF,24,HOU,4,0,9,2,4,0.5,0,0,NA,2,4,0.5,0.5,0,0,NA,0,1,1,0,1,0,1,3,4
2008,Bobby Jones,SF,24,MIA,6,0,143,17,32,0.531,6,15,0.4,11,17,0.647,0.625,8,13,0.615,8,16,24,5,2,0,7,18,48
2008,Bobby Jones,SF,24,SAS,3,0,20,1,4,0.25,0,2,0,1,2,0.5,0.25,0,0,NA,0,2,2,1,2,0,1,1,2
2008,Dahntay Jones,SG,27,SAC,25,0,206,23,53,0.434,1,6,0.167,22,47,0.468,0.443,34,51,0.667,7,28,35,12,8,6,10,28,81
2008,Damon Jones,SG,31,CLE,67,3,1336,151,363,0.416,115,276,0.417,36,87,0.414,0.574,20,28,0.714,5,67,72,126,19,1,36,66,437
2008,Eddie Jones,SG,36,DAL,47,33,922,66,180,0.367,34,116,0.293,32,64,0.5,0.461,10,14,0.714,18,114,132,69,26,8,29,72,176
2008,Fred Jones,SG,28,NYK,70,26,1757,182,432,0.421,74,192,0.385,108,240,0.45,0.507,94,126,0.746,30,140,170,166,48,18,78,140,532
2008,Solomon Jones,PF,23,ATL,35,0,145,12,30,0.4,0,2,0,12,28,0.429,0.4,11,20,0.55,19,23,42,0,3,5,11,28,35
2008,Coby Karl,SG,24,LAL,17,0,71,9,26,0.346,4,13,0.308,5,13,0.385,0.423,8,10,0.8,3,11,14,9,4,2,5,4,30
2008,Jason Kidd,PG,34,NJN,51,51,1895,201,549,0.366,84,236,0.356,117,313,0.374,0.443,91,111,0.82,58,354,412,530,74,15,185,90,577
2008,Jason Kidd,PG,34,DAL,29,29,1011,104,244,0.426,35,76,0.461,69,168,0.411,0.498,44,54,0.815,36,152,188,276,62,11,81,75,287
2008,Brevin Knight,PG,32,LAC,74,39,1674,138,342,0.404,0,6,0,138,336,0.411,0.404,62,71,0.873,15,127,142,328,100,11,71,160,338
2008,Kyle Korver,PF,26,PHI,25,0,657,90,227,0.396,38,108,0.352,52,119,0.437,0.48,31,34,0.912,12,61,73,33,20,6,28,67,249
2008,Kyle Korver,SG,26,UTA,50,0,1075,165,348,0.474,73,188,0.388,92,160,0.575,0.579,88,96,0.917,9,90,99,68,22,23,47,125,491
2008,Nenad Krstić,C,24,NJN,45,38,812,123,300,0.41,0,2,0,123,298,0.413,0.41,52,69,0.754,35,165,200,27,9,17,41,111,298
2008,Raef LaFrentz,C,31,POR,39,0,291,27,61,0.443,0,4,0,27,57,0.474,0.443,11,19,0.579,28,39,67,6,12,17,10,59,65
2008,Carl Landry,PF,24,HOU,42,0,711,135,219,0.616,0,1,0,135,218,0.619,0.616,72,109,0.661,96,111,207,21,17,7,26,98,342
2008,Stéphane Lasme,SF,25,GSW,1,0,0,0,0,NA,0,0,NA,0,0,NA,NA,0,0,NA,0,0,0,0,0,0,0,0,0
2008,Stéphane Lasme,PF,25,MIA,15,4,303,32,71,0.451,0,0,NA,32,71,0.451,0.451,19,32,0.594,26,27,53,3,13,22,15,35,83
2008,Acie Law,PG,23,ATL,56,6,865,95,237,0.401,7,34,0.206,88,203,0.433,0.416,38,48,0.792,12,45,57,113,29,0,56,73,235
2008,David Lee,PF,24,NYK,81,29,2356,341,618,0.552,0,2,0,341,616,0.554,0.552,194,237,0.819,242,482,724,95,55,29,97,210,876
2008,Rashard Lewis,PF,28,ORL,81,81,3076,516,1135,0.455,226,553,0.409,290,582,0.498,0.554,218,260,0.838,97,340,437,196,99,38,140,214,1476
2008,Kyle Lowry,PG,21,MEM,82,9,2089,256,592,0.432,36,140,0.257,220,452,0.487,0.463,243,348,0.698,41,209,250,296,92,22,127,185,791
2008,Tyronn Lue,PG,30,ATL,33,3,564,86,196,0.439,30,69,0.435,56,127,0.441,0.515,24,28,0.857,9,32,41,59,11,0,22,38,226
2008,Tyronn Lue,PG,30,DAL,17,0,172,27,57,0.474,9,17,0.529,18,40,0.45,0.553,1,4,0.25,0,13,13,15,0,1,5,28,64
2008,Jamaal Magloire,C,29,NJN,24,2,259,15,49,0.306,0,0,NA,15,49,0.306,0.306,14,31,0.452,18,63,81,7,0,10,23,42,44
2008,Jamaal Magloire,C,29,DAL,7,0,27,3,6,0.5,0,0,NA,3,6,0.5,0.5,6,13,0.462,1,7,8,0,1,0,7,8,12
2008,Stephon Marbury,PG,30,NYK,24,19,805,111,265,0.419,28,74,0.378,83,191,0.435,0.472,83,116,0.716,17,42,59,113,21,2,48,57,333
2008,Shawn Marion,PF,29,PHO,47,47,1713,304,578,0.526,58,167,0.347,246,411,0.599,0.576,77,108,0.713,86,378,464,98,95,70,49,117,743
2008,Shawn Marion,PF,29,MIA,16,15,602,96,209,0.459,8,31,0.258,88,178,0.494,0.478,29,42,0.69,50,129,179,40,30,15,37,33,229
2008,Donyell Marshall,PF,34,CLE,11,1,156,13,44,0.295,8,23,0.348,5,21,0.238,0.386,7,9,0.778,9,21,30,5,2,9,6,16,41
2008,Donyell Marshall,PF,34,SEA,15,0,184,19,54,0.352,7,30,0.233,12,24,0.5,0.417,12,13,0.923,15,31,46,5,4,7,9,15,57
2008,Darrick Martin,PG,36,TOR,17,0,141,10,43,0.233,2,16,0.125,8,27,0.296,0.256,5,6,0.833,3,4,7,21,6,0,1,12,27
2008,Kevin Martin,SG,24,SAC,61,57,2216,417,914,0.456,107,266,0.402,310,648,0.478,0.515,502,578,0.869,48,225,273,129,62,5,131,150,1443
2008,Desmond Mason,SF,30,MIL,59,56,1702,230,477,0.482,0,0,NA,230,477,0.482,0.482,114,173,0.659,75,181,256,121,40,30,83,106,574
2008,Roger Mason,PG,27,WAS,80,9,1708,266,600,0.443,130,327,0.398,136,273,0.498,0.552,62,71,0.873,17,113,130,134,40,18,69,140,724
2008,Rashad McCants,SG,23,MIN,75,24,2020,428,944,0.453,142,349,0.407,286,595,0.481,0.529,116,155,0.748,50,156,206,162,66,18,172,234,1114
2008,Antonio McDyess,PF,33,DET,78,78,2285,293,600,0.488,0,2,0,293,598,0.49,0.488,97,156,0.622,204,462,666,89,61,53,75,246,683
2008,Tracy McGrady,SG,28,HOU,66,62,2440,548,1307,0.419,86,295,0.292,462,1012,0.457,0.452,245,358,0.684,42,297,339,387,68,30,160,91,1427
2008,Dominic McGuire,SG,22,WAS,70,1,695,39,103,0.379,1,6,0.167,38,97,0.392,0.383,14,32,0.438,53,86,139,40,20,26,40,76,93
2008,Jeff McInnis,PG,33,CHA,54,26,1410,108,249,0.434,3,19,0.158,105,230,0.457,0.44,23,30,0.767,16,80,96,220,23,3,76,120,242
2008,Josh McRoberts,PF,20,POR,8,0,28,6,10,0.6,0,1,0,6,9,0.667,0.6,0,0,NA,2,8,10,2,1,0,2,1,12
2008,Chris Mihm,C,28,LAL,23,5,278,32,95,0.337,0,0,NA,32,95,0.337,0.337,18,27,0.667,28,49,77,13,4,14,17,42,82
2008,C.J. Miles,SG,20,UTA,60,13,689,113,236,0.479,30,77,0.39,83,159,0.522,0.542,41,52,0.788,16,62,78,53,32,8,27,98,297
2008,Darko Miličić,C,22,MEM,70,64,1663,219,500,0.438,0,1,0,219,499,0.439,0.438,67,121,0.554,127,297,424,58,32,114,101,185,505
2008,Andre Miller,PG,31,PHI,82,82,3016,569,1156,0.492,3,34,0.088,566,1122,0.504,0.494,257,333,0.772,95,229,324,565,105,6,206,181,1398
2008,Brad Miller,C,31,SAC,72,72,2513,337,728,0.463,28,90,0.311,309,638,0.484,0.482,262,309,0.848,167,514,681,264,69,74,164,247,964
2008,Mike Miller,SG,27,MEM,70,70,2474,414,824,0.502,155,359,0.432,259,465,0.557,0.596,164,212,0.774,51,416,467,240,35,16,182,145,1147
2008,Cuttino Mobley,SG,32,LAC,77,38,2702,377,870,0.433,67,192,0.349,310,678,0.457,0.472,163,199,0.819,50,225,275,202,78,34,123,152,984
2008,Nazr Mohammed,C,30,DET,21,0,228,28,59,0.475,0,1,0,28,58,0.483,0.475,13,30,0.433,29,44,73,6,7,8,11,36,69
2008,Nazr Mohammed,C,30,CHA,61,29,1422,244,469,0.52,0,0,NA,244,469,0.52,0.52,82,133,0.617,165,256,421,66,38,52,90,194,570
2008,Jamario Moon,SF,27,TOR,78,75,2166,279,575,0.485,40,122,0.328,239,453,0.528,0.52,63,85,0.741,92,392,484,90,80,108,51,152,661
2008,Mikki Moore,PF,32,SAC,82,79,2385,282,489,0.577,0,2,0,282,487,0.579,0.577,134,182,0.736,160,334,494,84,35,46,110,310,698
2008,Alonzo Mourning,C,37,MIA,25,0,389,52,95,0.547,0,0,NA,52,95,0.547,0.547,45,76,0.592,34,59,93,7,4,42,25,56,149
2008,Troy Murphy,PF,27,IND,75,61,2106,315,693,0.455,94,236,0.398,221,457,0.484,0.522,192,241,0.797,108,435,543,165,49,32,96,217,916
2008,Ronald Murray,PG,28,DET,19,2,347,57,139,0.41,6,27,0.222,51,112,0.455,0.432,22,37,0.595,13,23,36,64,13,1,31,19,142
2008,Ronald Murray,PG,28,IND,23,17,527,97,228,0.425,14,36,0.389,83,192,0.432,0.456,46,61,0.754,10,37,47,80,25,3,53,31,254
2008,Dikembe Mutombo,C,41,HOU,39,25,619,43,80,0.538,0,0,NA,43,80,0.538,0.538,32,45,0.711,68,131,199,5,11,48,17,55,118
2008,Boštjan Nachbar,PF,27,NJN,75,1,1660,245,609,0.402,94,262,0.359,151,347,0.435,0.479,154,196,0.786,56,204,260,88,44,21,85,182,738
2008,Eduardo Nájera,PF,31,DEN,78,3,1664,174,368,0.473,53,147,0.361,121,221,0.548,0.545,63,89,0.708,113,224,337,95,69,40,59,199,464
2008,Jameer Nelson,PG,25,ORL,69,62,1961,283,603,0.469,64,154,0.416,219,449,0.488,0.522,125,151,0.828,28,215,243,383,63,4,141,167,755
2008,Ira Newble,SG,33,CLE,41,13,650,71,158,0.449,15,45,0.333,56,113,0.496,0.497,20,26,0.769,41,73,114,14,27,7,31,64,177
2008,Ira Newble,SF,33,SEA,2,0,17,2,7,0.286,0,2,0,2,5,0.4,0.286,0,0,NA,0,0,0,1,0,0,0,0,4
2008,Ira Newble,SF,33,LAL,6,0,31,3,9,0.333,1,2,0.5,2,7,0.286,0.389,0,0,NA,6,5,11,3,1,1,3,5,7
2008,Demetris Nichols,SF,23,CLE,3,0,14,1,8,0.125,0,3,0,1,5,0.2,0.125,0,0,NA,0,1,1,0,0,0,2,0,2
2008,Demetris Nichols,SF,23,CHI,11,0,30,5,15,0.333,3,10,0.3,2,5,0.4,0.433,0,0,NA,0,4,4,1,0,3,2,4,13
2008,Andrés Nocioni,SF,28,CHI,82,27,2021,379,877,0.432,126,346,0.364,253,531,0.476,0.504,196,243,0.807,48,294,342,95,25,43,133,245,1080
2008,Steve Novak,SF,24,HOU,35,0,264,49,102,0.48,34,71,0.479,15,31,0.484,0.647,3,4,0.75,4,31,35,6,2,3,4,17,135
2008,Patrick O'Bryant,C,21,GSW,24,0,99,16,29,0.552,0,0,NA,16,29,0.552,0.552,3,5,0.6,10,19,29,4,4,9,7,27,35
2008,Jermaine O'Neal,C,29,IND,42,34,1206,225,512,0.439,0,5,0,225,507,0.444,0.439,121,163,0.742,82,201,283,93,20,87,106,129,571
2008,Shaquille O'Neal,C,35,MIA,33,33,945,191,329,0.581,0,0,NA,191,329,0.581,0.581,88,178,0.494,99,159,258,45,19,54,98,134,470
2008,Shaquille O'Neal,C,35,PHO,28,28,803,140,229,0.611,0,0,NA,140,229,0.611,0.611,82,160,0.513,67,229,296,48,13,34,83,94,362
2008,Kevin Ollie,SG,35,PHI,40,0,300,29,69,0.42,0,1,0,29,68,0.426,0.42,12,15,0.8,4,15,19,38,10,0,5,28,70
2008,Bo Outlaw,PF,36,ORL,2,0,7,2,3,0.667,0,0,NA,2,3,0.667,0.667,0,0,NA,0,0,0,0,0,0,1,1,4
2008,Travis Outlaw,PF,23,POR,82,6,2186,417,964,0.433,40,101,0.396,377,863,0.437,0.453,218,294,0.741,96,280,376,106,59,63,107,173,1092
2008,Jannero Pargo,SG,28,NOH,80,5,1497,254,652,0.39,65,186,0.349,189,466,0.406,0.439,71,81,0.877,26,104,130,192,50,5,93,123,644
2008,Smush Parker,PG,26,MIA,9,0,183,17,54,0.315,6,24,0.25,11,30,0.367,0.37,3,4,0.75,2,17,19,15,5,3,8,13,43
2008,Smush Parker,PG,26,LAC,19,2,409,47,130,0.362,12,54,0.222,35,76,0.461,0.408,16,24,0.667,2,30,32,69,19,3,36,47,122
2008,Ruben Patterson,SF,32,LAC,20,5,327,39,86,0.453,0,2,0,39,84,0.464,0.453,24,43,0.558,24,40,64,17,21,7,27,37,102
2008,Sasha Pavlović,SG,24,CLE,51,45,1188,146,403,0.362,34,114,0.298,112,289,0.388,0.404,53,77,0.688,35,93,128,82,29,6,55,117,379
2008,Kendrick Perkins,C,23,BOS,78,78,1912,214,348,0.615,0,1,0,214,347,0.617,0.615,114,183,0.623,145,329,474,84,31,114,125,242,542
2008,Johan Petro,C,22,SEA,72,28,1310,184,439,0.419,0,1,0,184,438,0.42,0.419,64,87,0.736,98,272,370,32,35,42,73,173,432
2008,Mickaël Piétrus,SF,25,GSW,66,16,1316,170,387,0.439,66,183,0.361,104,204,0.51,0.525,66,98,0.673,67,175,242,49,66,43,48,200,472
2008,James Posey,PF,31,BOS,74,2,1821,173,414,0.418,106,279,0.38,67,135,0.496,0.546,93,115,0.809,30,292,322,114,72,19,65,182,545
2008,Leon Powe,C,24,BOS,56,5,809,154,269,0.572,0,1,0,154,268,0.575,0.572,137,193,0.71,95,132,227,15,15,16,43,127,445
2008,Josh Powell,C,25,LAC,64,25,1228,145,315,0.46,0,3,0,145,312,0.465,0.46,63,87,0.724,115,216,331,47,14,23,65,130,353
2008,Tayshaun Prince,SF,27,DET,82,82,2694,421,940,0.448,53,146,0.363,368,794,0.463,0.476,185,241,0.768,109,289,398,268,42,33,91,90,1080
2008,Joel Przybilla,C,28,POR,77,67,1819,144,250,0.576,0,1,0,144,249,0.578,0.576,83,122,0.68,195,454,649,27,13,93,95,234,371
2008,Vladimir Radmanović,SF,27,LAL,65,41,1483,198,437,0.453,95,234,0.406,103,203,0.507,0.562,52,65,0.8,56,159,215,123,46,12,73,147,543
2008,Shavlik Randolph,PF,24,PHI,9,0,27,4,14,0.286,0,0,NA,4,14,0.286,0.286,0,0,NA,9,2,11,3,1,3,2,5,8
2008,Zach Randolph,C,26,NYK,69,68,2244,486,1058,0.459,22,80,0.275,464,978,0.474,0.47,223,289,0.772,184,526,710,140,59,16,186,194,1217
2008,Theo Ratliff,PF,34,MIN,10,6,214,23,45,0.511,0,1,0,23,44,0.523,0.511,17,25,0.68,13,26,39,7,3,19,12,30,63
2008,Theo Ratliff,C,34,DET,16,3,223,18,40,0.45,0,0,NA,18,40,0.45,0.45,12,18,0.667,19,31,50,7,4,18,9,29,48
2008,J.J. Redick,SG,23,ORL,34,0,276,48,108,0.444,17,43,0.395,31,65,0.477,0.523,27,34,0.794,1,22,23,16,4,0,15,29,140
2008,Jason Richardson,SF,27,CHA,82,82,3149,648,1468,0.441,243,599,0.406,405,869,0.466,0.524,249,331,0.752,80,361,441,258,116,57,166,241,1788
2008,Jeremy Richardson,SF,23,MEM,3,0,15,0,6,0,0,2,0,0,4,0,0,0,0,NA,0,1,1,1,0,0,1,2,0
2008,Jeremy Richardson,SG,23,SAS,5,1,29,3,7,0.429,2,5,0.4,1,2,0.5,0.571,2,2,1,0,1,1,1,1,0,0,5,10
2008,Jeremy Richardson,SF,23,ATL,19,0,88,13,31,0.419,5,12,0.417,8,19,0.421,0.5,0,0,NA,1,6,7,0,2,0,5,6,31
2008,Luke Ridnour,PG,26,SEA,61,5,1223,147,368,0.399,21,71,0.296,126,297,0.424,0.428,78,91,0.857,13,81,94,241,37,14,80,120,393
2008,Nate Robinson,PG,23,NYK,72,17,1883,331,782,0.423,97,292,0.332,234,490,0.478,0.485,154,196,0.786,51,171,222,212,60,1,103,186,913
2008,Sergio Rodríguez,PG,21,POR,72,0,628,69,196,0.352,17,58,0.293,52,138,0.377,0.395,25,38,0.658,13,45,58,123,24,0,53,57,180
2008,Rajon Rondo,PG,21,BOS,77,77,2306,351,713,0.492,5,19,0.263,346,694,0.499,0.496,107,175,0.611,78,244,322,393,129,13,147,187,814
2008,Malik Rose,PF,33,NYK,49,3,494,66,180,0.367,2,7,0.286,64,173,0.37,0.372,37,51,0.725,31,72,103,28,16,7,40,80,171
2008,Quinton Ross,SG,26,LAC,76,44,1505,131,335,0.391,9,21,0.429,122,314,0.389,0.404,40,60,0.667,54,118,172,88,43,33,29,132,311
2008,Kareem Rush,SG,27,IND,71,15,1504,228,569,0.401,102,262,0.389,126,307,0.41,0.49,30,42,0.714,19,149,168,89,42,19,62,108,588
2008,John Salmons,SG,28,SAC,81,41,2517,381,799,0.477,39,120,0.325,342,679,0.504,0.501,214,260,0.823,76,273,349,208,93,31,170,171,1015
2008,Cheikh Samb,C,23,DET,4,0,31,3,4,0.75,0,0,NA,3,4,0.75,0.75,1,2,0.5,3,4,7,0,1,2,1,8,7
2008,Thabo Sefolosha,SG,23,CHI,69,22,1436,180,421,0.428,29,88,0.33,151,333,0.453,0.462,75,104,0.721,50,205,255,129,61,30,93,128,464
2008,Mouhamed Sene,C,21,SEA,13,0,62,11,24,0.458,0,0,NA,11,24,0.458,0.458,8,17,0.471,7,9,16,1,0,7,0,9,30
2008,Ramon Sessions,PG,21,MIL,17,7,450,51,117,0.436,3,7,0.429,48,110,0.436,0.449,32,41,0.78,8,50,58,127,17,3,36,26,137
2008,Cedric Simmons,PF,22,CLE,7,0,68,2,6,0.333,0,0,NA,2,6,0.333,0.333,0,8,0,5,10,15,0,2,5,4,7,4
2008,Cedric Simmons,PF,22,CHI,7,0,19,2,8,0.25,0,0,NA,2,8,0.25,0.25,0,2,0,1,2,3,0,0,0,2,1,4
2008,Courtney Sims,C,24,IND,3,0,11,0,1,0,0,0,NA,0,1,0,0,0,0,NA,1,1,2,1,0,0,0,2,0
2008,Brian Skinner,C,31,PHO,66,0,844,92,198,0.465,2,3,0.667,90,195,0.462,0.47,33,63,0.524,63,175,238,15,21,77,39,112,219
2008,J.R. Smith,SG,22,DEN,74,0,1421,311,674,0.461,157,390,0.403,154,284,0.542,0.578,128,178,0.719,43,109,152,128,62,12,112,144,907
2008,Jason Smith,PF,21,PHI,76,1,1107,141,310,0.455,4,14,0.286,137,296,0.463,0.461,54,82,0.659,77,153,230,20,22,50,48,142,340
2008,Joe Smith,PF,32,CHI,50,35,1146,225,483,0.466,0,1,0,225,482,0.467,0.466,109,135,0.807,108,157,265,47,25,31,49,113,559
2008,Joe Smith,PF,32,CLE,27,1,580,87,170,0.512,0,2,0,87,168,0.518,0.512,45,69,0.652,55,81,136,19,9,16,22,73,219
2008,Josh Smith,PF,22,ATL,81,81,2873,518,1133,0.457,25,99,0.253,493,1034,0.477,0.468,333,469,0.71,161,506,667,272,123,227,245,269,1394
2008,Eric Snow,PG,34,CLE,22,5,305,6,38,0.158,0,2,0,6,36,0.167,0.158,10,22,0.455,4,16,20,42,10,4,10,30,22
2008,Kirk Snyder,PF,24,HOU,9,0,81,13,28,0.464,2,9,0.222,11,19,0.579,0.5,6,11,0.545,5,7,12,8,1,1,4,6,34
2008,Kirk Snyder,SF,24,MIN,27,18,680,83,161,0.516,3,14,0.214,80,147,0.544,0.525,58,77,0.753,25,89,114,56,19,14,48,49,227
2008,Jerry Stackhouse,SG,33,DAL,58,13,1412,213,526,0.405,60,184,0.326,153,342,0.447,0.462,132,148,0.892,33,100,133,145,28,10,86,82,618
2008,DeShawn Stevenson,SG,26,WAS,82,82,2564,301,780,0.386,158,413,0.383,143,367,0.39,0.487,157,197,0.797,37,198,235,252,65,15,102,110,917
2008,Peja Stojaković,SF,30,NOH,77,77,2711,451,1026,0.44,231,524,0.441,220,502,0.438,0.552,130,140,0.929,64,267,331,96,57,10,61,127,1263
2008,Damon Stoudamire,PG,34,MEM,29,29,624,77,194,0.397,36,94,0.383,41,100,0.41,0.49,21,26,0.808,14,57,71,112,19,0,50,46,211
2008,Damon Stoudamire,PG,34,SAS,31,4,413,43,143,0.301,14,55,0.255,29,88,0.33,0.35,6,8,0.75,6,41,47,53,11,2,30,30,106
2008,Amar'e Stoudemire,C,25,PHO,79,79,2677,714,1211,0.59,5,31,0.161,709,1180,0.601,0.592,556,691,0.805,178,541,719,118,64,163,174,294,1989
2008,Stromile Swift,PF,28,MEM,35,4,549,93,177,0.525,0,2,0,93,175,0.531,0.525,52,81,0.642,46,83,129,22,10,36,39,74,238
2008,Stromile Swift,PF,28,NJN,21,0,295,42,88,0.477,0,0,NA,42,88,0.477,0.477,21,28,0.75,18,52,70,4,5,18,12,39,105
2008,Wally Szczerbiak,SF,30,SEA,50,1,1180,236,513,0.46,71,166,0.428,165,347,0.476,0.529,113,134,0.843,16,120,136,69,14,5,56,67,656
2008,Wally Szczerbiak,SF,30,CLE,25,1,556,75,209,0.359,19,52,0.365,56,157,0.357,0.404,36,41,0.878,18,63,81,35,9,7,20,36,205
2008,Sebastian Telfair,PG,22,MIN,60,51,1933,223,556,0.401,32,114,0.281,191,442,0.432,0.43,78,105,0.743,16,119,135,355,59,11,111,171,556
2008,Billy Thomas,SF,32,NJN,4,0,8,0,3,0,0,3,0,0,0,NA,0,2,2,1,0,0,0,0,0,0,1,0,2
2008,Billy Thomas,SF,32,CLE,7,0,34,4,14,0.286,4,13,0.308,0,1,0,0.429,0,0,NA,0,2,2,0,1,0,3,4,12
2008,Kenny Thomas,PF,30,SAC,23,3,281,16,38,0.421,0,0,NA,16,38,0.421,0.421,0,5,0,18,43,61,13,6,1,21,38,32
2008,Kurt Thomas,C,35,SEA,42,39,1060,139,271,0.513,0,0,NA,139,271,0.513,0.513,39,56,0.696,94,275,369,53,35,43,28,131,317
2008,Kurt Thomas,PF,35,SAS,28,9,524,56,125,0.448,0,1,0,56,124,0.452,0.448,14,24,0.583,36,102,138,14,21,14,18,57,126
2008,Tim Thomas,PF,30,LAC,63,51,1940,291,705,0.413,83,271,0.306,208,434,0.479,0.472,115,153,0.752,62,261,323,171,40,29,98,192,780
2008,Tyrus Thomas,PF,21,CHI,74,27,1330,186,440,0.423,1,6,0.167,185,434,0.426,0.424,129,174,0.741,102,240,342,90,48,72,77,170,502
2008,Al Thornton,PF,24,LAC,79,31,2158,374,871,0.429,43,130,0.331,331,741,0.447,0.454,214,288,0.743,98,260,358,98,46,43,128,195,1005
2008,Alando Tucker,SF,23,PHO,6,0,48,8,22,0.364,1,4,0.25,7,18,0.389,0.386,5,6,0.833,4,4,8,0,0,1,0,2,22
2008,Ronny Turiaf,C,25,LAL,78,21,1458,188,397,0.474,0,1,0,188,396,0.475,0.474,140,186,0.753,95,211,306,128,28,108,72,199,516
2008,Hedo Türkoğlu,SF,28,ORL,82,82,3026,556,1219,0.456,166,415,0.4,390,804,0.485,0.524,324,391,0.829,83,388,471,409,74,25,246,244,1602
2008,Beno Udrih,PG,25,SAC,65,51,2080,328,708,0.463,53,137,0.387,275,571,0.482,0.501,125,147,0.85,34,183,217,282,56,10,148,138,834
2008,Anderson Varejão,C,25,CLE,48,13,1320,136,295,0.461,0,2,0,136,293,0.464,0.461,49,82,0.598,134,265,399,53,37,26,59,134,321
2008,Sasha Vujačić,SG,23,LAL,72,0,1279,219,482,0.454,118,270,0.437,101,212,0.476,0.577,76,91,0.835,19,135,154,72,36,5,52,107,632
2008,Dwyane Wade,SG,26,MIA,51,49,1954,439,937,0.469,22,77,0.286,417,860,0.485,0.48,354,467,0.758,45,169,214,354,87,37,224,137,1254
2008,Von Wafer,SG,22,DEN,21,0,90,10,38,0.263,1,15,0.067,9,23,0.391,0.276,6,8,0.75,1,9,10,5,2,1,11,4,27
2008,Von Wafer,SG,22,POR,8,0,64,7,23,0.304,3,11,0.273,4,12,0.333,0.37,2,4,0.5,0,9,9,2,0,2,2,3,19
2008,Antoine Walker,PF,31,MIN,46,1,892,136,375,0.363,61,188,0.324,75,187,0.401,0.444,35,66,0.53,56,112,168,45,33,8,46,80,368
2008,Ben Wallace,C,33,CHI,50,50,1627,101,271,0.373,0,4,0,101,267,0.378,0.373,53,125,0.424,175,266,441,92,69,80,49,86,255
2008,Ben Wallace,PF,33,CLE,22,22,578,37,81,0.457,0,0,NA,37,81,0.457,0.457,19,44,0.432,59,104,163,13,19,37,18,35,93
2008,Gerald Wallace,PF,25,CHA,62,59,2376,408,908,0.449,71,221,0.321,337,687,0.491,0.488,313,428,0.731,58,315,373,216,131,58,180,189,1200
2008,Rasheed Wallace,C,33,DET,77,76,2346,376,870,0.432,112,315,0.356,264,555,0.476,0.497,115,150,0.767,84,427,511,137,91,129,86,213,979
2008,Luke Walton,SF,27,LAL,74,31,1729,215,478,0.45,28,84,0.333,187,394,0.475,0.479,77,109,0.706,85,206,291,218,60,18,100,133,535
2008,Hakim Warrick,PF,25,MEM,75,30,1754,328,653,0.502,13,48,0.271,315,605,0.521,0.512,183,260,0.704,123,233,356,53,36,28,85,156,852
2008,Earl Watson,PG,28,SEA,78,73,2269,339,747,0.454,49,132,0.371,290,615,0.472,0.487,111,145,0.766,43,182,225,531,69,11,175,158,838
2008,Chris Webber,PF,34,GSW,9,8,126,15,31,0.484,0,0,NA,15,31,0.484,0.484,5,12,0.417,2,30,32,18,4,6,11,17,35
2008,Bonzi Wells,SG,31,HOU,51,7,1124,175,412,0.425,8,38,0.211,167,374,0.447,0.434,111,174,0.638,63,197,260,80,51,24,76,113,469
2008,Bonzi Wells,SG,31,NOH,22,0,438,77,157,0.49,4,12,0.333,73,145,0.503,0.503,35,53,0.66,21,50,71,17,24,8,27,44,193
2008,Delonte West,PG,24,SEA,35,5,727,97,250,0.388,19,56,0.339,78,194,0.402,0.426,26,39,0.667,13,83,96,113,30,10,66,44,239
2008,Delonte West,PG,24,CLE,26,26,806,99,225,0.44,29,79,0.367,70,146,0.479,0.504,41,52,0.788,18,79,97,116,29,19,51,59,268
2008,Chris Wilcox,PF,25,SEA,62,55,1739,334,638,0.524,0,3,0,334,635,0.526,0.524,160,248,0.645,126,307,433,74,46,36,103,174,828
2008,Mike Wilks,PG,28,DEN,8,0,122,10,23,0.435,2,5,0.4,8,18,0.444,0.478,2,2,1,4,8,12,6,5,0,5,9,24
2008,Mike Wilks,PG,28,WAS,4,0,44,2,4,0.5,1,2,0.5,1,2,0.5,0.625,0,0,NA,1,5,6,3,3,0,1,2,5
2008,Mike Wilks,PG,28,SEA,3,0,22,5,9,0.556,0,1,0,5,8,0.625,0.556,2,2,1,0,1,1,5,1,0,3,2,12
2008,Aaron Williams,C,36,LAC,30,5,297,27,55,0.491,0,0,NA,27,55,0.491,0.491,14,18,0.778,15,46,61,9,12,15,13,44,68
2008,Deron Williams,PG,23,UTA,82,82,3059,566,1117,0.507,83,210,0.395,483,907,0.533,0.544,330,411,0.803,34,209,243,862,90,23,279,200,1545
2008,Jason Williams,PG,32,MIA,67,53,1886,211,550,0.384,97,275,0.353,114,275,0.415,0.472,69,80,0.863,12,118,130,307,83,5,91,93,588
2008,Justin Williams,C,23,SAC,22,0,117,12,26,0.462,0,0,NA,12,26,0.462,0.462,7,22,0.318,19,29,48,0,5,5,3,14,31
2008,Justin Williams,C,23,HOU,1,0,6,1,3,0.333,0,0,NA,1,3,0.333,0.333,1,4,0.25,1,0,1,0,0,0,1,3,3
2008,Lou Williams,PG,21,PHI,80,0,1862,319,752,0.424,55,153,0.359,264,599,0.441,0.461,227,290,0.783,41,126,167,253,81,13,125,130,920
2008,Marcus Williams,PG,22,NJN,53,7,854,111,293,0.379,54,142,0.38,57,151,0.377,0.471,37,47,0.787,14,87,101,140,25,3,75,52,313
2008,Marcus Williams,SF,21,SAS,1,0,2,0,1,0,0,0,NA,0,1,0,0,0,0,NA,0,0,0,0,0,1,0,0,0
2008,Marcus Williams,PF,21,LAC,10,0,34,5,19,0.263,0,0,NA,5,19,0.263,0.263,0,0,NA,4,8,12,3,1,0,0,3,10
2008,Marvin Williams,SF,21,ATL,80,80,2765,424,918,0.462,1,10,0.1,423,908,0.466,0.462,336,409,0.822,119,338,457,137,81,33,127,225,1185
2008,Mo Williams,PG,25,MIL,66,66,2410,441,919,0.48,89,231,0.385,352,688,0.512,0.528,166,194,0.856,37,193,230,419,78,10,182,188,1137
2008,Sean Williams,C,21,NJN,73,29,1278,164,305,0.538,0,0,NA,164,305,0.538,0.538,81,133,0.609,115,207,322,28,28,106,70,193,409
2008,Shawne Williams,SF,21,IND,65,3,967,159,372,0.427,43,137,0.314,116,235,0.494,0.485,76,106,0.717,54,122,176,59,26,26,58,132,437
2008,Shelden Williams,PF,24,ATL,36,0,414,37,100,0.37,0,1,0,37,99,0.374,0.37,35,51,0.686,34,73,107,11,13,11,14,60,109
2008,Shelden Williams,PF,24,SAC,28,0,362,55,112,0.491,0,1,0,55,111,0.495,0.491,36,54,0.667,34,64,98,8,9,10,21,50,146
2008,Metta World Peace,SF,28,SAC,57,54,2172,436,962,0.453,84,221,0.38,352,741,0.475,0.497,212,295,0.719,101,227,328,199,133,38,148,159,1168
2008,Antoine Wright,SG,23,NJN,41,10,1056,115,287,0.401,27,101,0.267,88,186,0.473,0.448,41,58,0.707,35,90,125,67,26,17,39,105,298
2008,Antoine Wright,SG,23,DAL,15,0,176,21,42,0.5,5,9,0.556,16,33,0.485,0.56,5,9,0.556,5,17,22,13,2,4,11,22,52
2008,Brandan Wright,PF,20,GSW,38,6,376,62,112,0.554,0,0,NA,62,112,0.554,0.554,27,40,0.675,38,61,99,9,6,22,13,36,151
2008,Lorenzen Wright,C,32,ATL,13,1,148,5,17,0.294,0,0,NA,5,17,0.294,0.294,3,6,0.5,7,30,37,3,3,3,2,26,13
2008,Lorenzen Wright,C,32,SAC,5,0,13,1,4,0.25,0,0,NA,1,4,0.25,0.25,0,0,NA,1,0,1,1,0,0,2,5,2
2008,Nick Young,SG,22,WAS,75,2,1158,210,478,0.439,40,100,0.4,170,378,0.45,0.481,101,124,0.815,23,92,115,63,35,7,94,130,561
2008,Thaddeus Young,PF,19,PHI,74,22,1554,264,490,0.539,6,19,0.316,258,471,0.548,0.545,76,103,0.738,120,192,312,58,73,8,64,126,610
2009,Alex Acker,SG,26,DET,7,0,20,4,11,0.364,0,4,0,4,7,0.571,0.364,1,2,0.5,0,2,2,1,2,1,0,0,9
2009,Alex Acker,SG,26,LAC,18,0,179,26,65,0.4,7,16,0.438,19,49,0.388,0.454,4,8,0.5,8,14,22,11,3,3,7,9,63
2009,Arron Afflalo,SG,23,DET,74,8,1234,131,300,0.437,43,107,0.402,88,193,0.456,0.508,58,71,0.817,30,104,134,44,28,13,43,144,363
2009,Maurice Ager,SG,24,NJN,20,0,97,15,43,0.349,0,6,0,15,37,0.405,0.349,4,8,0.5,3,7,10,3,1,2,4,17,34
2009,Alexis Ajinça,PF,20,CHA,31,4,182,25,69,0.362,0,2,0,25,67,0.373,0.362,20,28,0.714,9,21,30,3,7,6,12,34,70
2009,LaMarcus Aldridge,PF,23,POR,81,81,3004,601,1243,0.484,7,28,0.25,594,1215,0.489,0.486,261,334,0.781,234,371,605,157,77,77,121,207,1470
2009,Malik Allen,PF,30,MIL,49,3,579,73,170,0.429,0,1,0,73,169,0.432,0.429,10,21,0.476,35,68,103,35,7,12,20,89,156
2009,Ray Allen,SG,33,BOS,79,79,2876,499,1040,0.48,199,486,0.409,300,554,0.542,0.575,237,249,0.952,66,212,278,218,69,13,134,157,1434
2009,Rafer Alston,PG,32,HOU,48,48,1591,193,522,0.37,80,230,0.348,113,292,0.387,0.446,86,109,0.789,25,119,144,258,57,7,88,72,552
2009,Rafer Alston,PG,32,ORL,29,28,856,123,298,0.413,32,101,0.317,91,197,0.462,0.466,70,99,0.707,8,75,83,148,51,3,52,63,348
2009,Lou Amundson,PF,26,PHO,76,0,1044,134,250,0.536,0,1,0,134,249,0.538,0.536,53,120,0.442,128,142,270,28,32,65,56,154,321
2009,Chris Andersen,C,30,DEN,71,1,1460,160,292,0.548,2,10,0.2,158,282,0.56,0.551,130,181,0.718,163,279,442,31,41,175,69,174,452
2009,Ryan Anderson,PF,20,NJN,66,30,1312,160,407,0.393,69,189,0.365,91,218,0.417,0.478,98,116,0.845,104,207,311,52,44,20,63,157,487
2009,Carmelo Anthony,SF,24,DEN,66,66,2277,535,1207,0.443,63,170,0.371,472,1037,0.455,0.469,371,468,0.793,106,344,450,222,75,24,199,195,1504
2009,Joel Anthony,C,26,MIA,65,28,1048,57,118,0.483,0,0,NA,57,118,0.483,0.483,30,46,0.652,89,108,197,27,20,93,41,139,144
2009,Gilbert Arenas,PG,27,WAS,2,2,63,6,23,0.261,2,7,0.286,4,16,0.25,0.304,12,16,0.75,1,8,9,20,0,1,1,4,26
2009,Trevor Ariza,SF,23,LAL,82,20,1999,274,596,0.46,61,191,0.319,213,405,0.526,0.511,120,169,0.71,111,241,352,145,137,24,87,166,729
2009,Hilton Armstrong,C,24,NOH,70,29,1092,138,246,0.561,0,2,0,138,244,0.566,0.561,62,98,0.633,81,114,195,29,26,45,80,181,338
2009,Chucky Atkins,PG,34,DEN,14,0,115,9,27,0.333,5,17,0.294,4,10,0.4,0.426,4,4,1,0,6,6,28,2,1,10,5,27
2009,Chucky Atkins,PG,34,OKC,19,0,297,25,86,0.291,10,40,0.25,15,46,0.326,0.349,11,12,0.917,5,13,18,31,8,1,13,22,71
2009,D.J. Augustin,PG,21,CHA,72,12,1908,267,621,0.43,108,246,0.439,159,375,0.424,0.517,208,233,0.893,17,116,133,250,42,2,119,140,850
2009,Renaldo Balkman,PF,24,DEN,53,10,780,110,197,0.558,2,7,0.286,108,190,0.568,0.563,42,65,0.646,86,117,203,34,47,23,35,98,264
2009,Marcus Banks,PG,27,MIA,16,0,166,15,39,0.385,2,14,0.143,13,25,0.52,0.41,10,15,0.667,0,15,15,22,10,2,11,21,42
2009,Marcus Banks,PG,27,TOR,6,0,40,6,18,0.333,1,5,0.2,5,13,0.385,0.361,1,3,0.333,1,2,3,6,1,0,3,5,14
2009,Leandro Barbosa,SG,26,PHO,70,11,1705,366,759,0.482,90,240,0.375,276,519,0.532,0.542,171,194,0.881,34,147,181,162,82,7,93,115,993
2009,Matt Barnes,PF,28,PHO,77,40,2082,285,674,0.423,117,341,0.343,168,333,0.505,0.51,101,136,0.743,79,342,421,212,52,26,130,209,788
2009,Brent Barry,SG,37,HOU,56,1,857,70,172,0.407,49,131,0.374,21,41,0.512,0.549,19,20,0.95,17,77,94,78,24,3,48,45,208
2009,Tony Battie,PF,32,ORL,77,3,1202,158,323,0.489,2,9,0.222,156,314,0.497,0.492,54,82,0.659,92,186,278,31,26,25,46,112,372
2009,Shane Battier,SG,30,HOU,60,59,2031,145,354,0.41,91,237,0.384,54,117,0.462,0.538,55,67,0.821,52,233,285,137,48,54,49,114,436
2009,Jerryd Bayless,PG,20,POR,53,0,655,69,189,0.365,7,27,0.259,62,162,0.383,0.384,83,103,0.806,8,49,57,78,16,2,56,81,228
2009,Marco Belinelli,SG,22,GSW,42,23,882,140,317,0.442,52,131,0.397,88,186,0.473,0.524,40,52,0.769,10,61,71,88,36,1,59,73,372
2009,Charlie Bell,SG,29,MIL,70,23,1783,217,524,0.414,87,240,0.363,130,284,0.458,0.497,66,80,0.825,32,102,134,151,50,7,76,138,587
2009,Raja Bell,SG,32,PHO,22,22,712,76,177,0.429,44,94,0.468,32,83,0.386,0.554,16,21,0.762,8,56,64,29,13,2,18,57,212
2009,Raja Bell,SG,32,CHA,45,44,1603,223,507,0.44,70,177,0.395,153,330,0.464,0.509,71,81,0.877,33,146,179,113,37,6,68,109,587
2009,Mike Bibby,PG,30,ATL,79,79,2740,437,1005,0.435,167,428,0.39,270,577,0.468,0.518,135,171,0.789,38,240,278,392,98,11,128,145,1176
2009,Chauncey Billups,PG,32,DET,2,2,70,7,21,0.333,2,7,0.286,5,14,0.357,0.381,9,10,0.9,1,9,10,15,3,1,4,3,25
2009,Chauncey Billups,PG,32,DEN,77,77,2719,403,959,0.42,160,390,0.41,243,569,0.427,0.504,409,448,0.913,31,198,229,491,90,17,173,158,1375
2009,Steve Blake,PG,28,POR,69,69,2188,277,647,0.428,140,328,0.427,137,319,0.429,0.536,63,75,0.84,28,145,173,348,69,4,108,126,757
2009,Mark Blount,C,33,MIA,20,0,207,30,78,0.385,11,27,0.407,19,51,0.373,0.455,8,13,0.615,10,31,41,4,1,7,14,17,79
2009,Keith Bogans,SG,28,ORL,36,15,787,63,175,0.36,42,126,0.333,21,49,0.429,0.48,21,24,0.875,15,96,111,31,23,2,19,61,189
2009,Keith Bogans,SG,28,MIL,29,0,485,56,149,0.376,32,92,0.348,24,57,0.421,0.483,31,33,0.939,16,75,91,33,20,2,22,44,175
2009,Andrew Bogut,C,24,MIL,36,33,1124,183,317,0.577,0,0,NA,183,317,0.577,0.577,56,98,0.571,117,252,369,72,23,37,86,130,422
2009,Calvin Booth,C,32,MIN,1,0,1,0,0,NA,0,0,NA,0,0,NA,NA,0,0,NA,1,0,1,0,0,0,0,0,0
2009,Calvin Booth,C,32,SAC,7,0,55,5,10,0.5,0,0,NA,5,10,0.5,0.5,6,8,0.75,4,6,10,0,1,2,1,10,16
2009,Bruce Bowen,SF,37,SAS,80,10,1506,79,187,0.422,42,98,0.429,37,89,0.416,0.535,14,26,0.538,16,129,145,40,36,13,25,123,214
2009,Corey Brewer,SF,22,MIN,15,8,307,37,90,0.411,5,12,0.417,32,78,0.41,0.439,14,19,0.737,18,31,49,25,15,3,13,37,93
2009,Ronnie Brewer,SF,23,UTA,81,80,2605,421,828,0.508,22,85,0.259,399,743,0.537,0.522,247,352,0.702,101,199,300,179,138,30,110,128,1111
2009,Aaron Brooks,PG,24,HOU,80,35,1998,316,783,0.404,113,309,0.366,203,474,0.428,0.476,149,172,0.866,33,124,157,238,46,8,125,152,894
2009,Bobby Brown,SG,24,SAC,47,1,675,94,247,0.381,31,94,0.33,63,153,0.412,0.443,26,34,0.765,8,28,36,87,15,1,47,74,245
2009,Bobby Brown,PG,24,MIN,21,1,256,47,113,0.416,14,36,0.389,33,77,0.429,0.478,8,9,0.889,6,10,16,30,6,2,16,21,116
2009,Dee Brown,PG,24,WAS,17,11,233,17,44,0.386,6,20,0.3,11,24,0.458,0.455,1,3,0.333,7,21,28,33,10,0,14,22,41
2009,Dee Brown,PG,24,PHO,2,0,28,1,5,0.2,1,4,0.25,0,1,0,0.3,2,2,1,0,1,1,3,0,0,3,6,5
2009,Devin Brown,SG,30,NOH,63,5,869,111,313,0.355,28,97,0.289,83,216,0.384,0.399,78,100,0.78,31,88,119,54,32,5,54,81,328
2009,Kwame Brown,C,26,DET,58,30,999,90,169,0.533,0,0,NA,90,169,0.533,0.533,63,122,0.516,91,199,290,32,24,24,50,138,243
2009,Shannon Brown,SG,23,CHA,30,0,341,56,123,0.455,8,28,0.286,48,95,0.505,0.488,24,30,0.8,8,16,24,28,18,5,29,33,144
2009,Shannon Brown,SG,23,LAL,18,0,136,22,42,0.524,6,9,0.667,16,33,0.485,0.595,8,9,0.889,3,17,20,10,4,2,9,9,58
2009,Caron Butler,SG,28,WAS,67,67,2585,491,1085,0.453,65,210,0.31,426,875,0.487,0.482,345,402,0.858,118,296,414,290,106,20,210,165,1392
2009,Rasual Butler,SF,29,NOH,82,74,2614,348,803,0.433,140,359,0.39,208,444,0.468,0.521,86,110,0.782,49,222,271,75,51,61,59,159,922
2009,Andrew Bynum,C,21,LAL,50,50,1446,281,502,0.56,0,0,NA,281,502,0.56,0.56,152,215,0.707,137,261,398,71,18,90,85,157,714
2009,José Calderón,PG,27,TOR,68,68,2333,320,644,0.497,82,202,0.406,238,442,0.538,0.561,151,154,0.981,16,178,194,607,74,7,143,114,873
2009,Marcus Camby,C,34,LAC,62,55,1925,254,496,0.512,1,4,0.25,253,492,0.514,0.513,132,182,0.725,161,529,690,127,51,132,93,129,641
2009,Rodney Carney,SG,24,MIN,67,6,1199,176,423,0.416,79,226,0.35,97,197,0.492,0.509,50,66,0.758,36,90,126,26,45,29,43,94,481
2009,Matt Carroll,SG,28,CHA,34,10,475,56,138,0.406,12,45,0.267,44,93,0.473,0.449,15,19,0.789,5,50,55,24,18,5,26,53,139
2009,Matt Carroll,SG,28,DAL,21,0,141,9,33,0.273,1,8,0.125,8,25,0.32,0.288,6,6,1,2,12,14,3,3,1,7,14,25
2009,Anthony Carter,PG,33,DEN,78,5,1787,167,386,0.433,21,88,0.239,146,298,0.49,0.46,57,78,0.731,40,165,205,364,96,13,155,142,412
2009,Vince Carter,SG,32,NJN,80,80,2946,588,1345,0.437,151,392,0.385,437,953,0.459,0.493,335,410,0.817,74,336,410,376,82,38,166,234,1662
2009,Mario Chalmers,PG,22,MIA,82,82,2626,278,662,0.42,114,311,0.367,164,351,0.467,0.506,148,193,0.767,37,191,228,403,160,8,165,240,818
2009,Tyson Chandler,C,26,NOH,45,45,1445,160,283,0.565,0,0,NA,160,283,0.565,0.565,77,133,0.579,163,230,393,22,15,56,70,144,397
2009,Wilson Chandler,SF,21,NYK,82,70,2735,455,1054,0.432,103,314,0.328,352,740,0.476,0.481,171,215,0.795,91,354,445,170,71,75,139,250,1184
2009,Speedy Claxton,PG,30,ATL,2,0,15,2,7,0.286,0,0,NA,2,7,0.286,0.286,1,2,0.5,0,0,0,3,0,0,0,1,5
2009,Jarron Collins,C,30,UTA,26,3,201,16,35,0.457,0,0,NA,16,35,0.457,0.457,8,11,0.727,20,17,37,7,2,1,9,35,40
2009,Jason Collins,C,30,MIN,31,22,422,22,70,0.314,0,0,NA,22,70,0.314,0.314,13,28,0.464,28,42,70,11,9,13,12,73,57
2009,Mardy Collins,SG,24,NYK,9,0,75,8,23,0.348,0,3,0,8,20,0.4,0.348,4,9,0.444,2,6,8,10,2,0,5,7,20
2009,Mardy Collins,PG,24,LAC,39,14,815,97,224,0.433,13,28,0.464,84,196,0.429,0.462,24,37,0.649,29,70,99,101,29,10,53,73,231
2009,Brian Cook,PF,28,ORL,21,0,146,23,60,0.383,11,25,0.44,12,35,0.343,0.475,5,6,0.833,6,21,27,4,3,0,11,23,62
2009,Brian Cook,PF,28,HOU,9,0,25,5,16,0.313,2,5,0.4,3,11,0.273,0.375,0,0,NA,1,4,5,1,0,3,2,3,12
2009,Daequan Cook,SF,21,MIA,75,4,1833,242,645,0.375,153,395,0.387,89,250,0.356,0.494,49,56,0.875,19,170,189,71,39,10,42,125,686
2009,Jamal Crawford,SG,28,NYK,11,11,392,73,169,0.432,35,77,0.455,38,92,0.413,0.536,35,46,0.761,2,15,17,48,9,0,26,13,216
2009,Jamal Crawford,PG,28,GSW,54,54,2087,346,853,0.406,107,317,0.338,239,536,0.446,0.468,265,298,0.889,21,155,176,240,48,13,122,79,1064
2009,Javaris Crittenton,SG,21,MEM,7,0,44,7,15,0.467,0,1,0,7,14,0.5,0.467,5,11,0.455,4,2,6,5,1,0,3,5,19
2009,Javaris Crittenton,PG,21,WAS,56,10,1130,124,270,0.459,2,14,0.143,122,256,0.477,0.463,48,81,0.593,53,107,160,145,39,6,79,96,298
2009,Austin Croshere,PF,33,MIL,11,0,77,12,30,0.4,5,11,0.455,7,19,0.368,0.483,7,11,0.636,7,17,24,6,1,1,4,4,36
2009,Austin Croshere,PF,33,SAS,3,0,23,2,9,0.222,0,4,0,2,5,0.4,0.222,0,1,0,4,6,10,3,0,0,2,1,4
2009,Antonio Daniels,PG,33,WAS,13,5,288,18,45,0.4,5,11,0.455,13,34,0.382,0.456,25,33,0.758,0,22,22,47,7,0,13,14,66
2009,Antonio Daniels,PG,33,NOH,61,4,733,81,191,0.424,17,49,0.347,64,142,0.451,0.469,55,67,0.821,5,50,55,130,19,1,49,41,234
2009,Baron Davis,PG,29,LAC,65,60,2248,355,959,0.37,99,328,0.302,256,631,0.406,0.422,159,210,0.757,46,192,238,501,108,35,193,193,968
2009,Glen Davis,C,23,BOS,76,16,1637,199,450,0.442,2,5,0.4,197,445,0.443,0.444,130,178,0.73,121,180,301,69,53,19,71,230,530
2009,Ricky Davis,SG,29,LAC,36,9,785,83,245,0.339,35,111,0.315,48,134,0.358,0.41,31,36,0.861,9,51,60,82,19,5,39,63,232
2009,Luol Deng,SF,23,CHI,49,46,1665,265,591,0.448,8,20,0.4,257,571,0.45,0.455,152,191,0.796,80,215,295,94,60,25,72,85,690
2009,Boris Diaw,PF,26,PHO,22,0,538,80,141,0.567,5,14,0.357,75,127,0.591,0.585,18,26,0.692,24,60,84,46,11,9,37,39,183
2009,Boris Diaw,PF,26,CHA,59,59,2216,368,743,0.495,70,167,0.419,298,576,0.517,0.542,83,121,0.686,94,254,348,287,50,44,178,163,889
2009,Travis Diener,PG,26,IND,55,0,719,74,179,0.413,46,118,0.39,28,61,0.459,0.542,12,15,0.8,6,80,86,122,26,5,21,42,206
2009,Ike Diogu,PF,25,POR,19,0,73,6,19,0.316,0,0,NA,6,19,0.316,0.316,15,20,0.75,12,5,17,0,1,2,6,9,27
2009,Ike Diogu,PF,25,SAC,10,1,142,33,55,0.6,1,2,0.5,32,53,0.604,0.609,25,33,0.758,14,25,39,3,2,1,6,14,92
2009,DeSagana Diop,C,27,DAL,34,0,452,22,58,0.379,0,0,NA,22,58,0.379,0.379,12,29,0.414,45,73,118,13,12,25,11,55,56
2009,DeSagana Diop,C,27,CHA,41,1,584,52,113,0.46,0,0,NA,52,113,0.46,0.46,10,37,0.27,69,86,155,19,17,31,28,73,114
2009,Juan Dixon,PG,30,WAS,50,6,816,101,256,0.395,25,75,0.333,76,181,0.42,0.443,34,39,0.872,8,59,67,118,35,6,70,74,261
2009,Joey Dorsey,PF,25,HOU,3,0,6,1,2,0.5,0,0,NA,1,2,0.5,0.5,0,0,NA,0,1,1,1,0,0,0,0,2
2009,Quincy Douby,PG,24,SAC,20,0,227,30,88,0.341,10,37,0.27,20,51,0.392,0.398,14,15,0.933,3,22,25,13,2,5,6,23,84
2009,Quincy Douby,PG,24,TOR,7,0,73,12,22,0.545,4,9,0.444,8,13,0.615,0.636,3,4,0.75,3,4,7,12,3,0,7,4,31
2009,Goran Dragić,PG,22,PHO,55,1,728,88,224,0.393,20,54,0.37,68,170,0.4,0.438,50,65,0.769,33,70,103,111,29,3,73,87,246
2009,Jared Dudley,SF,23,CHA,20,7,427,45,96,0.469,3,8,0.375,42,88,0.477,0.484,15,24,0.625,25,34,59,19,18,2,10,40,108
2009,Jared Dudley,SF,23,PHO,48,0,728,91,189,0.481,26,66,0.394,65,123,0.528,0.55,56,81,0.691,57,89,146,37,39,6,33,65,264
2009,Mike Dunleavy,SG,28,IND,18,14,495,93,232,0.401,32,90,0.356,61,142,0.43,0.47,53,65,0.815,14,54,68,44,12,9,38,36,271
2009,Monta Ellis,SG,23,GSW,25,25,892,194,430,0.451,8,26,0.308,186,404,0.46,0.46,78,94,0.83,14,94,108,93,39,8,67,67,474
2009,Francisco Elson,C,32,MIL,59,23,977,83,169,0.491,1,4,0.25,82,165,0.497,0.494,33,39,0.846,100,129,229,32,36,36,48,144,200
2009,Melvin Ely,C,30,NOH,31,4,373,37,95,0.389,0,0,NA,37,95,0.389,0.389,23,36,0.639,30,34,64,18,2,9,23,58,97
2009,Maurice Evans,SF,30,ATL,80,25,1840,208,482,0.432,98,248,0.395,110,234,0.47,0.533,60,73,0.822,88,155,243,54,50,10,43,163,574
2009,Reggie Evans,PF,28,PHI,79,7,1137,79,178,0.444,0,1,0,79,177,0.446,0.444,104,175,0.594,135,226,361,26,41,8,69,161,262
2009,Raymond Felton,PG,24,CHA,82,81,3086,442,1083,0.408,59,207,0.285,383,876,0.437,0.435,219,272,0.805,54,256,310,553,126,30,228,191,1162
2009,Michael Finley,SF,35,SAS,81,77,2336,301,689,0.437,131,319,0.411,170,370,0.459,0.532,51,62,0.823,26,244,270,114,37,17,61,82,784
2009,Derek Fisher,PG,34,LAL,82,82,2441,292,688,0.424,120,302,0.397,172,386,0.446,0.512,110,130,0.846,25,163,188,261,95,6,72,187,814
2009,Randy Foye,SG,25,MIN,70,61,2494,399,981,0.407,111,308,0.36,288,673,0.428,0.463,230,272,0.846,34,180,214,303,72,26,150,201,1139
2009,Adonal Foyle,C,33,ORL,9,0,59,7,11,0.636,0,0,NA,7,11,0.636,0.636,3,6,0.5,9,17,26,1,0,8,3,4,17
2009,Adonal Foyle,C,33,MEM,1,0,3,0,0,NA,0,0,NA,0,0,NA,NA,0,0,NA,0,0,0,0,0,0,0,1,0
2009,Channing Frye,PF,25,POR,63,1,746,113,267,0.423,11,33,0.333,102,234,0.436,0.444,26,36,0.722,41,99,140,24,17,16,29,106,263
2009,Dan Gadzuric,C,30,MIL,67,26,941,117,244,0.48,0,2,0,117,242,0.483,0.48,37,68,0.544,95,160,255,39,32,43,41,162,271
2009,Danilo Gallinari,SG,20,NYK,28,2,412,56,125,0.448,32,72,0.444,24,53,0.453,0.576,26,27,0.963,13,42,55,15,14,4,15,48,170
2009,Francisco García,SF,27,SAC,65,36,1975,295,665,0.444,88,221,0.398,207,444,0.466,0.51,146,178,0.82,56,162,218,150,80,67,112,196,824
2009,Kevin Garnett,PF,32,BOS,57,57,1772,393,740,0.531,2,8,0.25,391,732,0.534,0.532,111,132,0.841,78,407,485,144,63,68,90,128,899
2009,Marc Gasol,C,24,MEM,82,75,2521,350,661,0.53,0,1,0,350,660,0.53,0.53,275,375,0.733,201,404,605,143,63,90,164,265,975
2009,Pau Gasol,C,28,LAL,81,81,2999,592,1045,0.567,1,2,0.5,591,1043,0.567,0.567,343,439,0.781,262,518,780,284,52,81,157,172,1528
2009,Rudy Gay,SF,22,MEM,79,78,2945,572,1262,0.453,85,242,0.351,487,1020,0.477,0.487,264,344,0.767,109,328,437,135,98,59,203,221,1493
2009,J.R. Giddens,SF,23,BOS,6,0,8,2,3,0.667,0,0,NA,2,3,0.667,0.667,0,0,NA,2,1,3,0,1,0,1,1,4
2009,Eddie Gill,PG,30,MIL,6,0,43,6,9,0.667,2,3,0.667,4,6,0.667,0.778,0,0,NA,0,4,4,11,3,1,5,10,14
2009,Drew Gooden,PF,27,CHI,31,27,918,161,352,0.457,0,3,0,161,349,0.461,0.457,84,97,0.866,82,184,266,43,26,14,57,103,406
2009,Drew Gooden,PF,27,SAC,1,0,26,5,9,0.556,0,0,NA,5,9,0.556,0.556,2,2,1,3,10,13,2,0,0,3,2,12
2009,Drew Gooden,PF,27,SAS,19,1,320,71,145,0.49,0,1,0,71,144,0.493,0.49,45,57,0.789,28,55,83,3,4,4,16,39,187
2009,Marcin Gortat,PF,24,ORL,63,3,794,106,187,0.567,1,1,1,105,186,0.565,0.57,26,45,0.578,96,190,286,14,18,53,25,111,239
2009,Stephen Graham,SG,26,IND,52,6,684,106,256,0.414,20,66,0.303,86,190,0.453,0.453,50,62,0.806,21,75,96,33,10,4,45,82,282
2009,Danny Granger,SF,25,IND,67,66,2424,571,1277,0.447,182,450,0.404,389,827,0.47,0.518,404,460,0.878,49,292,341,183,69,97,165,207,1728
2009,Aaron Gray,C,24,CHI,56,18,715,81,167,0.485,0,1,0,81,166,0.488,0.485,34,59,0.576,84,136,220,46,14,18,40,135,196
2009,Gerald Green,SG,23,DAL,38,12,376,79,180,0.439,14,46,0.304,65,134,0.485,0.478,27,32,0.844,14,40,54,15,10,5,33,51,199
2009,Jeff Green,PF,22,OKC,78,78,2873,476,1068,0.446,96,247,0.389,380,821,0.463,0.491,242,307,0.788,120,399,519,155,81,33,173,202,1290
2009,Hamed Haddadi,C,23,MEM,19,0,120,15,31,0.484,0,0,NA,15,31,0.484,0.484,18,30,0.6,16,31,47,8,1,12,9,20,48
2009,Al Harrington,PF,28,GSW,5,5,166,23,70,0.329,11,28,0.393,12,42,0.286,0.407,5,10,0.5,10,18,28,10,7,0,7,14,62
2009,Al Harrington,PF,28,NYK,68,51,2380,509,1142,0.446,160,442,0.362,349,700,0.499,0.516,229,285,0.804,89,338,427,92,81,22,154,213,1407
2009,Devin Harris,PG,25,NJN,69,69,2494,455,1039,0.438,64,220,0.291,391,819,0.477,0.469,496,605,0.82,30,201,231,476,114,13,212,164,1470
2009,Jason Hart,PG,30,LAC,28,2,312,25,84,0.298,0,4,0,25,80,0.313,0.298,15,19,0.789,12,30,42,43,12,4,19,35,65
2009,Jason Hart,PG,30,DEN,11,0,36,5,10,0.5,0,2,0,5,8,0.625,0.5,3,4,0.75,1,3,4,5,0,0,3,4,13
2009,Trenton Hassell,SF,29,NJN,53,31,1094,86,191,0.45,2,8,0.25,84,183,0.459,0.455,20,25,0.8,50,96,146,51,21,16,30,92,194
2009,Spencer Hawes,C,20,SAC,77,51,2259,373,800,0.466,40,115,0.348,333,685,0.486,0.491,90,136,0.662,148,401,549,149,44,93,160,249,876
2009,Chuck Hayes,C,25,HOU,71,1,858,42,113,0.372,0,4,0,42,109,0.385,0.372,7,19,0.368,74,176,250,42,34,19,25,134,91
2009,Brendan Haywood,C,29,WAS,6,5,175,24,50,0.48,0,0,NA,24,50,0.48,0.48,10,21,0.476,13,31,44,8,4,15,9,14,58
2009,Luther Head,PG,26,HOU,22,4,322,39,101,0.386,14,38,0.368,25,63,0.397,0.455,14,16,0.875,3,24,27,35,6,1,16,15,106
2009,Luther Head,SG,26,MIA,10,0,176,16,43,0.372,6,16,0.375,10,27,0.37,0.442,5,8,0.625,3,22,25,23,11,1,9,22,43
2009,Walter Herrmann,SF,29,DET,59,0,630,82,207,0.396,41,120,0.342,41,87,0.471,0.495,19,25,0.76,28,79,107,22,7,4,17,43,224
2009,Roy Hibbert,C,22,IND,70,42,1009,198,420,0.471,0,0,NA,198,420,0.471,0.471,98,147,0.667,115,128,243,49,20,76,55,215,494
2009,J.J. Hickson,C,20,CLE,62,0,705,100,194,0.515,0,0,NA,100,194,0.515,0.515,45,67,0.672,52,113,165,9,14,30,45,81,245
2009,Nenê,C,26,DEN,77,76,2510,428,709,0.604,1,5,0.2,427,704,0.607,0.604,266,368,0.723,183,415,598,108,95,101,147,278,1123
2009,George Hill,PG,22,SAS,77,7,1270,150,372,0.403,24,73,0.329,126,299,0.421,0.435,114,146,0.781,30,128,158,136,45,21,74,150,438
2009,Kirk Hinrich,SG,28,CHI,51,4,1339,183,419,0.437,69,169,0.408,114,250,0.456,0.519,68,86,0.791,16,107,123,197,66,19,87,126,503
2009,Ryan Hollins,C,24,CHA,18,1,184,19,35,0.543,0,0,NA,19,35,0.543,0.543,26,39,0.667,19,17,36,4,3,17,10,34,64
2009,Ryan Hollins,C,24,DAL,27,2,260,31,59,0.525,0,0,NA,31,59,0.525,0.525,17,33,0.515,27,34,61,3,4,15,14,44,79
2009,Eddie House,PG,30,BOS,81,0,1479,249,560,0.445,151,340,0.444,98,220,0.445,0.579,42,53,0.792,11,146,157,92,61,7,55,113,691
2009,Josh Howard,SF,28,DAL,52,51,1663,353,783,0.451,58,168,0.345,295,615,0.48,0.488,172,220,0.782,59,204,263,83,55,30,89,135,936
2009,Juwan Howard,PF,35,DEN,3,0,22,1,2,0.5,0,0,NA,1,2,0.5,0.5,0,0,NA,1,3,4,2,1,1,0,4,2
2009,Juwan Howard,SF,35,CHA,39,2,450,74,145,0.51,0,0,NA,74,145,0.51,0.51,23,34,0.676,29,43,72,24,6,5,26,67,171
2009,Larry Hughes,SF,30,CHI,30,6,792,127,308,0.412,40,102,0.392,87,206,0.422,0.477,67,82,0.817,6,88,94,59,36,9,36,51,361
2009,Larry Hughes,SG,30,NYK,25,14,687,97,249,0.39,35,91,0.385,62,158,0.392,0.46,50,63,0.794,10,55,65,60,36,5,35,45,279
2009,Kris Humphries,SF,23,TOR,29,0,265,38,90,0.422,0,0,NA,38,90,0.422,0.422,38,48,0.792,24,46,70,10,8,6,8,31,114
2009,D.J. Mbenga,C,28,LAL,23,0,181,27,57,0.474,0,1,0,27,56,0.482,0.474,7,8,0.875,9,22,31,9,10,24,13,33,61
2009,Allen Iverson,SG,33,DEN,3,3,123,18,40,0.45,2,8,0.25,16,32,0.5,0.475,18,25,0.72,3,5,8,20,3,1,10,3,56
2009,Allen Iverson,PG,33,DET,54,50,1970,330,794,0.416,26,91,0.286,304,703,0.432,0.432,253,322,0.786,27,138,165,263,85,5,136,83,939
2009,Royal Ivey,SG,27,PHI,71,0,861,69,208,0.332,39,114,0.342,30,94,0.319,0.425,34,43,0.791,19,57,76,43,36,7,23,76,211
2009,Jarrett Jack,SG,25,IND,82,53,2716,386,853,0.453,78,221,0.353,308,632,0.487,0.498,224,263,0.852,44,232,276,338,88,17,184,179,1074
2009,Bobby Jackson,PG,35,SAC,71,10,1484,193,485,0.398,60,197,0.305,133,288,0.462,0.46,86,101,0.851,42,158,200,143,62,4,66,100,532
2009,Darnell Jackson,PF,23,CLE,51,2,430,37,86,0.43,0,2,0,37,84,0.44,0.43,24,35,0.686,32,55,87,8,10,4,14,77,98
2009,Stephen Jackson,SF,30,GSW,59,59,2339,413,997,0.414,103,305,0.338,310,692,0.448,0.466,294,356,0.826,70,233,303,381,88,31,229,153,1223
2009,Mike James,PG,33,NOH,8,0,74,8,25,0.32,3,4,0.75,5,21,0.238,0.38,1,2,0.5,1,6,7,8,2,0,3,7,20
2009,Mike James,PG,33,WAS,53,50,1575,189,489,0.387,66,180,0.367,123,309,0.398,0.454,67,80,0.838,24,102,126,193,42,6,91,101,511
2009,Antawn Jamison,PF,32,WAS,81,81,3096,674,1441,0.468,112,319,0.351,562,1122,0.501,0.507,341,452,0.754,196,525,721,153,95,25,125,218,1801
2009,Richard Jefferson,SF,28,MIL,82,82,2939,537,1222,0.439,116,292,0.397,421,930,0.453,0.487,417,518,0.805,57,317,374,199,66,14,165,252,1607
2009,Jared Jeffries,SF,27,NYK,56,36,1310,120,273,0.44,1,12,0.083,119,261,0.456,0.441,55,90,0.611,128,103,231,80,47,33,65,153,296
2009,Anthony Johnson,PG,34,ORL,80,12,1481,154,381,0.404,52,133,0.391,102,248,0.411,0.472,61,81,0.753,29,118,147,200,46,5,82,111,421
2009,Joe Johnson,SG,27,ATL,79,79,3124,620,1420,0.437,149,414,0.36,471,1006,0.468,0.489,299,362,0.826,65,281,346,455,84,19,195,176,1688
2009,Linton Johnson,PF,28,CHA,2,0,13,0,0,NA,0,0,NA,0,0,NA,NA,0,0,NA,0,0,0,0,0,0,0,1,0
2009,Linton Johnson,PF,28,CHI,8,0,42,4,11,0.364,1,2,0.5,3,9,0.333,0.409,0,0,NA,3,5,8,2,1,0,2,6,9
2009,Trey Johnson,SG,24,CLE,4,0,14,0,5,0,0,0,NA,0,5,0,0,4,4,1,0,1,1,0,0,0,1,4,4
2009,Dahntay Jones,SG,28,DEN,79,71,1426,154,336,0.458,11,17,0.647,143,319,0.448,0.475,110,151,0.728,58,110,168,78,49,19,68,199,429
2009,Damon Jones,PG,32,MIL,18,0,108,11,34,0.324,11,28,0.393,0,6,0,0.485,0,0,NA,0,6,6,7,3,0,6,4,33
2009,Fred Jones,SF,29,LAC,52,21,1495,129,317,0.407,54,147,0.367,75,170,0.441,0.492,66,81,0.815,23,103,126,188,53,11,66,112,378
2009,Solomon Jones,C,24,ATL,63,0,675,67,111,0.604,1,2,0.5,66,109,0.606,0.608,53,74,0.716,52,90,142,15,7,34,27,125,188
2009,DeAndre Jordan,C,20,LAC,53,13,771,93,147,0.633,0,0,NA,93,147,0.633,0.633,42,109,0.385,72,165,237,11,11,59,41,96,228
2009,Jason Kidd,PG,35,DAL,81,81,2886,257,618,0.416,131,323,0.406,126,295,0.427,0.522,86,105,0.819,85,415,500,702,160,39,185,168,731
2009,Brevin Knight,PG,33,UTA,74,0,938,66,189,0.349,0,6,0,66,183,0.361,0.349,48,64,0.75,13,75,88,190,68,4,66,98,180
2009,Kyle Korver,SF,27,UTA,78,2,1874,245,560,0.438,103,267,0.386,142,293,0.485,0.529,112,127,0.882,35,223,258,137,47,30,90,170,705
2009,Kosta Koufos,C,19,UTA,48,7,565,94,185,0.508,0,0,NA,94,185,0.508,0.508,36,51,0.706,50,88,138,20,12,31,26,70,224
2009,Nenad Krstić,C,25,OKC,46,29,1141,191,407,0.469,0,0,NA,191,407,0.469,0.469,63,79,0.797,85,168,253,29,21,49,45,114,445
2009,Carl Landry,PF,25,HOU,69,0,1467,240,418,0.574,1,3,0.333,239,415,0.576,0.575,157,193,0.813,124,219,343,39,26,31,68,166,638
2009,Acie Law,PG,24,ATL,55,1,560,52,139,0.374,9,29,0.31,43,110,0.391,0.406,49,60,0.817,6,52,58,86,11,3,29,43,162
2009,Courtney Lee,SG,23,ORL,77,42,1939,243,540,0.45,82,203,0.404,161,337,0.478,0.526,78,94,0.83,18,160,178,91,76,14,69,157,646
2009,David Lee,C,25,NYK,81,74,2824,522,951,0.549,0,3,0,522,948,0.551,0.549,249,330,0.755,256,695,951,174,80,22,150,260,1293
2009,Rashard Lewis,PF,29,ORL,79,79,2859,478,1089,0.439,220,554,0.397,258,535,0.482,0.54,225,269,0.836,92,361,453,205,81,51,158,194,1401
2009,Shaun Livingston,PG,23,MIA,4,0,41,3,8,0.375,0,0,NA,3,8,0.375,0.375,3,4,0.75,0,2,2,4,2,0,3,4,9
2009,Shaun Livingston,PG,23,OKC,8,1,190,28,52,0.538,0,0,NA,28,52,0.538,0.538,6,6,1,3,23,26,16,5,2,6,8,62
2009,Kyle Lowry,PG,22,MEM,49,21,1071,112,272,0.412,17,69,0.246,95,203,0.468,0.443,129,161,0.801,13,98,111,178,48,8,79,89,370
2009,Kyle Lowry,PG,22,HOU,28,0,608,77,162,0.475,8,29,0.276,69,133,0.519,0.5,52,65,0.8,13,65,78,97,21,9,38,57,214
2009,Tyronn Lue,PG,31,MIL,30,0,392,54,119,0.454,21,45,0.467,33,74,0.446,0.542,12,16,0.75,6,29,35,46,6,0,21,41,141
2009,Tyronn Lue,PG,31,ORL,14,0,129,17,43,0.395,6,17,0.353,11,26,0.423,0.465,2,3,0.667,0,11,11,14,2,0,2,13,42
2009,Jamaal Magloire,C,30,MIA,55,12,709,65,131,0.496,0,0,NA,65,131,0.496,0.496,29,60,0.483,82,140,222,22,11,25,32,121,159
2009,Stephon Marbury,PG,31,BOS,23,4,414,38,111,0.342,6,25,0.24,32,86,0.372,0.369,6,13,0.462,2,26,28,75,10,3,37,34,88
2009,Shawn Marion,SF,30,MIA,42,41,1516,215,446,0.482,8,40,0.2,207,406,0.51,0.491,67,85,0.788,107,258,365,77,57,45,56,92,505
2009,Shawn Marion,SF,30,TOR,27,27,954,167,342,0.488,2,13,0.154,165,329,0.502,0.491,50,62,0.806,73,151,224,62,31,21,49,40,386
2009,Donyell Marshall,PF,35,PHI,25,0,189,33,73,0.452,25,55,0.455,8,18,0.444,0.623,3,6,0.5,6,34,40,15,4,5,6,24,94
2009,Cartier Martin,SF,24,CHA,33,1,266,28,77,0.364,10,33,0.303,18,44,0.409,0.429,20,25,0.8,7,26,33,13,8,4,9,33,86
2009,Kevin Martin,SG,25,SAC,51,46,1947,341,811,0.42,115,277,0.415,226,534,0.423,0.491,457,527,0.867,29,154,183,138,61,8,146,116,1254
2009,Desmond Mason,SG,31,OKC,39,19,1064,124,285,0.435,0,3,0,124,282,0.44,0.435,46,85,0.541,41,116,157,46,15,30,56,96,294
2009,Roger Mason,SG,28,SAS,82,71,2496,349,822,0.425,166,394,0.421,183,428,0.428,0.526,105,118,0.89,16,235,251,173,40,12,100,160,969
2009,Luc Mbah a Moute,PF,22,MIL,82,52,2114,227,491,0.462,0,4,0,227,487,0.466,0.462,140,192,0.729,189,298,487,87,87,45,100,204,594
2009,Rashad McCants,SG,24,MIN,34,2,636,105,292,0.36,38,119,0.319,67,173,0.387,0.425,60,81,0.741,11,52,63,32,27,6,45,63,308
2009,Rashad McCants,SG,24,SAC,24,1,465,87,196,0.444,25,70,0.357,62,126,0.492,0.508,47,60,0.783,10,37,47,36,20,8,19,40,246
2009,Antonio McDyess,PF,34,DET,62,30,1866,268,525,0.51,0,0,NA,268,525,0.51,0.51,60,86,0.698,185,422,607,83,41,50,51,191,596
2009,JaVale McGee,C,21,WAS,75,14,1143,191,387,0.494,0,0,NA,191,387,0.494,0.494,107,162,0.66,120,174,294,23,33,75,61,155,489
2009,Tracy McGrady,SG,29,HOU,35,35,1181,188,485,0.388,44,117,0.376,144,368,0.391,0.433,125,156,0.801,20,134,154,175,42,15,69,38,545
2009,Dominic McGuire,SF,23,WAS,79,57,2072,140,324,0.432,2,4,0.5,138,320,0.431,0.435,74,102,0.725,113,315,428,198,62,74,92,153,356
2009,Josh McRoberts,PF,21,IND,33,0,279,35,83,0.422,0,10,0,35,73,0.479,0.422,10,13,0.769,26,48,74,16,12,16,12,41,80
2009,Pops Mensah-Bonsu,PF,25,SAS,3,0,20,5,7,0.714,0,0,NA,5,7,0.714,0.714,5,7,0.714,5,5,10,0,1,1,2,6,15
2009,Pops Mensah-Bonsu,PF,25,TOR,19,0,263,34,96,0.354,0,2,0,34,94,0.362,0.354,28,41,0.683,50,53,103,6,8,4,17,37,96
2009,Chris Mihm,C,29,LAL,18,0,105,15,40,0.375,0,0,NA,15,40,0.375,0.375,6,7,0.857,15,19,34,10,1,6,10,23,36
2009,C.J. Miles,SG,21,UTA,72,72,1623,258,562,0.459,63,179,0.352,195,383,0.509,0.515,78,89,0.876,45,122,167,107,46,15,64,187,657
2009,Darius Miles,SF,27,MEM,34,0,298,48,99,0.485,1,6,0.167,47,93,0.505,0.49,23,31,0.742,19,38,57,17,11,20,21,32,120
2009,Darko Miličić,C,23,MEM,61,15,1034,137,266,0.515,0,0,NA,137,266,0.515,0.515,59,105,0.562,83,181,264,34,22,51,48,134,333
2009,Andre Miller,PG,32,PHI,82,82,2976,492,1041,0.473,15,53,0.283,477,988,0.483,0.48,338,409,0.826,123,245,368,534,109,14,199,196,1337
2009,Brad Miller,C,32,SAC,43,43,1354,184,388,0.474,20,43,0.465,164,345,0.475,0.5,125,156,0.801,83,261,344,148,30,24,83,135,513
2009,Brad Miller,C,32,CHI,27,0,746,108,226,0.478,3,13,0.231,105,213,0.493,0.485,99,116,0.853,67,134,201,86,22,12,47,88,318
2009,Mike Miller,SF,28,MIN,73,47,2356,264,548,0.482,85,225,0.378,179,323,0.554,0.559,109,149,0.732,73,410,483,326,30,31,145,139,722
2009,Cuttino Mobley,SG,33,LAC,11,11,365,63,146,0.432,12,35,0.343,51,111,0.459,0.473,13,18,0.722,9,20,29,12,15,2,18,21,151
2009,Nazr Mohammed,C,31,CHA,39,1,341,41,101,0.406,0,0,NA,41,101,0.406,0.406,22,40,0.55,35,44,79,8,5,16,23,63,104
2009,Jamario Moon,SF,28,TOR,54,39,1379,150,317,0.473,38,110,0.345,112,207,0.541,0.533,55,65,0.846,48,201,249,70,65,44,31,85,393
2009,Jamario Moon,SF,28,MIA,26,21,689,72,157,0.459,27,73,0.37,45,84,0.536,0.545,13,15,0.867,10,106,116,25,21,16,12,48,184
2009,Mikki Moore,PF,33,SAC,46,20,746,63,121,0.521,0,0,NA,63,121,0.521,0.521,34,42,0.81,45,107,152,28,13,14,27,112,160
2009,Mikki Moore,C,33,BOS,24,0,456,51,85,0.6,0,0,NA,51,85,0.6,0.6,14,19,0.737,31,75,106,25,4,5,21,96,116
2009,Adam Morrison,SF,24,CHA,44,5,667,76,211,0.36,31,92,0.337,45,119,0.378,0.434,16,21,0.762,16,56,72,38,9,4,29,73,199
2009,Adam Morrison,SF,24,LAL,8,0,44,4,12,0.333,1,4,0.25,3,8,0.375,0.375,1,2,0.5,2,6,8,3,0,0,3,4,10
2009,Anthony Morrow,SG,23,GSW,67,17,1515,255,534,0.478,86,184,0.467,169,350,0.483,0.558,80,92,0.87,78,121,199,80,36,12,52,130,676
2009,Troy Murphy,PF,28,IND,73,73,2482,364,767,0.475,161,358,0.45,203,409,0.496,0.58,152,184,0.826,146,715,861,172,58,34,114,226,1041
2009,Ronald Murray,SG,29,ATL,80,2,1975,355,795,0.447,87,242,0.36,268,553,0.485,0.501,177,233,0.76,22,146,168,158,88,17,128,173,974
2009,Dikembe Mutombo,C,42,HOU,9,2,96,5,13,0.385,0,0,NA,5,13,0.385,0.385,6,9,0.667,12,21,33,0,0,11,6,11,16
2009,Eduardo Nájera,PF,32,NJN,27,0,319,33,74,0.446,5,25,0.2,28,49,0.571,0.48,8,22,0.364,17,50,67,19,10,4,18,50,79
2009,Jameer Nelson,PG,26,ORL,42,42,1309,267,531,0.503,82,181,0.453,185,350,0.529,0.58,86,97,0.887,20,125,145,226,51,3,83,123,702
2009,Demetris Nichols,SF,24,CHI,2,0,5,1,4,0.25,0,1,0,1,3,0.333,0.25,0,0,NA,0,0,0,1,0,0,0,1,2
2009,Demetris Nichols,SF,24,NYK,2,0,9,2,5,0.4,0,1,0,2,4,0.5,0.4,1,2,0.5,0,2,2,0,0,1,0,0,5
2009,Andrés Nocioni,PF,29,CHI,53,2,1278,186,449,0.414,79,209,0.378,107,240,0.446,0.502,100,124,0.806,34,188,222,60,26,16,73,176,551
2009,Andrés Nocioni,SF,29,SAC,23,16,713,113,252,0.448,45,102,0.441,68,150,0.453,0.538,45,59,0.763,20,119,139,42,13,17,40,85,316
2009,Steve Novak,PF,25,LAC,71,3,1161,176,396,0.444,119,286,0.416,57,110,0.518,0.595,21,23,0.913,19,106,125,40,20,5,23,71,492
2009,Patrick O'Bryant,C,22,BOS,26,0,108,16,31,0.516,0,0,NA,16,31,0.516,0.516,8,12,0.667,7,27,34,8,3,8,17,29,40
2009,Patrick O'Bryant,C,22,TOR,13,3,147,29,53,0.547,0,2,0,29,51,0.569,0.547,3,8,0.375,6,26,32,3,3,11,5,32,61
2009,Jermaine O'Neal,C,30,TOR,41,34,1216,220,465,0.473,0,1,0,220,464,0.474,0.473,115,142,0.81,71,217,288,67,18,82,92,130,555
2009,Jermaine O'Neal,C,30,MIA,27,27,811,145,305,0.475,0,0,NA,145,305,0.475,0.475,60,80,0.75,55,90,145,55,11,54,52,81,350
2009,Shaquille O'Neal,C,36,PHO,75,75,2252,512,841,0.609,0,1,0,512,840,0.61,0.609,309,519,0.595,187,446,633,126,49,108,168,253,1333
2009,Kevin Ollie,PG,36,MIN,50,21,850,61,150,0.407,0,1,0,61,149,0.409,0.407,80,96,0.833,13,62,75,117,19,4,34,79,202
2009,Travis Outlaw,SF,24,POR,81,6,2246,385,850,0.453,89,236,0.377,296,614,0.482,0.505,175,242,0.723,70,261,331,83,47,57,94,168,1034
2009,Sasha Pavlović,SF,25,CLE,66,12,1053,116,275,0.422,48,117,0.41,68,158,0.43,0.509,25,54,0.463,31,96,127,72,22,16,48,122,305
2009,Kendrick Perkins,C,24,BOS,76,76,2253,276,478,0.577,0,2,0,276,476,0.58,0.577,96,160,0.6,204,415,619,96,22,150,165,253,648
2009,Johan Petro,C,23,OKC,22,12,342,46,113,0.407,0,1,0,46,112,0.411,0.407,10,15,0.667,27,68,95,6,16,5,15,51,102
2009,Johan Petro,C,23,DEN,27,10,217,27,63,0.429,0,1,0,27,62,0.435,0.429,6,14,0.429,15,48,63,10,3,10,13,56,60
2009,Mickaël Piétrus,SG,26,ORL,54,25,1329,176,426,0.413,80,223,0.359,96,203,0.473,0.507,78,110,0.709,44,132,176,65,31,24,56,126,510
2009,James Posey,SG,32,NOH,75,0,2140,216,524,0.412,116,314,0.369,100,210,0.476,0.523,120,146,0.822,38,324,362,82,58,21,79,216,668
2009,Leon Powe,PF,25,BOS,70,7,1227,177,338,0.524,0,0,NA,177,338,0.524,0.524,184,267,0.689,145,200,345,46,24,38,76,192,538
2009,Josh Powell,PF,26,LAL,60,1,703,106,239,0.444,0,0,NA,106,239,0.444,0.444,38,50,0.76,71,105,176,27,9,17,51,98,250
2009,Tayshaun Prince,SF,28,DET,82,82,3057,459,1020,0.45,56,141,0.397,403,879,0.458,0.477,189,243,0.778,128,348,476,253,44,51,101,104,1163
2009,Joel Przybilla,C,29,POR,82,43,1952,168,269,0.625,0,1,0,168,268,0.627,0.625,112,169,0.663,204,513,717,27,34,97,78,215,448
2009,Vladimir Radmanović,SF,28,LAL,46,28,771,95,214,0.444,60,136,0.441,35,78,0.449,0.584,23,27,0.852,18,99,117,38,28,7,47,51,273
2009,Vladimir Radmanović,SF,28,CHA,32,3,674,101,252,0.401,45,126,0.357,56,126,0.444,0.49,20,31,0.645,27,78,105,43,18,8,51,60,267
2009,Anthony Randolph,PF,19,GSW,63,22,1129,199,431,0.462,0,4,0,199,427,0.466,0.462,101,141,0.716,128,235,363,49,42,74,80,141,499
2009,Shavlik Randolph,PF,25,POR,10,0,37,8,13,0.615,1,1,1,7,12,0.583,0.654,1,4,0.25,10,8,18,0,0,1,6,4,18
2009,Zach Randolph,C,27,NYK,11,11,388,82,189,0.434,7,24,0.292,75,165,0.455,0.452,55,67,0.821,40,97,137,15,13,3,23,28,226
2009,Zach Randolph,PF,27,LAC,39,34,1369,333,684,0.487,25,73,0.342,308,611,0.504,0.505,124,177,0.701,117,250,367,88,30,13,91,105,815
2009,Theo Ratliff,C,35,PHI,46,0,579,34,64,0.531,0,0,NA,34,64,0.531,0.531,21,35,0.6,46,82,128,9,17,47,14,77,89
2009,J.J. Redick,SG,24,ORL,64,5,1111,117,299,0.391,67,179,0.374,50,120,0.417,0.503,81,93,0.871,8,101,109,73,21,1,54,72,382
2009,Jason Richardson,SG,28,CHA,14,14,491,97,220,0.441,27,59,0.458,70,161,0.435,0.502,41,55,0.745,13,45,58,36,14,3,24,43,262
2009,Jason Richardson,SG,28,PHO,58,57,1919,368,754,0.488,102,266,0.383,266,488,0.545,0.556,112,144,0.778,64,197,261,110,62,25,71,103,950
2009,Jeremy Richardson,SF,24,ORL,12,0,93,14,49,0.286,6,17,0.353,8,32,0.25,0.347,3,6,0.5,1,13,14,3,0,0,3,6,37
2009,Luke Ridnour,PG,27,MIL,72,50,2033,250,621,0.403,55,157,0.35,195,464,0.42,0.447,133,153,0.869,33,185,218,365,92,16,128,200,688
2009,Anthony Roberson,PG,25,NYK,23,0,253,39,103,0.379,24,71,0.338,15,32,0.469,0.495,5,5,1,4,11,15,19,10,1,7,18,107
2009,Anthony Roberson,PG,25,CHI,6,0,23,5,17,0.294,2,10,0.2,3,7,0.429,0.353,0,0,NA,2,5,7,1,0,0,1,0,12
2009,Nate Robinson,PG,24,NYK,74,11,2209,449,1028,0.437,125,385,0.325,324,643,0.504,0.498,249,296,0.841,98,192,290,301,95,6,139,206,1272
2009,Sergio Rodríguez,PG,22,POR,80,13,1225,129,329,0.392,37,114,0.325,92,215,0.428,0.448,61,77,0.792,43,87,130,286,54,2,119,133,356
2009,Rajon Rondo,PG,22,BOS,80,80,2642,383,759,0.505,15,48,0.313,368,711,0.518,0.514,172,268,0.642,100,316,416,659,149,11,209,193,953
2009,Derrick Rose,PG,20,CHI,81,80,3000,574,1208,0.475,16,72,0.222,558,1136,0.491,0.482,197,250,0.788,96,221,317,512,66,18,202,125,1361
2009,Malik Rose,PF,34,NYK,18,0,160,11,41,0.268,0,4,0,11,37,0.297,0.268,8,11,0.727,4,27,31,10,1,1,17,24,30
2009,Malik Rose,PF,34,OKC,20,0,310,34,90,0.378,0,3,0,34,87,0.391,0.378,32,40,0.8,13,52,65,26,9,2,19,48,100
2009,Quinton Ross,SF,27,MEM,68,7,1164,99,259,0.382,33,88,0.375,66,171,0.386,0.446,34,42,0.81,29,97,126,47,32,14,36,114,265
2009,Kareem Rush,SG,28,PHI,25,1,199,20,58,0.345,10,33,0.303,10,25,0.4,0.431,4,4,1,0,15,15,15,5,1,10,10,54
2009,John Salmons,SF,29,SAC,53,53,1980,351,744,0.472,77,184,0.418,274,560,0.489,0.524,191,232,0.823,43,178,221,196,58,9,122,122,970
2009,John Salmons,SF,29,CHI,26,21,979,165,349,0.473,49,118,0.415,116,231,0.502,0.543,97,115,0.843,16,96,112,53,25,15,43,60,476
2009,Cheikh Samb,C,24,DEN,6,0,24,2,13,0.154,0,1,0,2,12,0.167,0.154,0,0,NA,2,7,9,1,2,5,2,4,4
2009,Cheikh Samb,C,24,LAC,10,0,51,4,16,0.25,0,2,0,4,14,0.286,0.25,3,5,0.6,7,6,13,0,1,5,1,3,11
2009,Cheikh Samb,C,24,NYK,2,0,8,0,3,0,0,0,NA,0,3,0,0,0,2,0,1,1,2,0,0,0,0,0,0
2009,Thabo Sefolosha,SF,24,CHI,43,14,735,79,182,0.434,15,50,0.3,64,132,0.485,0.475,21,25,0.84,26,97,123,65,35,19,37,50,194
2009,Thabo Sefolosha,SG,24,OKC,23,22,718,73,175,0.417,9,37,0.243,64,138,0.464,0.443,40,48,0.833,28,91,119,46,40,26,27,54,195
2009,Mouhamed Sene,C,22,OKC,5,0,23,5,7,0.714,0,0,NA,5,7,0.714,0.714,7,9,0.778,3,6,9,0,1,2,3,2,17
2009,Mouhamed Sene,C,22,NYK,1,0,6,1,2,0.5,0,0,NA,1,2,0.5,0.5,1,1,1,2,3,5,0,0,1,1,0,3
2009,Ramon Sessions,PG,22,MIL,79,39,2173,345,775,0.445,6,34,0.176,339,741,0.457,0.449,281,354,0.794,64,205,269,452,83,7,152,158,977
2009,Cedric Simmons,PF,23,CHI,11,0,61,11,21,0.524,0,0,NA,11,21,0.524,0.524,6,14,0.429,4,8,12,2,1,4,0,6,28
2009,Cedric Simmons,PF,23,SAC,7,0,23,0,4,0,0,0,NA,0,4,0,0,1,2,0.5,1,3,4,0,0,0,2,2,1
2009,Courtney Sims,C,25,PHO,1,0,2,0,0,NA,0,0,NA,0,0,NA,NA,0,0,NA,0,0,0,0,0,0,1,0,0
2009,Courtney Sims,C,25,NYK,1,0,11,3,6,0.5,0,0,NA,3,6,0.5,0.5,0,0,NA,2,2,4,0,0,0,0,1,6
2009,Sean Singletary,PG,23,PHO,13,1,122,12,37,0.324,4,10,0.4,8,27,0.296,0.378,6,6,1,5,11,16,12,6,0,5,14,34
2009,Sean Singletary,PG,23,CHA,24,1,181,19,48,0.396,6,15,0.4,13,33,0.394,0.458,12,15,0.8,5,14,19,17,5,0,18,31,56
2009,James Singleton,PF,27,DAL,62,6,884,117,221,0.529,13,40,0.325,104,181,0.575,0.559,67,78,0.859,89,161,250,17,26,28,36,110,314
2009,Brian Skinner,PF,32,LAC,51,21,843,92,205,0.449,0,2,0,92,203,0.453,0.449,30,47,0.638,72,131,203,27,17,52,43,94,214
2009,J.R. Smith,SG,23,DEN,81,18,2245,424,950,0.446,180,453,0.397,244,497,0.491,0.541,205,272,0.754,43,254,297,227,78,14,150,190,1233
2009,Joe Smith,C,33,OKC,36,3,691,99,218,0.454,2,4,0.5,97,214,0.453,0.459,38,54,0.704,53,110,163,25,10,26,15,72,238
2009,Joe Smith,C,33,CLE,21,0,411,57,115,0.496,1,3,0.333,56,112,0.5,0.5,21,28,0.75,36,64,100,16,7,14,10,50,136
2009,Josh Smith,PF,23,ATL,69,69,2421,418,849,0.492,26,87,0.299,392,762,0.514,0.508,211,359,0.588,134,364,498,169,94,111,161,184,1073
2009,Will Solomon,PG,30,TOR,39,9,544,79,181,0.436,15,57,0.263,64,124,0.516,0.478,20,24,0.833,9,34,43,123,20,4,49,60,193
2009,Will Solomon,PG,30,SAC,14,0,168,26,64,0.406,13,29,0.448,13,35,0.371,0.508,5,10,0.5,3,18,21,10,7,0,5,11,70
2009,Marreese Speights,C,21,PHI,79,2,1263,252,502,0.502,2,8,0.25,250,494,0.506,0.504,102,132,0.773,123,170,293,30,27,56,46,181,608
2009,Jerry Stackhouse,SG,34,DAL,10,1,162,16,60,0.267,3,19,0.158,13,41,0.317,0.292,7,7,1,5,12,17,12,4,1,9,6,42
2009,DeShawn Stevenson,SG,27,WAS,32,25,886,72,231,0.312,35,129,0.271,37,102,0.363,0.387,32,60,0.533,11,65,76,98,21,2,32,43,211
2009,Peja Stojaković,SF,31,NOH,61,59,2089,287,719,0.399,145,384,0.378,142,335,0.424,0.5,93,104,0.894,44,220,264,75,52,3,51,101,812
2009,Amar'e Stoudemire,PF,26,PHO,53,53,1948,404,749,0.539,3,7,0.429,401,742,0.54,0.541,323,387,0.835,116,314,430,104,49,57,150,163,1134
2009,Stromile Swift,PF,29,NJN,6,0,64,9,15,0.6,0,0,NA,9,15,0.6,0.6,5,11,0.455,5,8,13,1,0,2,7,15,23
2009,Stromile Swift,PF,29,PHO,13,0,121,15,41,0.366,1,1,1,14,40,0.35,0.378,8,15,0.533,11,22,33,2,4,6,9,25,39
2009,Wally Szczerbiak,SF,31,CLE,74,5,1527,179,398,0.45,69,168,0.411,110,230,0.478,0.536,90,106,0.849,43,189,232,82,28,10,55,130,517
2009,Sebastian Telfair,PG,23,MIN,75,43,2095,267,697,0.383,73,211,0.346,194,486,0.399,0.435,131,160,0.819,32,95,127,343,73,12,146,184,738
2009,Kenny Thomas,PF,31,SAC,8,0,62,3,8,0.375,0,0,NA,3,8,0.375,0.375,0,0,NA,4,11,15,1,6,1,1,9,6
2009,Kurt Thomas,PF,36,SAS,79,10,1404,153,304,0.503,0,2,0,153,302,0.507,0.503,37,45,0.822,134,271,405,66,34,58,42,170,343
2009,Tim Thomas,PF,31,LAC,10,5,220,34,90,0.378,6,20,0.3,28,70,0.4,0.411,21,34,0.618,14,32,46,10,3,1,14,26,95
2009,Tim Thomas,PF,31,NYK,36,1,773,119,258,0.461,53,126,0.421,66,132,0.5,0.564,54,67,0.806,20,93,113,46,22,10,46,91,345
2009,Tim Thomas,PF,31,CHI,18,0,254,36,90,0.4,19,43,0.442,17,47,0.362,0.506,14,20,0.7,8,34,42,12,6,0,10,27,105
2009,Tyrus Thomas,PF,22,CHI,79,61,2175,308,683,0.451,3,9,0.333,305,674,0.453,0.453,238,304,0.783,148,360,508,77,91,151,129,220,857
2009,Jason Thompson,PF,22,SAC,82,56,2303,356,717,0.497,0,8,0,356,709,0.502,0.497,198,286,0.692,234,372,606,93,46,59,146,314,910
2009,Al Thornton,SF,25,LAC,71,67,2654,469,1051,0.446,20,79,0.253,449,972,0.462,0.456,236,313,0.754,122,246,368,103,59,62,130,227,1194
2009,Anthony Tolliver,PF,23,SAS,19,0,208,19,65,0.292,9,41,0.22,10,24,0.417,0.362,5,10,0.5,12,29,41,17,5,1,7,16,52
2009,Alando Tucker,SG,24,PHO,30,1,282,52,121,0.43,8,23,0.348,44,98,0.449,0.463,26,33,0.788,19,12,31,12,5,1,14,14,138
2009,Ronny Turiaf,C,26,GSW,79,26,1696,186,366,0.508,0,3,0,186,363,0.512,0.508,98,124,0.79,88,272,360,166,34,168,70,243,470
2009,Hedo Türkoğlu,SF,29,ORL,77,77,2815,423,1025,0.413,134,376,0.356,289,649,0.445,0.478,314,389,0.807,45,365,410,375,64,19,204,218,1294
2009,Beno Udrih,PG,26,SAC,73,72,2270,321,696,0.461,35,113,0.31,286,583,0.491,0.486,123,150,0.82,46,174,220,342,81,12,158,192,800
2009,Anderson Varejão,PF,26,CLE,81,42,2306,270,504,0.536,0,2,0,270,502,0.538,0.536,154,250,0.616,166,415,581,81,75,66,80,239,694
2009,Sasha Vujačić,SG,24,LAL,80,0,1293,155,401,0.387,81,223,0.363,74,178,0.416,0.488,70,76,0.921,19,116,135,113,77,7,35,154,461
2009,Dwyane Wade,SG,27,MIA,79,79,3048,854,1739,0.491,88,278,0.317,766,1461,0.524,0.516,590,771,0.765,89,309,398,589,173,106,272,178,2386
2009,Von Wafer,SG,23,HOU,63,11,1225,229,512,0.447,64,164,0.39,165,348,0.474,0.51,88,117,0.752,19,94,113,71,40,8,59,71,610
2009,Henry Walker,SF,21,BOS,29,0,216,36,58,0.621,0,1,0,36,57,0.632,0.621,16,23,0.696,8,21,29,13,6,2,18,51,88
2009,Ben Wallace,PF,34,CLE,56,53,1314,69,155,0.445,0,0,NA,69,155,0.445,0.445,27,64,0.422,136,226,362,44,48,75,34,82,165
2009,Gerald Wallace,SF,26,CHA,71,71,2669,389,811,0.48,39,131,0.298,350,680,0.515,0.504,365,454,0.804,112,441,553,189,121,67,148,210,1182
2009,Rasheed Wallace,C,34,DET,66,63,2123,302,720,0.419,113,319,0.354,189,401,0.471,0.498,78,101,0.772,56,434,490,91,62,86,59,197,795
2009,Luke Walton,SF,28,LAL,65,34,1166,134,307,0.436,17,57,0.298,117,250,0.468,0.464,41,57,0.719,55,125,180,177,32,10,69,105,326
2009,Hakim Warrick,PF,26,MEM,82,7,2029,340,693,0.491,5,23,0.217,335,670,0.5,0.494,266,374,0.711,129,277,406,66,48,39,98,170,951
2009,Earl Watson,PG,29,OKC,68,18,1776,174,453,0.384,20,85,0.235,154,368,0.418,0.406,80,106,0.755,36,147,183,391,50,11,156,137,448
2009,Sonny Weems,SG,22,DEN,12,0,55,8,25,0.32,0,3,0,8,22,0.364,0.32,3,8,0.375,0,4,4,3,1,0,6,8,19
2009,Delonte West,SG,25,CLE,64,64,2152,285,624,0.457,91,228,0.399,194,396,0.49,0.53,90,108,0.833,31,172,203,226,94,13,92,125,751
2009,D.J. White,PF,22,OKC,7,0,130,26,50,0.52,0,0,NA,26,50,0.52,0.52,10,13,0.769,10,22,32,6,3,5,3,10,62
2009,Chris Wilcox,C,26,OKC,37,6,719,130,268,0.485,0,3,0,130,265,0.491,0.485,52,87,0.598,65,130,195,33,18,11,55,89,312
2009,Chris Wilcox,C,26,NYK,25,0,330,54,102,0.529,0,1,0,54,101,0.535,0.529,27,53,0.509,31,51,82,14,8,5,20,48,135
2009,Deron Williams,PG,24,UTA,68,68,2505,463,984,0.471,70,226,0.31,393,758,0.518,0.506,326,384,0.849,24,171,195,725,73,20,228,134,1322
2009,Lou Williams,SG,22,PHI,81,0,1919,336,844,0.398,63,220,0.286,273,624,0.438,0.435,304,385,0.79,36,129,165,242,85,14,151,128,1039
2009,Marcus Williams,PG,23,GSW,9,0,54,4,17,0.235,2,6,0.333,2,11,0.182,0.294,2,6,0.333,0,4,4,13,1,1,4,6,12
2009,Marcus Williams,PF,22,SAS,2,0,3,2,2,1,0,0,NA,2,2,1,1,0,0,NA,0,0,0,0,0,0,0,1,4
2009,Marvin Williams,SF,22,ATL,61,59,2093,285,622,0.458,55,155,0.355,230,467,0.493,0.502,220,273,0.806,110,272,382,81,57,39,70,127,845
2009,Mo Williams,PG,26,CLE,81,81,2834,526,1126,0.467,183,420,0.436,343,706,0.486,0.548,208,228,0.912,47,232,279,329,69,9,179,215,1443
2009,Sean Williams,PF,22,NJN,33,0,366,30,72,0.417,0,0,NA,30,72,0.417,0.417,20,32,0.625,34,45,79,13,7,29,20,72,80
2009,Shawne Williams,SF,22,DAL,15,0,170,16,56,0.286,1,17,0.059,15,39,0.385,0.295,9,11,0.818,19,27,46,2,2,9,5,19,42
2009,Shelden Williams,PF,25,SAC,30,0,305,40,89,0.449,0,2,0,40,87,0.46,0.449,32,42,0.762,25,53,78,8,12,10,26,36,112
2009,Shelden Williams,PF,25,MIN,15,0,207,30,68,0.441,0,0,NA,30,68,0.441,0.441,14,21,0.667,24,51,75,4,10,8,8,28,74
2009,Metta World Peace,SF,29,HOU,69,55,2452,416,1037,0.401,153,383,0.399,263,654,0.402,0.475,196,262,0.748,65,294,359,229,105,24,140,155,1181
2009,Antoine Wright,SF,24,DAL,65,53,1552,179,431,0.415,45,149,0.302,134,282,0.475,0.468,71,95,0.747,31,105,136,77,46,27,54,172,474
2009,Brandan Wright,PF,21,GSW,39,23,688,130,246,0.528,0,4,0,130,242,0.537,0.528,63,85,0.741,62,95,157,21,22,37,23,74,323
2009,Lorenzen Wright,C,33,CLE,17,2,125,10,27,0.37,0,0,NA,10,27,0.37,0.37,3,8,0.375,7,18,25,3,4,5,9,17,23
2009,Nick Young,SG,23,WAS,82,5,1837,336,756,0.444,56,164,0.341,280,592,0.473,0.481,164,193,0.85,31,119,150,95,39,20,92,140,892
2009,Thaddeus Young,PF,20,PHI,75,71,2580,475,960,0.495,56,164,0.341,419,796,0.526,0.524,139,189,0.735,139,238,377,86,100,23,118,165,1145
2010,Arron Afflalo,SG,24,DEN,82,75,2221,272,585,0.465,108,249,0.434,164,336,0.488,0.557,72,98,0.735,59,193,252,138,46,30,74,225,724
2010,Alexis Ajinça,C,21,CHA,6,0,30,5,10,0.5,0,0,NA,5,10,0.5,0.5,0,1,0,1,3,4,0,1,1,2,5,10
2010,LaMarcus Aldridge,PF,24,POR,78,78,2922,579,1169,0.495,5,16,0.313,574,1153,0.498,0.497,230,304,0.757,192,435,627,160,67,48,104,231,1393
2010,Malik Allen,PF,31,DEN,51,3,456,46,116,0.397,1,6,0.167,45,110,0.409,0.401,12,13,0.923,36,46,82,16,11,5,22,68,105
2010,Ray Allen,SG,34,BOS,80,80,2819,464,973,0.477,145,399,0.363,319,574,0.556,0.551,231,253,0.913,45,208,253,210,64,25,129,182,1304
2010,Rafer Alston,PG,33,NJN,27,13,766,95,277,0.343,28,87,0.322,67,190,0.353,0.394,44,54,0.815,9,66,75,104,27,5,61,50,262
2010,Rafer Alston,PG,33,MIA,25,25,655,60,169,0.355,30,81,0.37,30,88,0.341,0.444,15,27,0.556,4,50,54,72,23,5,34,53,165
2010,Lou Amundson,PF,27,PHO,79,0,1168,152,276,0.551,0,1,0,152,275,0.553,0.551,67,123,0.545,128,218,346,31,24,73,57,169,371
2010,Chris Andersen,PF,31,DEN,76,0,1695,142,251,0.566,0,3,0,142,248,0.573,0.566,164,236,0.695,147,336,483,33,42,143,59,171,448
2010,David Andersen,C,29,HOU,63,0,891,147,340,0.432,27,78,0.346,120,262,0.458,0.472,46,67,0.687,54,154,208,44,15,12,37,119,367
2010,Ryan Anderson,PF,21,ORL,63,6,911,169,388,0.436,78,211,0.37,91,177,0.514,0.536,71,82,0.866,70,132,202,37,25,14,56,81,487
2010,Carmelo Anthony,SF,25,DEN,69,69,2634,688,1502,0.458,59,187,0.316,629,1315,0.478,0.478,508,612,0.83,152,302,454,222,88,30,209,225,1943
2010,Joel Anthony,C,27,MIA,80,16,1322,76,159,0.478,0,0,NA,76,159,0.478,0.478,66,92,0.717,123,126,249,12,20,109,45,158,218
2010,Gilbert Arenas,PG,28,WAS,32,32,1169,253,616,0.411,63,181,0.348,190,435,0.437,0.462,153,207,0.739,17,116,133,230,41,9,117,95,722
2010,Trevor Ariza,SF,24,HOU,72,71,2629,394,999,0.394,136,407,0.334,258,592,0.436,0.462,148,228,0.649,78,325,403,276,126,40,161,162,1072
2010,Hilton Armstrong,PF,25,NOH,18,0,239,19,50,0.38,0,0,NA,19,50,0.38,0.38,13,28,0.464,17,44,61,16,8,8,13,44,51
2010,Hilton Armstrong,C,25,SAC,6,0,56,4,12,0.333,0,0,NA,4,12,0.333,0.333,2,2,1,5,9,14,2,2,4,4,5,10
2010,Hilton Armstrong,C,25,HOU,9,0,40,5,17,0.294,0,1,0,5,16,0.313,0.294,0,2,0,5,1,6,3,5,0,5,10,10
2010,Carlos Arroyo,PG,30,MIA,72,35,1585,178,375,0.475,7,25,0.28,171,350,0.489,0.484,76,90,0.844,26,104,130,225,36,6,54,102,439
2010,Chucky Atkins,PG,35,DET,40,11,644,57,157,0.363,22,73,0.301,35,84,0.417,0.433,25,27,0.926,5,24,29,91,17,0,32,53,161
2010,D.J. Augustin,PG,22,CHA,80,2,1472,168,435,0.386,70,178,0.393,98,257,0.381,0.467,102,131,0.779,11,86,97,193,45,5,74,127,508
2010,Renaldo Balkman,SF,25,DEN,13,1,91,6,18,0.333,0,7,0,6,11,0.545,0.333,2,6,0.333,4,19,23,7,8,2,6,16,14
2010,Marcus Banks,PG,28,TOR,22,0,244,39,73,0.534,7,24,0.292,32,49,0.653,0.582,24,29,0.828,3,20,23,26,12,2,20,30,109
2010,Leandro Barbosa,PG,27,PHO,44,5,786,155,365,0.425,44,136,0.324,111,229,0.485,0.485,64,73,0.877,11,58,69,64,23,12,46,71,418
2010,Matt Barnes,SF,29,ORL,81,58,2097,271,557,0.487,66,207,0.319,205,350,0.586,0.546,108,146,0.74,106,339,445,134,59,30,112,185,716
2010,Earl Barron,C,28,NYK,7,6,232,30,68,0.441,0,0,NA,30,68,0.441,0.441,22,29,0.759,31,46,77,8,4,4,11,24,82
2010,Tony Battie,C,33,NJN,15,0,134,14,40,0.35,1,4,0.25,13,36,0.361,0.363,7,10,0.7,4,19,23,3,4,2,3,19,36
2010,Shane Battier,SG,31,HOU,67,62,2168,178,447,0.398,101,279,0.362,77,168,0.458,0.511,77,106,0.726,74,238,312,164,53,76,64,139,534
2010,Jerryd Bayless,SG,21,POR,74,11,1304,200,483,0.414,29,92,0.315,171,391,0.437,0.444,201,242,0.831,18,102,120,172,26,5,94,152,630
2010,Marco Belinelli,SG,23,TOR,66,1,1121,154,379,0.406,60,158,0.38,94,221,0.425,0.485,101,121,0.835,14,81,95,89,42,5,60,80,469
2010,Charlie Bell,SG,30,MIL,71,39,1611,169,443,0.381,73,200,0.365,96,243,0.395,0.464,48,67,0.716,31,101,132,104,39,12,54,136,459
2010,Raja Bell,SG,33,CHA,5,5,157,24,55,0.436,9,24,0.375,15,31,0.484,0.518,3,3,1,5,16,21,10,4,2,5,13,60
2010,Raja Bell,SG,33,GSW,1,0,23,4,6,0.667,3,3,1,1,3,0.333,0.917,0,0,NA,0,2,2,3,0,0,0,2,11
2010,Mike Bibby,PG,31,ATL,80,80,2195,268,644,0.416,126,324,0.389,142,320,0.444,0.514,68,79,0.861,20,164,184,310,67,3,90,157,730
2010,Chauncey Billups,PG,33,DEN,73,73,2490,402,962,0.418,157,407,0.386,245,555,0.441,0.499,466,512,0.91,25,203,228,409,82,9,177,153,1427
2010,Steve Blake,PG,29,POR,51,28,1397,143,355,0.403,78,207,0.377,65,148,0.439,0.513,24,32,0.75,15,103,118,203,37,2,65,84,388
2010,Steve Blake,PG,29,LAC,29,10,762,74,167,0.443,38,87,0.437,36,80,0.45,0.557,12,16,0.75,6,63,69,177,21,4,63,39,198
2010,Keith Bogans,SF,29,SAS,79,50,1559,120,298,0.403,70,196,0.357,50,102,0.49,0.52,37,50,0.74,25,151,176,95,45,12,53,156,347
2010,Andrew Bogut,C,25,MIL,69,69,2229,473,910,0.52,0,2,0,473,908,0.521,0.52,149,237,0.629,208,493,701,127,39,175,131,222,1095
2010,Earl Boykins,PG,33,WAS,67,1,1117,172,403,0.427,19,60,0.317,153,343,0.446,0.45,77,89,0.865,17,58,75,171,24,3,69,48,440
2010,Corey Brewer,SG,23,MIN,82,82,2482,409,949,0.431,82,237,0.346,327,712,0.459,0.474,166,256,0.648,70,209,279,193,117,29,164,224,1066
2010,Ronnie Brewer,SG,24,UTA,53,53,1662,206,416,0.495,8,31,0.258,198,385,0.514,0.505,81,128,0.633,44,136,180,151,85,15,51,80,501
2010,Ronnie Brewer,SG,24,MEM,5,0,80,3,13,0.231,0,0,NA,3,13,0.231,0.231,4,5,0.8,1,6,7,3,6,0,2,0,10
2010,Primož Brezec,C,30,PHI,7,0,36,2,13,0.154,0,0,NA,2,13,0.154,0.154,1,2,0.5,6,6,12,0,1,1,0,9,5
2010,Primož Brezec,C,30,MIL,14,0,59,7,13,0.538,0,0,NA,7,13,0.538,0.538,0,4,0,6,7,13,1,0,2,2,10,14
2010,Aaron Brooks,PG,25,HOU,82,82,2919,575,1331,0.432,209,525,0.398,366,806,0.454,0.511,245,298,0.822,54,161,215,434,69,14,232,199,1604
2010,Bobby Brown,PG,25,NOH,22,0,328,60,152,0.395,17,66,0.258,43,86,0.5,0.451,8,8,1,1,17,18,46,9,1,24,28,145
2010,Bobby Brown,PG,25,LAC,23,0,191,28,85,0.329,9,32,0.281,19,53,0.358,0.382,5,7,0.714,8,12,20,42,6,0,22,14,70
2010,Derrick Brown,SF,22,CHA,57,0,535,68,147,0.463,2,7,0.286,66,140,0.471,0.469,48,72,0.667,31,47,78,19,21,10,19,53,186
2010,Devin Brown,SG,31,NOH,39,37,967,128,325,0.394,54,147,0.367,74,178,0.416,0.477,69,86,0.802,27,82,109,58,30,5,57,62,379
2010,Devin Brown,SG,31,CHI,11,0,93,8,36,0.222,4,17,0.235,4,19,0.211,0.278,0,0,NA,2,13,15,7,3,1,5,10,20
2010,Kwame Brown,C,27,DET,48,1,660,62,124,0.5,0,1,0,62,123,0.504,0.5,33,98,0.337,53,124,177,22,15,12,43,93,157
2010,Shannon Brown,SG,24,LAL,82,7,1700,253,592,0.427,62,189,0.328,191,403,0.474,0.48,99,121,0.818,30,153,183,108,57,31,67,129,667
2010,Chase Budinger,SF,21,HOU,74,4,1488,249,565,0.441,92,249,0.369,157,316,0.497,0.522,67,87,0.77,38,182,220,88,34,11,48,85,657
2010,Caron Butler,SF,29,WAS,47,47,1853,293,694,0.422,25,95,0.263,268,599,0.447,0.44,185,211,0.877,68,248,316,107,68,15,113,126,796
2010,Caron Butler,SG,29,DAL,27,27,930,157,357,0.44,17,50,0.34,140,307,0.456,0.464,79,104,0.76,36,109,145,49,48,9,47,67,410
2010,Rasual Butler,SF,30,LAC,82,64,2702,356,870,0.409,145,432,0.336,211,438,0.482,0.493,122,145,0.841,39,201,240,116,36,68,79,121,979
2010,Andrew Bynum,C,22,LAL,65,65,1977,392,688,0.57,0,1,0,392,687,0.571,0.57,193,261,0.739,177,364,541,68,35,94,115,193,977
2010,José Calderón,PG,28,TOR,68,39,1817,274,568,0.482,68,171,0.398,206,397,0.519,0.542,83,104,0.798,23,119,142,404,47,7,99,135,699
2010,Marcus Camby,PF,35,LAC,51,51,1596,166,356,0.466,2,6,0.333,164,350,0.469,0.469,60,91,0.659,166,450,616,151,69,99,64,105,394
2010,Marcus Camby,C,35,POR,23,23,718,72,145,0.497,0,1,0,72,144,0.5,0.497,18,31,0.581,83,172,255,35,26,47,27,56,162
2010,Rodney Carney,SG,25,PHI,68,0,857,113,282,0.401,41,135,0.304,72,147,0.49,0.473,52,63,0.825,26,111,137,37,25,20,21,79,319
2010,DeMarre Carroll,SF,23,MEM,71,1,795,88,222,0.396,0,6,0,88,216,0.407,0.396,33,53,0.623,53,97,150,33,28,9,24,107,209
2010,Matt Carroll,SG,29,DAL,25,0,121,18,50,0.36,4,19,0.211,14,31,0.452,0.4,6,6,1,4,8,12,6,5,0,7,13,46
2010,Anthony Carter,PG,34,DEN,54,7,859,76,181,0.42,17,63,0.27,59,118,0.5,0.467,11,13,0.846,17,72,89,160,39,13,58,72,180
2010,Vince Carter,SG,33,ORL,75,74,2310,434,1015,0.428,119,324,0.367,315,691,0.456,0.486,257,306,0.84,33,260,293,236,53,18,106,189,1244
2010,Omri Casspi,SF,21,SAC,77,31,1931,300,672,0.446,75,203,0.369,225,469,0.48,0.502,117,174,0.672,75,274,349,95,54,17,98,125,792
2010,Mario Chalmers,PG,23,MIA,73,22,1807,182,454,0.401,75,236,0.318,107,218,0.491,0.483,82,110,0.745,25,110,135,246,91,12,123,175,521
2010,Tyson Chandler,C,27,CHA,51,27,1163,109,190,0.574,0,0,NA,109,190,0.574,0.574,115,157,0.732,114,206,320,16,17,55,91,138,333
2010,Wilson Chandler,SG,22,NYK,65,64,2320,412,860,0.479,40,150,0.267,372,710,0.524,0.502,129,160,0.806,93,255,348,138,46,49,108,184,993
2010,Earl Clark,PF,22,PHO,51,0,383,56,151,0.371,2,5,0.4,54,146,0.37,0.377,26,36,0.722,18,44,62,21,7,13,23,25,140
2010,Jarron Collins,C,31,PHO,34,10,261,12,31,0.387,0,0,NA,12,31,0.387,0.387,10,25,0.4,22,40,62,6,2,3,10,42,34
2010,Jason Collins,C,31,ATL,24,0,115,8,23,0.348,0,1,0,8,22,0.364,0.348,0,2,0,5,9,14,4,3,2,5,21,16
2010,Mardy Collins,SG,25,LAC,43,0,470,47,128,0.367,4,17,0.235,43,111,0.387,0.383,13,21,0.619,13,37,50,44,23,1,32,45,111
2010,Will Conroy,PG,27,HOU,5,0,36,3,10,0.3,0,3,0,3,7,0.429,0.3,0,2,0,0,3,3,7,0,0,4,5,6
2010,Brian Cook,PF,29,HOU,15,0,44,7,23,0.304,2,9,0.222,5,14,0.357,0.348,5,7,0.714,1,8,9,1,0,2,6,5,21
2010,Daequan Cook,SG,22,MIA,45,3,691,81,253,0.32,40,126,0.317,41,127,0.323,0.399,21,25,0.84,9,73,82,43,14,10,24,50,223
2010,Jamal Crawford,SG,29,ATL,79,0,2460,496,1105,0.449,163,427,0.382,333,678,0.491,0.523,270,315,0.857,34,167,201,238,61,12,137,132,1425
2010,Dante Cunningham,PF,22,POR,63,2,707,106,214,0.495,0,2,0,106,212,0.5,0.495,31,48,0.646,54,106,160,14,24,22,15,97,243
2010,Baron Davis,PG,30,LAC,75,73,2523,412,1015,0.406,82,296,0.277,330,719,0.459,0.446,239,291,0.821,52,214,266,598,126,43,211,210,1145
2010,Glen Davis,PF,24,BOS,54,1,933,122,279,0.437,0,4,0,122,275,0.444,0.437,96,138,0.696,101,104,205,35,21,14,53,132,340
2010,Ricky Davis,SF,30,LAC,36,2,499,62,143,0.434,16,42,0.381,46,101,0.455,0.49,18,31,0.581,10,47,57,39,11,3,29,39,158
2010,Austin Daye,SF,21,DET,69,4,915,137,295,0.464,29,95,0.305,108,200,0.54,0.514,46,56,0.821,34,140,174,34,25,26,48,114,349
2010,Luol Deng,SF,24,CHI,70,69,2651,473,1014,0.466,32,83,0.386,441,931,0.474,0.482,252,330,0.764,131,381,512,143,66,61,134,129,1230
2010,Boris Diaw,PF,27,CHA,82,82,2906,373,773,0.483,66,206,0.32,307,567,0.541,0.525,113,147,0.769,131,293,424,325,60,57,178,219,925
2010,Travis Diener,PG,27,IND,4,0,25,1,6,0.167,1,5,0.2,0,1,0,0.25,0,2,0,0,2,2,4,3,0,0,1,3
2010,Travis Diener,PG,27,POR,5,0,26,1,4,0.25,0,2,0,1,2,0.5,0.25,1,2,0.5,0,1,1,4,1,0,0,1,3
2010,DeSagana Diop,C,28,CHA,27,0,262,15,29,0.517,0,0,NA,15,29,0.517,0.517,2,9,0.222,24,41,65,5,5,14,12,31,32
2010,Joey Dorsey,PF,26,HOU,7,0,54,5,11,0.455,0,0,NA,5,11,0.455,0.455,1,2,0.5,11,14,25,2,2,1,4,12,11
2010,Joey Dorsey,PF,26,SAC,8,0,52,4,9,0.444,0,0,NA,4,9,0.444,0.444,4,10,0.4,5,13,18,0,1,1,2,9,12
2010,Toney Douglas,PG,23,NYK,56,12,1087,179,391,0.458,68,175,0.389,111,216,0.514,0.545,55,68,0.809,40,68,108,112,42,3,55,116,481
2010,Goran Dragić,PG,23,PHO,80,2,1442,222,491,0.452,74,188,0.394,148,303,0.488,0.527,117,159,0.736,38,133,171,241,48,8,126,131,635
2010,Jared Dudley,SF,24,PHO,82,1,1991,225,490,0.459,120,262,0.458,105,228,0.461,0.582,104,138,0.754,99,182,281,115,81,16,68,162,674
2010,Mike Dunleavy,SF,29,IND,67,15,1486,229,558,0.41,75,236,0.318,154,322,0.478,0.478,133,158,0.842,25,211,236,103,38,15,72,105,666
2010,Wayne Ellington,SG,22,MIN,76,1,1384,190,448,0.424,64,162,0.395,126,286,0.441,0.496,61,70,0.871,33,126,159,74,20,5,74,72,505
2010,Monta Ellis,SG,24,GSW,64,64,2647,631,1406,0.449,77,228,0.338,554,1178,0.47,0.476,292,388,0.753,47,210,257,340,143,25,244,189,1631
2010,Francisco Elson,C,33,MIL,11,0,62,4,13,0.308,0,0,NA,4,13,0.308,0.308,2,2,1,5,8,13,2,1,0,1,7,10
2010,Francisco Elson,C,33,PHI,1,0,4,1,2,0.5,0,0,NA,1,2,0.5,0.5,0,3,0,1,0,1,0,0,0,0,0,2
2010,Maurice Evans,SF,31,ATL,79,5,1317,175,393,0.445,57,169,0.337,118,224,0.527,0.518,46,61,0.754,59,95,154,48,34,17,20,125,453
2010,Reggie Evans,PF,29,TOR,28,1,311,34,69,0.493,0,0,NA,34,69,0.493,0.493,27,60,0.45,30,75,105,8,14,4,22,44,95
2010,Tyreke Evans,SG,20,SAC,72,72,2677,533,1165,0.458,36,141,0.255,497,1024,0.485,0.473,348,465,0.748,66,314,380,414,109,26,216,204,1450
2010,Raymond Felton,PG,25,CHA,80,80,2643,388,846,0.459,60,156,0.385,328,690,0.475,0.494,132,173,0.763,53,235,288,446,123,22,168,172,968
2010,Michael Finley,SF,36,SAS,25,6,395,37,97,0.381,13,41,0.317,24,56,0.429,0.448,6,9,0.667,5,33,38,19,6,4,13,12,93
2010,Michael Finley,SF,36,BOS,21,1,314,44,87,0.506,19,41,0.463,25,46,0.543,0.615,2,6,0.333,1,32,33,24,4,2,8,21,109
2010,Derek Fisher,PG,35,LAL,82,82,2227,212,558,0.38,78,224,0.348,134,334,0.401,0.45,113,132,0.856,25,145,170,201,90,9,78,202,615
2010,Jonny Flynn,PG,20,MIN,81,81,2339,397,952,0.417,77,215,0.358,320,737,0.434,0.457,223,270,0.826,24,167,191,356,82,2,233,98,1094
2010,Randy Foye,PG,26,WAS,70,38,1667,256,619,0.414,63,182,0.346,193,437,0.442,0.464,129,145,0.89,16,114,130,228,33,10,94,123,704
2010,Channing Frye,C,26,PHO,81,41,2190,317,703,0.451,172,392,0.439,145,311,0.466,0.573,98,121,0.81,66,361,427,113,64,74,73,263,904
2010,Dan Gadzuric,C,31,MIL,32,6,314,39,89,0.438,0,0,NA,39,89,0.438,0.438,10,25,0.4,38,54,92,12,9,13,15,63,88
2010,Sundiata Gaines,PG,23,UTA,32,0,217,38,82,0.463,7,26,0.269,31,56,0.554,0.506,23,46,0.5,6,23,29,39,12,0,14,17,106
2010,Danilo Gallinari,SF,21,NYK,81,74,2747,392,927,0.423,186,488,0.381,206,439,0.469,0.523,251,307,0.818,65,333,398,135,75,58,110,191,1221
2010,Francisco García,SG,28,SAC,25,4,575,82,176,0.466,23,59,0.39,59,117,0.504,0.531,15,17,0.882,11,55,66,45,10,19,21,49,202
2010,Kevin Garnett,PF,33,BOS,69,69,2060,402,772,0.521,1,5,0.2,401,767,0.523,0.521,185,221,0.837,78,428,506,185,68,57,101,170,990
2010,Marc Gasol,C,25,MEM,69,69,2469,378,651,0.581,0,1,0,378,650,0.582,0.581,252,376,0.67,208,432,640,165,69,109,135,254,1008
2010,Pau Gasol,C,29,LAL,65,65,2403,452,844,0.536,0,5,0,452,839,0.539,0.536,286,362,0.79,243,491,734,218,37,113,143,152,1190
2010,Rudy Gay,SF,23,MEM,80,80,3175,600,1288,0.466,66,202,0.327,534,1086,0.492,0.491,301,400,0.753,115,357,472,153,118,64,169,201,1567
2010,Alonzo Gee,SG,22,WAS,11,2,182,28,59,0.475,7,9,0.778,21,50,0.42,0.534,18,29,0.621,15,18,33,7,7,1,10,13,81
2010,Taj Gibson,PF,24,CHI,82,70,2204,311,629,0.494,0,0,NA,311,629,0.494,0.494,113,175,0.646,226,385,611,70,50,104,114,282,735
2010,J.R. Giddens,SF,24,BOS,21,1,99,9,21,0.429,0,2,0,9,19,0.474,0.429,6,12,0.5,4,16,20,6,4,1,7,10,24
2010,J.R. Giddens,SF,24,NYK,11,0,140,19,39,0.487,0,8,0,19,31,0.613,0.487,7,11,0.636,12,19,31,7,5,1,10,19,45
2010,Drew Gooden,C,28,DAL,46,11,1030,157,336,0.467,1,6,0.167,156,330,0.473,0.469,93,115,0.809,123,193,316,26,26,50,56,129,408
2010,Drew Gooden,PF,28,LAC,24,22,725,131,266,0.492,0,2,0,131,264,0.496,0.492,93,101,0.921,84,142,226,21,15,8,52,65,355
2010,Marcin Gortat,C,25,ORL,81,0,1088,121,227,0.533,0,3,0,121,224,0.54,0.533,51,75,0.68,104,237,341,17,17,70,46,138,293
2010,Stephen Graham,SG,27,CHA,70,8,804,119,240,0.496,16,50,0.32,103,190,0.542,0.529,42,65,0.646,24,111,135,23,20,10,36,94,296
2010,Danny Granger,SF,26,IND,62,62,2278,488,1139,0.428,158,438,0.361,330,701,0.471,0.498,363,428,0.848,67,275,342,171,94,51,157,183,1497
2010,Aaron Gray,C,25,CHI,8,0,50,8,21,0.381,0,0,NA,8,21,0.381,0.381,2,7,0.286,5,11,16,2,0,0,1,10,18
2010,Aaron Gray,C,25,NOH,24,0,261,34,61,0.557,0,0,NA,34,61,0.557,0.557,18,21,0.857,40,50,90,20,9,11,17,44,86
2010,Jeff Green,PF,23,OKC,82,82,3043,485,1070,0.453,104,312,0.333,381,758,0.503,0.502,165,223,0.74,112,378,490,134,104,72,135,221,1239
2010,Hamed Haddadi,C,24,MEM,36,0,240,24,62,0.387,0,3,0,24,59,0.407,0.387,14,19,0.737,26,49,75,10,1,14,20,57,62
2010,James Harden,SG,20,OKC,76,0,1738,233,578,0.403,93,248,0.375,140,330,0.424,0.484,194,240,0.808,47,197,244,137,80,20,106,200,753
2010,Al Harrington,PF,29,NYK,72,15,2195,448,1030,0.435,140,409,0.342,308,621,0.496,0.503,240,317,0.757,88,317,405,110,62,26,132,209,1276
2010,Devin Harris,PG,26,NJN,64,61,2221,356,884,0.403,60,217,0.276,296,667,0.444,0.437,308,386,0.798,24,179,203,423,79,18,181,178,1080
2010,Mike Harris,PF,26,HOU,8,0,82,10,27,0.37,0,1,0,10,26,0.385,0.37,5,9,0.556,9,11,20,3,4,1,9,10,25
2010,Mike Harris,PF,26,WAS,5,0,14,1,3,0.333,0,0,NA,1,3,0.333,0.333,2,2,1,1,3,4,0,1,0,0,4,4
2010,Jason Hart,PG,31,MIN,1,0,5,0,1,0,0,0,NA,0,1,0,0,0,0,NA,0,0,0,1,1,0,0,0,0
2010,Jason Hart,PG,31,NOH,4,0,17,1,1,1,0,0,NA,1,1,1,1,0,0,NA,0,2,2,5,1,1,3,4,2
2010,Trenton Hassell,SF,30,NJN,52,31,1106,90,219,0.411,0,5,0,90,214,0.421,0.411,52,69,0.754,56,96,152,50,17,9,47,91,232
2010,Spencer Hawes,C,21,SAC,72,59,1904,312,666,0.468,26,87,0.299,286,579,0.494,0.488,73,106,0.689,145,291,436,158,32,83,131,200,723
2010,Chuck Hayes,C,26,HOU,82,82,1773,161,329,0.489,0,0,NA,161,329,0.489,0.489,36,66,0.545,151,314,465,139,73,43,74,219,358
2010,Brendan Haywood,C,30,WAS,49,48,1614,188,335,0.561,0,0,NA,188,335,0.561,0.561,102,158,0.646,200,307,507,18,18,101,67,145,478
2010,Brendan Haywood,C,30,DAL,28,19,741,88,156,0.564,0,1,0,88,155,0.568,0.564,50,87,0.575,78,130,208,25,8,57,32,64,226
2010,Luther Head,SG,27,IND,47,10,813,136,311,0.437,37,105,0.352,99,206,0.481,0.497,48,58,0.828,6,74,80,72,18,9,54,53,357
2010,Gerald Henderson,SG,22,CHA,43,0,355,37,104,0.356,4,19,0.211,33,85,0.388,0.375,35,47,0.745,15,40,55,13,10,9,14,25,113
2010,Roy Hibbert,C,23,IND,81,69,2035,387,782,0.495,3,6,0.5,384,776,0.495,0.497,169,224,0.754,177,287,464,158,30,131,145,285,946
2010,J.J. Hickson,PF,21,CLE,81,73,1691,289,522,0.554,0,1,0,289,521,0.555,0.554,111,163,0.681,110,290,400,40,36,39,92,132,689
2010,Nenê,C,27,DEN,82,82,2755,421,717,0.587,0,2,0,421,715,0.589,0.587,293,416,0.704,166,461,627,203,115,82,125,281,1135
2010,George Hill,PG,23,SAS,78,43,2276,353,738,0.478,75,188,0.399,278,550,0.505,0.529,183,237,0.772,42,163,205,226,69,26,101,222,964
2010,Jordan Hill,PF,22,NYK,24,0,252,41,92,0.446,0,2,0,41,90,0.456,0.446,15,21,0.714,32,29,61,7,10,9,12,37,97
2010,Jordan Hill,PF,22,HOU,23,0,372,58,109,0.532,0,0,NA,58,109,0.532,0.532,31,47,0.66,44,70,114,13,4,12,18,55,147
2010,Kirk Hinrich,SG,29,CHI,74,53,2481,308,753,0.409,104,280,0.371,204,473,0.431,0.478,85,113,0.752,24,236,260,330,85,24,113,204,805
2010,Ryan Hollins,C,25,MIN,73,27,1223,169,303,0.558,0,1,0,169,302,0.56,0.558,109,158,0.69,79,128,207,51,19,38,95,199,447
2010,Eddie House,PG,31,BOS,50,0,846,129,322,0.401,64,167,0.383,65,155,0.419,0.5,36,40,0.9,7,62,69,48,28,7,27,61,358
2010,Eddie House,SG,31,NYK,18,0,371,44,133,0.331,15,60,0.25,29,73,0.397,0.387,12,12,1,6,34,40,37,12,0,20,20,115
2010,Josh Howard,SF,29,DAL,31,9,827,137,342,0.401,20,75,0.267,117,267,0.438,0.43,94,119,0.79,26,86,112,44,23,9,43,78,388
2010,Josh Howard,SF,29,WAS,4,3,91,20,46,0.435,3,11,0.273,17,35,0.486,0.467,15,20,0.75,4,9,13,4,3,2,3,13,58
2010,Juwan Howard,C,36,POR,73,27,1632,191,375,0.509,0,1,0,191,374,0.511,0.509,55,70,0.786,108,227,335,61,27,10,72,191,437
2010,Lester Hudson,PG,25,BOS,16,0,70,7,18,0.389,3,5,0.6,4,13,0.308,0.472,5,6,0.833,3,5,8,8,3,2,9,7,22
2010,Lester Hudson,PG,25,MEM,9,0,61,14,35,0.4,2,11,0.182,12,24,0.5,0.429,6,7,0.857,4,6,10,5,5,1,5,5,36
2010,Larry Hughes,SG,31,NYK,31,14,820,102,279,0.366,28,97,0.289,74,182,0.407,0.416,65,79,0.823,16,94,110,109,40,11,56,53,297
2010,Larry Hughes,SG,31,CHA,14,2,295,35,107,0.327,15,42,0.357,20,65,0.308,0.397,29,34,0.853,7,25,32,28,12,4,19,17,114
2010,Kris Humphries,PF,24,DAL,25,0,315,53,115,0.461,0,0,NA,53,115,0.461,0.461,25,44,0.568,38,57,95,7,7,11,13,43,131
2010,Kris Humphries,PF,24,NJN,44,0,906,127,293,0.433,0,1,0,127,292,0.435,0.433,102,146,0.699,82,201,283,25,29,37,53,102,356
2010,Serge Ibaka,PF,20,OKC,73,0,1323,201,370,0.543,1,2,0.5,200,368,0.543,0.545,58,92,0.63,138,259,397,10,25,97,68,194,461
2010,D.J. Mbenga,C,29,LAL,49,2,355,48,103,0.466,0,0,NA,48,103,0.466,0.466,9,19,0.474,32,55,87,8,5,29,15,54,105
2010,Ersan İlyasova,PF,22,MIL,81,31,1898,323,729,0.443,81,241,0.336,242,488,0.496,0.499,113,158,0.715,157,360,517,84,53,23,71,251,840
2010,Allen Iverson,PG,34,MEM,3,0,67,15,26,0.577,1,1,1,14,25,0.56,0.596,6,12,0.5,1,3,4,11,1,0,7,5,37
2010,Allen Iverson,SG,34,PHI,25,24,798,121,290,0.417,8,24,0.333,113,266,0.425,0.431,98,119,0.824,15,60,75,102,18,2,57,43,348
2010,Royal Ivey,SG,28,PHI,26,0,236,26,55,0.473,12,24,0.5,14,31,0.452,0.582,6,7,0.857,5,21,26,17,10,2,5,25,70
2010,Royal Ivey,SG,28,MIL,18,0,90,9,28,0.321,2,11,0.182,7,17,0.412,0.357,3,5,0.6,1,7,8,10,9,0,6,14,23
2010,Jarrett Jack,PG,26,TOR,82,43,2243,323,671,0.481,82,199,0.412,241,472,0.511,0.542,203,241,0.842,30,192,222,413,60,6,163,151,931
2010,Cedric Jackson,PG,23,CLE,5,0,10,0,2,0,0,1,0,0,1,0,0,1,4,0.25,0,1,1,2,0,0,1,0,1
2010,Cedric Jackson,PG,23,SAS,3,0,25,2,7,0.286,0,2,0,2,5,0.4,0.286,3,4,0.75,1,3,4,6,3,2,2,2,7
2010,Cedric Jackson,PG,23,WAS,4,0,39,4,11,0.364,1,3,0.333,3,8,0.375,0.409,3,4,0.75,1,2,3,6,0,0,8,5,12
2010,Darnell Jackson,PF,24,CLE,27,0,114,8,25,0.32,1,3,0.333,7,22,0.318,0.34,4,6,0.667,8,12,20,4,2,4,13,19,21
2010,Darnell Jackson,PF,24,MIL,1,0,9,1,5,0.2,0,1,0,1,4,0.25,0.2,0,0,NA,1,1,2,0,0,0,0,2,2
2010,Stephen Jackson,PF,31,GSW,9,9,300,56,133,0.421,11,40,0.275,45,93,0.484,0.462,26,37,0.703,6,29,35,42,14,6,26,16,149
2010,Stephen Jackson,SG,31,CHA,72,72,2829,544,1285,0.423,118,353,0.334,426,932,0.457,0.469,312,397,0.786,72,294,366,258,118,37,233,181,1518
2010,Mike James,PG,34,WAS,4,0,46,6,20,0.3,2,6,0.333,4,14,0.286,0.35,4,8,0.5,1,2,3,5,3,0,5,3,18
2010,Antawn Jamison,PF,33,WAS,41,41,1595,315,700,0.45,58,168,0.345,257,532,0.483,0.491,152,217,0.7,99,263,362,52,43,9,61,112,840
2010,Antawn Jamison,PF,33,CLE,25,23,811,163,336,0.485,27,79,0.342,136,257,0.529,0.525,42,83,0.506,37,156,193,32,28,12,30,67,395
2010,Othyus Jeffers,SG,24,UTA,14,0,73,12,29,0.414,0,0,NA,12,29,0.414,0.414,13,19,0.684,8,11,19,1,4,0,6,10,37
2010,Richard Jefferson,SF,29,SAS,81,70,2520,362,775,0.467,59,187,0.316,303,588,0.515,0.505,211,287,0.735,58,298,356,158,45,40,105,178,994
2010,Jared Jeffries,PF,28,NYK,52,37,1462,102,230,0.443,20,62,0.323,82,168,0.488,0.487,60,93,0.645,99,124,223,83,53,58,62,157,284
2010,Jared Jeffries,SF,28,HOU,18,0,332,36,84,0.429,1,9,0.111,35,75,0.467,0.435,15,27,0.556,31,34,65,18,9,13,14,46,88
2010,Brandon Jennings,PG,20,MIL,82,82,2671,451,1216,0.371,145,388,0.374,306,828,0.37,0.431,223,273,0.817,49,233,282,470,105,18,200,191,1270
2010,Jonas Jerebko,PF,22,DET,80,73,2232,290,603,0.481,36,115,0.313,254,488,0.52,0.511,125,176,0.71,194,284,478,58,79,29,82,230,741
2010,Anthony Johnson,PG,35,ORL,31,0,406,49,111,0.441,13,39,0.333,36,72,0.5,0.5,19,20,0.95,8,40,48,63,11,1,26,32,130
2010,James Johnson,PF,22,CHI,65,11,757,95,210,0.452,15,46,0.326,80,164,0.488,0.488,51,70,0.729,34,94,128,48,21,43,62,126,256
2010,Joe Johnson,SG,28,ATL,76,76,2886,635,1386,0.458,129,350,0.369,506,1036,0.488,0.505,220,269,0.818,74,279,353,369,82,5,145,145,1619
2010,Dahntay Jones,SF,29,IND,76,26,1892,287,623,0.461,4,32,0.125,283,591,0.479,0.464,198,257,0.77,48,181,229,150,40,39,129,237,776
2010,Solomon Jones,C,25,IND,52,2,675,78,176,0.443,0,3,0,78,173,0.451,0.443,51,71,0.718,51,93,144,32,14,37,40,125,207
2010,DeAndre Jordan,C,21,LAC,70,12,1137,144,238,0.605,0,2,0,144,236,0.61,0.605,48,128,0.375,122,230,352,21,16,62,75,152,336
2010,Coby Karl,SG,26,CLE,3,0,5,0,0,NA,0,0,NA,0,0,NA,NA,0,0,NA,0,2,2,0,0,0,4,0,0
2010,Coby Karl,SF,26,GSW,4,1,108,11,32,0.344,2,11,0.182,9,21,0.429,0.375,4,6,0.667,4,12,16,15,3,1,6,14,28
2010,Jason Kidd,PG,36,DAL,80,80,2881,284,671,0.423,176,414,0.425,108,257,0.42,0.554,80,99,0.808,48,397,445,724,145,35,195,142,824
2010,Kyle Korver,SG,28,UTA,52,0,952,138,280,0.493,59,110,0.536,79,170,0.465,0.598,39,49,0.796,10,101,111,89,26,12,42,76,374
2010,Kosta Koufos,C,20,UTA,36,0,172,22,47,0.468,0,0,NA,22,47,0.468,0.468,9,15,0.6,16,29,45,6,2,4,15,26,53
2010,Nenad Krstić,C,26,OKC,76,76,1741,281,560,0.502,1,5,0.2,280,555,0.505,0.503,76,106,0.717,134,249,383,52,32,45,58,177,639
2010,Carl Landry,PF,26,HOU,52,1,1415,302,552,0.547,0,0,NA,302,552,0.547,0.547,235,280,0.839,122,164,286,40,28,46,86,146,839
2010,Carl Landry,PF,26,SAC,28,28,1054,197,379,0.52,1,3,0.333,196,376,0.521,0.521,109,147,0.741,66,116,182,26,27,17,50,88,504
2010,Marcus Landry,SF,24,NYK,17,0,108,16,41,0.39,9,26,0.346,7,15,0.467,0.5,3,5,0.6,5,14,19,0,1,2,6,14,44
2010,Marcus Landry,SF,24,BOS,1,0,3,0,2,0,0,2,0,0,0,NA,0,0,0,NA,0,0,0,0,0,0,0,0,0
2010,Acie Law,PG,25,GSW,5,0,66,9,14,0.643,1,3,0.333,8,11,0.727,0.679,12,15,0.8,0,2,2,7,6,0,2,5,31
2010,Acie Law,PG,25,CHA,9,0,33,5,16,0.313,0,1,0,5,15,0.333,0.313,6,7,0.857,0,1,1,3,1,1,3,3,16
2010,Acie Law,PG,25,CHI,12,1,135,21,45,0.467,4,12,0.333,17,33,0.515,0.511,20,27,0.741,3,11,14,16,4,0,12,8,66
2010,Ty Lawson,PG,22,DEN,65,8,1318,201,390,0.515,34,83,0.41,167,307,0.544,0.559,106,140,0.757,42,82,124,203,48,2,82,89,542
2010,Courtney Lee,SG,24,NJN,71,66,2375,338,775,0.436,76,225,0.338,262,550,0.476,0.485,133,153,0.869,60,192,252,121,93,20,76,130,885
2010,David Lee,C,26,NYK,81,81,3019,686,1258,0.545,0,8,0,686,1250,0.549,0.545,268,330,0.812,228,721,949,295,85,40,189,257,1640
2010,Rashard Lewis,PF,30,ORL,72,72,2369,350,805,0.435,168,423,0.397,182,382,0.476,0.539,145,180,0.806,62,256,318,107,78,28,108,180,1013
2010,Shaun Livingston,PG,24,OKC,10,0,130,5,16,0.313,0,2,0,5,14,0.357,0.313,0,0,NA,4,16,20,14,5,2,8,9,10
2010,Shaun Livingston,PG,24,WAS,26,18,666,99,185,0.535,0,4,0,99,181,0.547,0.535,42,48,0.875,12,46,58,116,12,9,50,52,240
2010,Kyle Lowry,PG,23,HOU,68,0,1651,184,464,0.397,37,136,0.272,147,328,0.448,0.436,215,260,0.827,91,156,247,305,60,9,116,173,620
2010,Jamaal Magloire,C,31,MIA,36,0,359,28,56,0.5,0,0,NA,28,56,0.5,0.5,21,59,0.356,41,80,121,1,9,11,17,59,77
2010,Shawn Marion,SF,31,DAL,75,75,2385,395,778,0.508,3,19,0.158,392,759,0.516,0.51,105,139,0.755,158,319,477,107,69,61,99,141,898
2010,Cartier Martin,SF,25,GSW,10,2,276,32,88,0.364,10,31,0.323,22,57,0.386,0.42,16,21,0.762,17,30,47,9,8,0,13,36,90
2010,Cartier Martin,SF,25,WAS,8,0,114,18,48,0.375,7,18,0.389,11,30,0.367,0.448,8,9,0.889,8,13,21,7,3,1,6,12,51
2010,Kevin Martin,SG,26,SAC,22,21,774,135,339,0.398,39,110,0.355,96,229,0.419,0.456,127,155,0.819,20,74,94,57,23,4,35,51,436
2010,Kevin Martin,SG,26,HOU,24,22,859,154,354,0.435,31,100,0.31,123,254,0.484,0.479,171,185,0.924,9,61,70,54,23,2,57,45,510
2010,Desmond Mason,SF,32,SAC,5,4,66,5,12,0.417,0,0,NA,5,12,0.417,0.417,3,4,0.75,4,9,13,2,1,1,4,5,13
2010,Roger Mason,SG,29,SAS,79,5,1515,193,496,0.389,88,264,0.333,105,232,0.453,0.478,27,34,0.794,11,151,162,137,30,14,59,99,501
2010,Wesley Matthews,SG,23,UTA,82,48,2025,273,565,0.483,63,165,0.382,210,400,0.525,0.539,160,193,0.829,50,141,191,124,64,15,93,152,769
2010,Eric Maynor,PG,22,UTA,26,2,363,52,133,0.391,5,24,0.208,47,109,0.431,0.41,25,33,0.758,10,28,38,81,13,2,28,33,134
2010,Eric Maynor,PG,22,OKC,55,0,906,102,235,0.434,17,47,0.362,85,188,0.452,0.47,27,39,0.692,11,80,91,185,27,8,57,82,248
2010,Luc Mbah a Moute,PF,23,MIL,73,62,1866,177,369,0.48,6,17,0.353,171,352,0.486,0.488,93,133,0.699,171,229,400,81,60,39,70,181,453
2010,Antonio McDyess,PF,35,SAS,77,50,1617,205,428,0.479,0,2,0,205,426,0.481,0.479,36,57,0.632,149,306,455,83,43,32,79,147,446
2010,JaVale McGee,C,22,WAS,60,19,968,156,307,0.508,0,1,0,156,306,0.51,0.508,74,116,0.638,88,155,243,14,16,101,51,122,386
2010,Tracy McGrady,SG,30,HOU,6,0,46,7,19,0.368,1,2,0.5,6,17,0.353,0.395,4,6,0.667,0,5,5,6,0,2,1,2,19
2010,Tracy McGrady,SG,30,NYK,24,24,627,84,216,0.389,15,62,0.242,69,154,0.448,0.424,43,57,0.754,22,67,89,93,15,12,43,38,226
2010,Dominic McGuire,SF,24,WAS,41,0,240,15,40,0.375,0,0,NA,15,40,0.375,0.375,0,5,0,17,44,61,8,4,3,10,32,30
2010,Dominic McGuire,SF,24,SAC,10,2,67,4,12,0.333,0,0,NA,4,12,0.333,0.333,0,2,0,6,12,18,3,1,1,7,3,8
2010,Josh McRoberts,C,22,IND,42,3,524,76,146,0.521,8,23,0.348,68,123,0.553,0.548,19,38,0.5,40,87,127,44,17,16,19,74,179
2010,Jodie Meeks,SG,22,MIL,41,0,486,64,177,0.362,23,82,0.28,41,95,0.432,0.427,18,21,0.857,5,67,72,22,13,4,20,33,169
2010,Jodie Meeks,SG,22,PHI,19,0,233,40,91,0.44,19,50,0.38,21,41,0.512,0.544,13,18,0.722,4,23,27,17,5,1,5,19,112
2010,Pops Mensah-Bonsu,PF,26,HOU,4,0,13,1,4,0.25,0,0,NA,1,4,0.25,0.25,3,6,0.5,1,3,4,1,1,1,0,3,5
2010,Pops Mensah-Bonsu,PF,26,TOR,16,0,107,12,29,0.414,0,0,NA,12,29,0.414,0.414,10,18,0.556,15,16,31,2,3,8,10,17,34
2010,C.J. Miles,SF,22,UTA,63,28,1497,241,562,0.429,74,217,0.341,167,345,0.484,0.495,66,95,0.695,42,126,168,105,58,17,81,190,622
2010,Darko Miličić,C,24,NYK,8,0,71,8,17,0.471,0,0,NA,8,17,0.471,0.471,0,0,NA,5,13,18,4,4,1,2,7,16
2010,Darko Miličić,C,24,MIN,24,18,614,92,187,0.492,0,1,0,92,186,0.495,0.492,15,28,0.536,42,91,133,43,18,33,33,75,199
2010,Andre Miller,PG,33,POR,82,66,2500,404,908,0.445,16,80,0.2,388,828,0.469,0.454,322,392,0.821,81,185,266,445,93,9,173,169,1146
2010,Brad Miller,C,33,CHI,82,37,1950,250,581,0.43,37,132,0.28,213,449,0.474,0.462,182,220,0.827,83,316,399,154,44,29,107,189,719
2010,Mike Miller,SG,29,WAS,54,50,1805,217,433,0.501,82,171,0.48,135,262,0.515,0.596,70,85,0.824,55,281,336,212,39,12,115,131,586
2010,Nazr Mohammed,C,32,CHA,58,29,984,189,342,0.553,0,0,NA,189,342,0.553,0.553,81,125,0.648,114,190,304,28,15,43,53,105,459
2010,Jamario Moon,SF,29,CLE,61,2,1052,114,247,0.462,32,100,0.32,82,147,0.558,0.526,36,45,0.8,26,165,191,49,34,30,23,69,296
2010,Mikki Moore,C,34,GSW,23,20,406,54,90,0.6,0,0,NA,54,90,0.6,0.6,7,11,0.636,26,43,69,36,5,13,21,60,115
2010,Adam Morrison,SF,25,LAL,31,0,241,32,85,0.376,5,21,0.238,27,64,0.422,0.406,5,8,0.625,10,22,32,18,3,2,10,17,74
2010,Anthony Morrow,SG,24,GSW,69,37,2018,329,703,0.468,140,307,0.456,189,396,0.477,0.568,101,114,0.886,61,198,259,104,65,16,84,158,899
2010,Byron Mullens,PF,20,OKC,13,0,54,7,19,0.368,0,0,NA,7,19,0.368,0.368,0,0,NA,3,7,10,1,2,0,4,13,14
2010,Troy Murphy,PF,29,IND,72,69,2344,384,813,0.472,128,333,0.384,256,480,0.533,0.551,154,193,0.798,129,608,737,150,72,34,100,175,1050
2010,Ronald Murray,SG,30,CHA,46,1,993,160,411,0.389,41,131,0.313,119,280,0.425,0.439,93,131,0.71,15,83,98,84,28,12,65,77,454
2010,Ronald Murray,SG,30,CHI,29,1,680,108,272,0.397,28,90,0.311,80,182,0.44,0.449,48,63,0.762,13,72,85,51,18,4,26,49,292
2010,Eduardo Nájera,PF,33,NJN,13,2,204,20,53,0.377,3,17,0.176,17,36,0.472,0.406,6,12,0.5,12,26,38,15,9,2,12,33,49
2010,Eduardo Nájera,PF,33,DAL,33,3,481,42,93,0.452,16,47,0.34,26,46,0.565,0.538,8,12,0.667,22,55,77,14,17,12,13,61,108
2010,Jameer Nelson,PG,27,ORL,65,64,1860,317,706,0.449,86,226,0.381,231,480,0.481,0.51,98,116,0.845,26,168,194,353,48,2,139,147,818
2010,Andrés Nocioni,SF,30,SAC,75,28,1477,234,587,0.399,96,249,0.386,138,338,0.408,0.48,71,99,0.717,32,190,222,75,32,26,67,160,635
2010,Steve Novak,SF,26,LAC,54,0,362,42,108,0.389,22,71,0.31,20,37,0.541,0.491,7,9,0.778,1,32,33,6,7,2,2,21,113
2010,Patrick O'Bryant,C,23,TOR,11,0,51,8,15,0.533,0,1,0,8,14,0.571,0.533,3,6,0.5,2,9,11,1,2,4,5,12,19
2010,Jermaine O'Neal,C,31,MIA,70,70,1991,394,745,0.529,0,2,0,394,743,0.53,0.529,162,225,0.72,124,362,486,92,25,95,125,212,950
2010,Shaquille O'Neal,C,37,CLE,53,53,1240,262,463,0.566,0,1,0,262,462,0.567,0.566,112,226,0.496,93,262,355,80,15,62,105,169,636
2010,Kevin Ollie,PG,37,OKC,25,0,263,18,45,0.4,0,1,0,18,44,0.409,0.4,8,8,1,3,22,25,20,9,0,6,16,44
2010,Travis Outlaw,SF,25,POR,11,0,231,38,101,0.376,12,31,0.387,26,70,0.371,0.436,21,24,0.875,13,25,38,8,7,8,12,13,109
2010,Travis Outlaw,SF,25,LAC,23,6,499,72,180,0.4,28,74,0.378,44,106,0.415,0.478,28,35,0.8,20,63,83,26,11,9,20,30,200
2010,Jannero Pargo,PG,30,CHI,63,5,829,132,381,0.346,38,138,0.275,94,243,0.387,0.396,42,45,0.933,9,69,78,89,29,2,50,68,344
2010,Sasha Pavlović,SF,26,MIN,71,0,877,109,300,0.363,35,118,0.297,74,182,0.407,0.422,10,26,0.385,12,105,117,58,23,6,53,84,263
2010,Kendrick Perkins,C,25,BOS,78,78,2154,314,522,0.602,0,3,0,314,519,0.605,0.602,163,280,0.582,155,440,595,80,26,132,165,219,791
2010,Johan Petro,C,24,DEN,36,16,436,54,101,0.535,0,1,0,54,100,0.54,0.535,14,21,0.667,32,97,129,14,10,13,23,80,122
2010,Mickaël Piétrus,SF,27,ORL,75,24,1687,233,539,0.432,116,306,0.379,117,233,0.502,0.54,69,109,0.633,39,176,215,49,53,31,69,138,651
2010,James Posey,SF,33,NOH,77,2,1731,126,345,0.365,81,242,0.335,45,103,0.437,0.483,66,80,0.825,32,297,329,117,42,19,51,204,399
2010,Leon Powe,SF,26,CLE,20,2,236,21,49,0.429,0,0,NA,21,49,0.429,0.429,37,63,0.587,19,42,61,0,6,2,11,36,79
2010,Josh Powell,PF,27,LAL,63,0,581,71,194,0.366,7,16,0.438,64,178,0.36,0.384,20,31,0.645,44,72,116,35,9,6,33,71,169
2010,A.J. Price,PG,23,IND,56,2,865,145,354,0.41,60,174,0.345,85,180,0.472,0.494,60,75,0.8,12,76,88,106,35,3,59,53,410
2010,Tayshaun Prince,SF,29,DET,49,49,1664,282,580,0.486,27,73,0.37,255,507,0.503,0.509,70,98,0.714,71,177,248,161,34,22,60,77,661
2010,Joel Przybilla,C,30,POR,30,9,681,45,86,0.523,0,0,NA,45,86,0.523,0.523,33,51,0.647,72,166,238,8,8,43,39,95,123
2010,Vladimir Radmanović,PF,29,CHA,8,0,133,14,42,0.333,7,22,0.318,7,20,0.35,0.417,4,6,0.667,8,21,29,7,3,1,5,18,39
2010,Vladimir Radmanović,PF,29,GSW,33,20,758,89,231,0.385,23,86,0.267,66,145,0.455,0.435,16,21,0.762,43,106,149,38,26,6,39,79,217
2010,Anthony Randolph,C,20,GSW,33,8,749,137,309,0.443,1,5,0.2,136,304,0.447,0.445,109,136,0.801,73,142,215,42,28,51,49,92,384
2010,Shavlik Randolph,PF,26,MIA,3,0,47,5,15,0.333,0,0,NA,5,15,0.333,0.333,0,0,NA,7,6,13,0,1,1,2,9,10
2010,Shavlik Randolph,PF,26,POR,3,0,6,1,3,0.333,0,0,NA,1,3,0.333,0.333,2,2,1,0,1,1,1,0,0,1,0,4
2010,Zach Randolph,PF,28,MEM,81,81,3051,652,1336,0.488,15,52,0.288,637,1284,0.496,0.494,362,465,0.778,330,620,950,149,80,34,174,226,1681
2010,Theo Ratliff,C,36,SAS,21,3,183,16,36,0.444,0,0,NA,16,36,0.444,0.444,2,4,0.5,15,25,40,9,3,18,16,27,34
2010,Theo Ratliff,C,36,CHA,28,26,624,54,116,0.466,0,0,NA,54,116,0.466,0.466,36,46,0.783,44,73,117,16,9,43,25,60,144
2010,J.J. Redick,SG,25,ORL,82,9,1808,243,553,0.439,111,274,0.405,132,279,0.473,0.54,191,222,0.86,17,138,155,158,28,4,63,118,788
2010,Jason Richardson,SG,29,PHO,79,76,2485,473,998,0.474,157,400,0.393,316,598,0.528,0.553,136,184,0.739,81,323,404,143,66,33,92,169,1239
2010,Luke Ridnour,PG,28,MIL,82,0,1759,328,686,0.478,69,181,0.381,259,505,0.513,0.528,127,140,0.907,24,119,143,324,54,7,106,182,852
2010,Nate Robinson,PG,25,NYK,30,2,733,152,336,0.452,51,136,0.375,101,200,0.505,0.528,42,54,0.778,23,49,72,112,27,5,53,66,397
2010,Nate Robinson,PG,25,BOS,26,0,382,63,157,0.401,36,87,0.414,27,70,0.386,0.516,8,13,0.615,5,33,38,51,22,0,20,50,170
2010,Sergio Rodríguez,PG,23,SAC,39,0,517,88,190,0.463,15,42,0.357,73,148,0.493,0.503,43,62,0.694,15,35,50,121,29,3,59,46,234
2010,Sergio Rodríguez,PG,23,NYK,27,8,531,79,161,0.491,17,49,0.347,62,112,0.554,0.543,25,31,0.806,9,30,39,91,21,2,55,38,200
2010,Rajon Rondo,PG,23,BOS,81,81,2963,459,904,0.508,17,80,0.213,442,824,0.536,0.517,175,282,0.621,100,260,360,794,189,11,246,198,1110
2010,Derrick Rose,PG,21,CHI,78,78,2871,672,1373,0.489,16,60,0.267,656,1313,0.5,0.495,259,338,0.766,65,228,293,469,57,27,217,96,1619
2010,Quinton Ross,SF,28,DAL,27,7,301,23,56,0.411,3,13,0.231,20,43,0.465,0.438,5,8,0.625,11,16,27,7,7,4,3,34,54
2010,Quinton Ross,SG,28,WAS,25,0,261,17,55,0.309,1,8,0.125,16,47,0.34,0.318,3,6,0.5,6,16,22,5,6,2,8,35,38
2010,Kareem Rush,SG,29,LAC,7,0,58,4,11,0.364,1,3,0.333,3,8,0.375,0.409,0,0,NA,1,5,6,4,2,3,3,8,9
2010,John Salmons,SG,30,CHI,51,28,1695,230,548,0.42,73,192,0.38,157,356,0.441,0.486,116,147,0.789,18,156,174,125,65,22,70,101,649
2010,John Salmons,SG,30,MIL,30,28,1129,207,443,0.467,45,117,0.385,162,326,0.497,0.518,137,158,0.867,17,79,96,98,34,4,53,65,596
2010,Thabo Sefolosha,SG,25,OKC,82,82,2348,194,441,0.44,41,131,0.313,153,310,0.494,0.486,60,89,0.674,76,311,387,145,97,46,90,154,489
2010,Ramon Sessions,PG,23,MIN,82,1,1732,253,555,0.456,1,15,0.067,252,540,0.467,0.457,167,233,0.717,58,156,214,258,55,5,137,137,674
2010,James Singleton,SF,28,DAL,25,0,211,24,64,0.375,5,22,0.227,19,42,0.452,0.414,6,6,1,17,38,55,9,11,7,12,31,59
2010,James Singleton,PF,28,WAS,32,3,766,73,190,0.384,2,15,0.133,71,175,0.406,0.389,47,56,0.839,91,130,221,22,17,36,37,82,195
2010,Brian Skinner,PF,33,LAC,16,1,123,10,25,0.4,0,0,NA,10,25,0.4,0.4,6,8,0.75,9,18,27,0,3,4,7,20,26
2010,J.R. Smith,SG,24,DEN,75,0,2082,428,1033,0.414,158,467,0.338,270,566,0.477,0.491,142,201,0.706,28,206,234,183,99,20,139,174,1156
2010,Jason Smith,PF,23,PHI,56,2,658,75,174,0.431,10,29,0.345,65,145,0.448,0.46,29,42,0.69,54,81,135,33,21,28,35,110,189
2010,Joe Smith,PF,34,ATL,64,1,592,77,193,0.399,1,7,0.143,76,186,0.409,0.402,39,48,0.813,66,91,157,21,6,19,22,95,194
2010,Josh Smith,PF,24,ATL,81,81,2871,504,999,0.505,0,7,0,504,992,0.508,0.505,261,422,0.618,223,482,705,342,130,172,198,240,1269
2010,Marreese Speights,C,22,PHI,62,1,1016,212,444,0.477,0,5,0,212,439,0.483,0.477,108,145,0.745,85,167,252,36,29,34,51,152,532
2010,Jerry Stackhouse,SG,35,MIL,42,0,855,129,316,0.408,45,130,0.346,84,186,0.452,0.479,55,69,0.797,19,81,100,70,21,9,66,56,358
2010,DeShawn Stevenson,SG,28,WAS,40,13,616,29,103,0.282,11,62,0.177,18,41,0.439,0.335,18,25,0.72,7,58,65,44,11,5,24,51,87
2010,DeShawn Stevenson,SG,28,DAL,24,5,267,17,60,0.283,8,25,0.32,9,35,0.257,0.35,7,10,0.7,4,22,26,12,5,1,6,23,49
2010,Peja Stojaković,SF,32,NOH,62,55,1947,278,688,0.404,132,352,0.375,146,336,0.435,0.5,96,107,0.897,39,188,227,92,48,5,56,83,784
2010,Amar'e Stoudemire,PF,27,PHO,82,82,2838,704,1264,0.557,1,6,0.167,703,1258,0.559,0.557,487,632,0.771,230,502,732,82,52,83,213,281,1896
2010,Jermaine Taylor,SG,23,HOU,31,4,303,45,119,0.378,5,22,0.227,40,97,0.412,0.399,33,46,0.717,21,25,46,16,10,3,19,15,128
2010,Jeff Teague,PG,21,ATL,71,3,719,90,227,0.396,7,32,0.219,83,195,0.426,0.412,41,49,0.837,5,62,67,122,34,11,50,82,228
2010,Sebastian Telfair,PG,24,LAC,39,1,582,67,166,0.404,11,47,0.234,56,119,0.471,0.437,24,31,0.774,5,36,41,114,22,5,44,65,169
2010,Sebastian Telfair,PG,24,CLE,4,0,77,16,35,0.457,2,9,0.222,14,26,0.538,0.486,5,6,0.833,0,4,4,12,2,0,6,6,39
2010,Garrett Temple,SG,23,HOU,9,0,118,13,29,0.448,3,12,0.25,10,17,0.588,0.5,16,24,0.667,2,12,14,7,4,4,14,16,45
2010,Garrett Temple,SG,23,SAC,5,0,23,3,8,0.375,0,2,0,3,6,0.5,0.375,5,5,1,1,2,3,2,1,0,2,1,11
2010,Garrett Temple,SG,23,SAS,13,4,193,28,64,0.438,10,23,0.435,18,41,0.439,0.516,14,21,0.667,3,11,14,12,8,2,11,25,80
2010,Hasheem Thabeet,C,22,MEM,68,13,883,77,131,0.588,0,0,NA,77,131,0.588,0.588,54,93,0.581,85,158,243,11,15,89,43,162,208
2010,Kenny Thomas,PF,32,SAC,26,2,313,17,35,0.486,0,0,NA,17,35,0.486,0.486,7,12,0.583,35,51,86,15,10,10,17,42,41
2010,Kurt Thomas,C,37,MIL,70,9,1049,99,208,0.476,0,0,NA,99,208,0.476,0.476,12,15,0.8,84,207,291,47,26,46,48,159,210
2010,Tim Thomas,SF,32,DAL,18,1,285,49,106,0.462,16,43,0.372,33,63,0.524,0.538,21,24,0.875,13,28,41,14,10,2,14,31,135
2010,Tyrus Thomas,PF,23,CHI,29,3,678,99,205,0.483,0,1,0,99,204,0.485,0.483,58,90,0.644,42,141,183,33,40,48,52,64,256
2010,Tyrus Thomas,C,23,CHA,25,0,542,95,215,0.442,0,2,0,95,213,0.446,0.442,62,85,0.729,39,113,152,23,23,37,40,65,252
2010,Jason Thompson,C,23,SAC,75,58,2357,370,784,0.472,1,10,0.1,369,774,0.477,0.473,198,277,0.715,224,413,637,124,41,73,139,279,939
2010,Al Thornton,SF,26,LAC,51,30,1405,220,460,0.478,5,14,0.357,215,446,0.482,0.484,103,139,0.741,85,107,192,61,25,22,66,144,548
2010,Al Thornton,SF,26,WAS,24,16,674,100,216,0.463,6,17,0.353,94,199,0.472,0.477,50,72,0.694,31,71,102,29,20,13,36,62,256
2010,Marcus Thornton,SG,22,NOH,73,17,1872,398,883,0.451,117,313,0.374,281,570,0.493,0.517,144,177,0.814,72,139,211,114,58,11,76,127,1057
2010,Anthony Tolliver,PF,24,POR,2,0,4,0,1,0,0,1,0,0,0,NA,0,0,0,NA,0,1,1,0,0,0,0,1,0
2010,Anthony Tolliver,PF,24,GSW,44,29,1423,193,448,0.431,50,151,0.331,143,297,0.481,0.487,103,134,0.769,84,235,319,87,32,33,46,127,539
2010,Alando Tucker,SF,25,PHO,11,0,71,13,30,0.433,1,7,0.143,12,23,0.522,0.45,16,21,0.762,5,2,7,3,0,0,4,5,43
2010,Alando Tucker,SF,25,MIN,4,0,25,4,9,0.444,0,0,NA,4,9,0.444,0.444,0,0,NA,1,2,3,1,0,0,1,1,8
2010,Ronny Turiaf,C,27,GSW,42,20,872,85,146,0.582,0,1,0,85,145,0.586,0.582,37,78,0.474,54,137,191,90,23,54,49,98,207
2010,Hedo Türkoğlu,SF,30,TOR,74,69,2272,276,674,0.409,108,289,0.374,168,385,0.436,0.49,175,226,0.774,42,301,343,304,55,32,125,220,835
2010,Beno Udrih,PG,27,SAC,79,41,2477,415,841,0.493,75,199,0.377,340,642,0.53,0.538,118,141,0.837,38,181,219,372,89,10,136,166,1023
2010,Anderson Varejão,PF,27,CLE,76,7,2166,267,467,0.572,1,5,0.2,266,462,0.576,0.573,116,175,0.663,189,389,578,87,71,67,67,223,651
2010,Sasha Vujačić,SG,25,LAL,67,1,575,66,164,0.402,25,81,0.309,41,83,0.494,0.479,28,33,0.848,25,54,79,41,20,4,17,67,185
2010,Dwyane Wade,SG,28,MIA,77,77,2792,719,1511,0.476,73,243,0.3,646,1268,0.509,0.5,534,702,0.761,107,266,373,501,142,82,252,181,2045
2010,Henry Walker,SF,22,BOS,8,0,29,3,6,0.5,0,0,NA,3,6,0.5,0.5,2,2,1,0,5,5,3,0,0,2,4,8
2010,Henry Walker,SG,22,NYK,27,13,739,117,226,0.518,50,116,0.431,67,110,0.609,0.628,37,47,0.787,15,68,83,37,23,3,26,79,321
2010,Ben Wallace,C,35,DET,69,67,1975,158,292,0.541,0,2,0,158,290,0.545,0.541,65,160,0.406,245,352,597,105,86,84,64,131,381
2010,Gerald Wallace,SF,27,CHA,76,76,3119,456,943,0.484,52,140,0.371,404,803,0.503,0.511,422,544,0.776,150,612,762,161,117,83,178,194,1386
2010,Rasheed Wallace,C,35,BOS,79,13,1780,266,650,0.409,82,290,0.283,184,360,0.511,0.472,96,125,0.768,42,283,325,80,80,70,63,222,710
2010,Luke Walton,SF,29,LAL,29,0,272,30,84,0.357,7,17,0.412,23,67,0.343,0.399,2,4,0.5,12,26,38,40,10,1,12,19,69
2010,Hakim Warrick,PF,27,MIL,48,6,1024,182,378,0.481,1,6,0.167,181,372,0.487,0.483,125,172,0.727,87,125,212,35,17,10,57,83,490
2010,Hakim Warrick,PF,27,CHI,28,0,533,83,172,0.483,0,1,0,83,171,0.485,0.483,77,102,0.755,40,62,102,17,7,8,23,43,243
2010,Earl Watson,PG,30,IND,79,52,2322,223,524,0.426,53,184,0.288,170,340,0.5,0.476,120,169,0.71,54,186,240,399,104,16,175,181,619
2010,Sonny Weems,SG,23,TOR,69,19,1368,236,458,0.515,2,15,0.133,234,443,0.528,0.517,44,64,0.688,42,150,192,101,39,25,65,126,518
2010,Delonte West,SG,26,CLE,60,3,1500,194,436,0.445,25,77,0.325,169,359,0.471,0.474,115,142,0.81,29,140,169,196,55,28,90,86,528
2010,D.J. White,PF,23,OKC,12,0,102,25,41,0.61,0,0,NA,25,41,0.61,0.61,9,10,0.9,10,13,23,4,5,3,3,12,59
2010,Chris Wilcox,PF,27,DET,34,10,441,63,120,0.525,0,0,NA,63,120,0.525,0.525,26,52,0.5,44,73,117,13,13,12,38,64,152
2010,Mike Wilks,PG,30,OKC,4,0,59,6,12,0.5,2,3,0.667,4,9,0.444,0.583,2,4,0.5,1,3,4,4,0,0,4,5,16
2010,Deron Williams,PG,25,UTA,76,76,2802,494,1053,0.469,96,259,0.371,398,794,0.501,0.515,335,418,0.801,50,253,303,798,96,16,252,208,1419
2010,Jason Williams,PG,34,ORL,82,18,1703,189,426,0.444,84,221,0.38,105,205,0.512,0.542,31,41,0.756,7,119,126,298,53,3,87,65,493
2010,Lou Williams,PG,23,PHI,64,38,1912,318,677,0.47,70,206,0.34,248,471,0.527,0.521,192,233,0.824,25,162,187,268,80,15,106,110,898
2010,Marcus Williams,PG,24,MEM,62,1,872,104,271,0.384,24,81,0.296,80,190,0.421,0.428,37,55,0.673,13,80,93,161,32,1,74,43,269
2010,Marvin Williams,SF,23,ATL,81,81,2468,302,664,0.455,40,132,0.303,262,532,0.492,0.485,176,215,0.819,106,310,416,93,66,46,72,160,820
2010,Mo Williams,PG,27,CLE,69,68,2359,378,855,0.442,159,371,0.429,219,484,0.452,0.535,177,198,0.894,28,178,206,368,70,21,173,170,1092
2010,Reggie Williams,SF,23,GSW,24,10,782,140,283,0.495,33,92,0.359,107,191,0.56,0.553,52,62,0.839,18,92,110,66,23,6,29,49,365
2010,Sean Williams,PF,23,NJN,20,0,227,21,49,0.429,0,1,0,21,48,0.438,0.429,10,19,0.526,21,25,46,1,8,19,20,41,52
2010,Shelden Williams,PF,26,BOS,54,0,597,63,121,0.521,0,1,0,63,120,0.525,0.521,75,98,0.765,47,99,146,21,13,21,30,85,201
2010,Terrence Williams,SF,22,NJN,78,9,1764,261,651,0.401,31,100,0.31,230,551,0.417,0.425,103,144,0.715,46,302,348,223,43,10,124,126,656
2010,Metta World Peace,SF,30,LAL,77,77,2605,306,740,0.414,105,296,0.355,201,444,0.453,0.484,128,186,0.688,99,232,331,234,106,21,121,165,845
2010,Antoine Wright,SF,25,TOR,67,10,1392,162,399,0.406,58,173,0.335,104,226,0.46,0.479,53,77,0.688,38,152,190,71,30,11,58,134,435
2010,Nick Young,SG,24,WAS,74,23,1421,233,558,0.418,69,170,0.406,164,388,0.423,0.479,104,130,0.8,20,82,102,48,28,8,56,147,639
2010,Sam Young,SF,24,MEM,80,1,1321,224,497,0.451,11,56,0.196,213,441,0.483,0.462,136,175,0.777,77,124,201,52,34,20,94,106,595
2010,Thaddeus Young,PF,21,PHI,67,45,2145,382,813,0.47,48,138,0.348,334,675,0.495,0.499,114,165,0.691,130,220,350,97,81,15,126,133,926
2011,Jeff Adrien,PF,24,GSW,23,0,196,23,54,0.426,0,0,NA,23,54,0.426,0.426,11,19,0.579,23,35,58,10,4,5,9,28,57
2011,Arron Afflalo,SG,25,DEN,69,69,2324,312,627,0.498,105,248,0.423,207,379,0.546,0.581,138,163,0.847,45,206,251,168,34,31,71,153,867
2011,Maurice Ager,SG,26,MIN,4,0,29,6,11,0.545,3,4,0.75,3,7,0.429,0.682,0,0,NA,0,2,2,1,1,0,4,4,15
2011,Alexis Ajinça,C,22,DAL,10,2,75,12,32,0.375,3,7,0.429,9,25,0.36,0.422,2,3,0.667,5,12,17,2,3,5,1,13,29
2011,Alexis Ajinça,C,22,TOR,24,0,265,47,101,0.465,9,27,0.333,38,74,0.514,0.51,11,15,0.733,12,49,61,8,8,14,17,60,114
2011,Cole Aldrich,C,22,OKC,18,0,142,8,15,0.533,0,0,NA,8,15,0.533,0.533,2,4,0.5,13,22,35,4,5,7,8,30,18
2011,LaMarcus Aldridge,PF,25,POR,81,81,3211,707,1415,0.5,4,23,0.174,703,1392,0.505,0.501,351,444,0.791,278,431,709,170,82,94,153,220,1769
2011,Malik Allen,PF,32,ORL,18,0,178,11,31,0.355,0,0,NA,11,31,0.355,0.355,1,2,0.5,12,20,32,4,1,4,3,30,23
2011,Ray Allen,SG,35,BOS,80,80,2890,480,978,0.491,168,378,0.444,312,600,0.52,0.577,193,219,0.881,51,223,274,219,77,16,117,147,1321
2011,Al-Farouq Aminu,SF,20,LAC,81,14,1452,160,406,0.394,45,143,0.315,115,263,0.437,0.45,92,119,0.773,75,192,267,60,59,25,103,121,457
2011,Lou Amundson,PF,28,GSW,46,7,691,83,183,0.454,0,0,NA,83,183,0.454,0.454,34,87,0.391,81,104,185,17,14,33,24,87,200
2011,Chris Andersen,C,32,DEN,45,0,732,82,137,0.599,0,1,0,82,136,0.603,0.599,86,135,0.637,75,144,219,20,23,58,25,79,250
2011,David Andersen,PF,30,TOR,11,0,150,23,47,0.489,3,10,0.3,20,37,0.541,0.521,7,7,1,8,26,34,7,3,3,8,11,56
2011,David Andersen,PF,30,NOH,29,0,223,33,74,0.446,5,13,0.385,28,61,0.459,0.48,7,15,0.467,12,38,50,6,2,6,14,29,78
2011,James Anderson,SF,21,SAS,26,2,286,31,81,0.383,18,46,0.391,13,35,0.371,0.494,14,18,0.778,2,21,23,18,3,6,13,24,94
2011,Ryan Anderson,PF,22,ORL,64,14,1424,226,525,0.43,134,341,0.393,92,184,0.5,0.558,95,117,0.812,129,226,355,52,30,38,49,137,681
2011,Carmelo Anthony,SF,26,DEN,50,50,1774,437,967,0.452,42,126,0.333,395,841,0.47,0.474,343,417,0.823,77,305,382,140,43,31,142,134,1259
2011,Carmelo Anthony,SF,26,NYK,27,27,977,247,536,0.461,53,125,0.424,194,411,0.472,0.51,164,188,0.872,41,140,181,81,25,15,64,90,711
2011,Joel Anthony,C,28,MIA,75,11,1463,53,99,0.535,0,0,NA,53,99,0.535,0.535,47,73,0.644,104,162,266,24,10,93,36,194,153
2011,Gilbert Arenas,PG,29,WAS,21,14,726,130,330,0.394,47,145,0.324,83,185,0.449,0.465,56,67,0.836,6,64,70,117,30,12,71,76,363
2011,Gilbert Arenas,PG,29,ORL,49,2,1070,139,404,0.344,50,182,0.275,89,222,0.401,0.406,64,86,0.744,16,103,119,157,44,9,106,112,392
2011,Trevor Ariza,SF,25,NOH,75,75,2600,303,762,0.398,82,271,0.303,221,491,0.45,0.451,138,197,0.701,61,347,408,162,120,31,118,180,826
2011,Hilton Armstrong,C,26,WAS,41,2,412,31,64,0.484,1,3,0.333,30,61,0.492,0.492,14,23,0.609,39,75,114,10,15,16,25,75,77
2011,Hilton Armstrong,C,26,ATL,12,0,76,6,12,0.5,1,1,1,5,11,0.455,0.542,2,10,0.2,3,14,17,4,3,5,3,9,15
2011,Carlos Arroyo,PG,31,MIA,49,42,995,109,238,0.458,28,64,0.438,81,174,0.466,0.517,28,35,0.8,13,67,80,100,14,1,43,60,274
2011,Carlos Arroyo,PG,31,BOS,15,1,190,11,35,0.314,3,5,0.6,8,30,0.267,0.357,11,12,0.917,7,16,23,25,7,0,17,11,36
2011,Ömer Aşık,C,24,CHI,82,0,989,78,141,0.553,0,0,NA,78,141,0.553,0.553,73,145,0.503,112,194,306,32,20,56,64,153,229
2011,D.J. Augustin,PG,23,CHA,82,82,2757,399,958,0.416,111,333,0.333,288,625,0.461,0.474,269,297,0.906,38,187,225,498,54,3,155,152,1178
2011,Luke Babbitt,SF,21,POR,24,0,137,15,55,0.273,3,16,0.188,12,39,0.308,0.3,3,9,0.333,6,24,30,6,2,2,8,15,36
2011,Renaldo Balkman,SF,26,DEN,5,0,44,5,9,0.556,0,0,NA,5,9,0.556,0.556,3,4,0.75,1,3,4,2,3,2,0,11,13
2011,Renaldo Balkman,SF,26,NYK,3,0,18,1,4,0.25,1,2,0.5,0,2,0,0.375,0,0,NA,1,2,3,0,1,0,1,4,3
2011,Marcus Banks,PG,29,TOR,3,0,22,0,2,0,0,0,NA,0,2,0,0,6,8,0.75,0,1,1,3,1,0,2,4,6
2011,Leandro Barbosa,SG,28,TOR,58,0,1395,294,653,0.45,72,213,0.338,222,440,0.505,0.505,109,137,0.796,14,85,99,119,50,6,84,112,769
2011,Matt Barnes,SF,30,LAL,53,0,1020,131,279,0.47,34,107,0.318,97,172,0.564,0.53,60,77,0.779,73,155,228,71,39,22,58,127,356
2011,Earl Barron,C,29,PHO,12,6,183,12,51,0.235,0,0,NA,12,51,0.235,0.235,12,20,0.6,16,24,40,4,6,4,11,32,36
2011,Earl Barron,C,29,MIL,7,0,85,17,37,0.459,0,0,NA,17,37,0.459,0.459,2,2,1,12,10,22,4,2,2,2,10,36
2011,Earl Barron,C,29,POR,2,1,37,3,11,0.273,0,0,NA,3,11,0.273,0.273,1,2,0.5,4,10,14,3,0,0,3,4,7
2011,Tony Battie,C,34,PHI,38,0,377,45,96,0.469,2,3,0.667,43,93,0.462,0.479,8,14,0.571,17,82,99,12,5,15,12,59,100
2011,Shane Battier,SF,32,HOU,59,59,1818,186,408,0.456,88,225,0.391,98,183,0.536,0.564,49,76,0.645,58,223,281,153,53,71,63,127,509
2011,Shane Battier,SF,32,MEM,23,0,557,43,101,0.426,14,42,0.333,29,59,0.492,0.495,15,17,0.882,32,60,92,32,16,10,16,31,115
2011,Jerryd Bayless,PG,22,NOH,11,0,149,17,49,0.347,3,14,0.214,14,35,0.4,0.378,13,17,0.765,2,13,15,28,2,1,17,16,50
2011,Jerryd Bayless,PG,22,TOR,60,14,1347,201,468,0.429,46,132,0.348,155,336,0.461,0.479,153,189,0.81,24,126,150,238,36,4,110,133,601
2011,Marco Belinelli,SG,24,NOH,80,69,1957,302,691,0.437,134,324,0.414,168,367,0.458,0.534,98,125,0.784,17,134,151,92,38,6,77,146,836
2011,Charlie Bell,SG,31,GSW,19,0,171,12,43,0.279,6,21,0.286,6,22,0.273,0.349,2,4,0.5,6,12,18,13,6,1,6,13,32
2011,Raja Bell,SG,34,UTA,68,63,2097,191,467,0.409,68,193,0.352,123,274,0.449,0.482,91,102,0.892,31,145,176,118,56,14,63,169,541
2011,Mike Bibby,PG,32,ATL,56,56,1674,192,441,0.435,113,256,0.441,79,185,0.427,0.563,29,46,0.63,15,128,143,202,38,6,68,125,526
2011,Mike Bibby,PG,32,WAS,2,0,29,1,9,0.111,0,4,0,1,5,0.2,0.111,0,0,NA,0,3,3,8,1,0,1,3,2
2011,Mike Bibby,PG,32,MIA,22,12,582,55,126,0.437,40,88,0.455,15,38,0.395,0.595,10,16,0.625,2,47,49,55,11,3,32,47,160
2011,Chauncey Billups,PG,34,DEN,51,51,1646,235,536,0.438,105,238,0.441,130,298,0.436,0.536,265,287,0.923,12,113,125,271,52,12,129,94,840
2011,Chauncey Billups,PG,34,NYK,21,21,664,104,258,0.403,41,125,0.328,63,133,0.474,0.483,119,132,0.902,13,52,65,116,19,2,48,52,368
2011,Steve Blake,PG,30,LAL,79,0,1581,110,306,0.359,73,193,0.378,37,113,0.327,0.479,26,30,0.867,19,137,156,170,40,3,73,99,319
2011,Eric Bledsoe,PG,21,LAC,81,25,1841,206,486,0.424,32,116,0.276,174,370,0.47,0.457,99,133,0.744,68,155,223,289,92,26,194,130,543
2011,Keith Bogans,SG,30,CHI,82,82,1461,124,307,0.404,90,237,0.38,34,70,0.486,0.55,21,32,0.656,19,129,148,101,38,9,41,113,359
2011,Andrew Bogut,C,26,MIL,65,65,2297,367,742,0.495,0,4,0,367,738,0.497,0.495,96,217,0.442,199,521,720,131,47,168,125,217,830
2011,Trevor Booker,PF,23,WAS,65,14,1063,139,253,0.549,0,1,0,139,252,0.552,0.549,68,101,0.673,98,153,251,35,29,42,38,115,346
2011,Earl Boykins,PG,34,MIL,57,0,862,156,352,0.443,27,71,0.38,129,281,0.459,0.482,69,82,0.841,15,40,55,141,38,3,52,43,408
2011,Avery Bradley,PG,20,BOS,31,0,162,23,67,0.343,0,5,0,23,62,0.371,0.343,6,12,0.5,4,13,17,12,9,0,16,20,52
2011,Corey Brewer,SF,24,MIN,56,22,1362,168,437,0.384,26,99,0.263,142,338,0.42,0.414,121,171,0.708,45,107,152,77,89,14,77,134,483
2011,Corey Brewer,SG,24,DAL,13,2,148,25,51,0.49,4,13,0.308,21,38,0.553,0.529,15,21,0.714,12,11,23,12,11,2,10,25,69
2011,Ronnie Brewer,SG,25,CHI,81,1,1781,205,427,0.48,6,27,0.222,199,400,0.498,0.487,87,133,0.654,55,207,262,140,106,22,55,82,503
2011,Aaron Brooks,PG,26,HOU,34,7,811,134,387,0.346,48,169,0.284,86,218,0.394,0.408,78,83,0.94,11,40,51,129,21,2,55,69,394
2011,Aaron Brooks,PG,26,PHO,25,5,473,86,200,0.43,22,67,0.328,64,133,0.481,0.485,46,57,0.807,9,18,27,104,13,1,44,46,240
2011,Derrick Brown,SF,23,CHA,41,1,488,62,113,0.549,2,6,0.333,60,107,0.561,0.558,25,47,0.532,32,52,84,29,16,8,28,48,151
2011,Derrick Brown,SF,23,NYK,8,0,88,12,18,0.667,3,4,0.75,9,14,0.643,0.75,7,13,0.538,9,6,15,4,4,2,7,11,34
2011,Kwame Brown,C,28,CHA,66,50,1714,194,375,0.517,0,0,NA,194,375,0.517,0.517,136,231,0.589,147,303,450,43,26,39,69,174,524
2011,Shannon Brown,SG,25,LAL,82,0,1568,273,643,0.425,74,212,0.349,199,431,0.462,0.482,92,101,0.911,35,122,157,96,67,16,75,124,712
2011,Chase Budinger,SF,22,HOU,78,22,1738,279,656,0.425,89,274,0.325,190,382,0.497,0.493,118,138,0.855,52,229,281,127,41,18,67,114,765
2011,Caron Butler,SF,30,DAL,29,29,867,170,378,0.45,28,65,0.431,142,313,0.454,0.487,68,88,0.773,22,96,118,46,28,8,49,59,436
2011,Rasual Butler,SG,31,LAC,41,2,744,73,226,0.323,42,129,0.326,31,97,0.32,0.416,18,27,0.667,10,66,76,27,8,15,22,34,206
2011,Rasual Butler,SG,31,CHI,6,0,26,6,11,0.545,4,7,0.571,2,4,0.5,0.727,0,0,NA,0,1,1,0,0,0,2,3,16
2011,Andrew Bynum,C,23,LAL,54,47,1500,237,413,0.574,0,0,NA,237,413,0.574,0.574,138,209,0.66,170,338,508,73,19,106,74,140,612
2011,José Calderón,PG,29,TOR,68,55,2102,262,596,0.44,57,156,0.365,205,440,0.466,0.487,88,103,0.854,30,172,202,605,81,7,148,143,669
2011,Marcus Camby,C,36,POR,59,51,1540,117,294,0.398,0,1,0,117,293,0.399,0.398,43,70,0.614,182,424,606,121,40,92,62,140,277
2011,Rodney Carney,SF,26,GSW,25,1,331,45,107,0.421,17,37,0.459,28,70,0.4,0.5,18,27,0.667,12,35,47,11,11,5,16,33,125
2011,Rodney Carney,SF,26,MEM,2,0,5,1,3,0.333,0,1,0,1,2,0.5,0.333,0,0,NA,1,0,1,0,1,0,0,0,2
2011,DeMarre Carroll,PF,24,MEM,7,0,39,4,9,0.444,0,0,NA,4,9,0.444,0.444,2,2,1,2,6,8,2,1,1,0,5,10
2011,DeMarre Carroll,PF,24,HOU,5,0,11,0,3,0,0,0,NA,0,3,0,0,0,0,NA,0,0,0,2,0,0,0,0,0
2011,Matt Carroll,SG,30,CHA,54,1,582,89,199,0.447,17,46,0.37,72,153,0.471,0.49,40,52,0.769,12,56,68,23,17,6,23,43,235
2011,Anthony Carter,PG,35,DEN,14,0,153,10,30,0.333,4,12,0.333,6,18,0.333,0.4,2,2,1,0,12,12,26,9,1,14,19,26
2011,Anthony Carter,PG,35,NYK,19,0,310,35,76,0.461,8,28,0.286,27,48,0.563,0.513,6,6,1,7,32,39,43,18,5,25,30,84
2011,Vince Carter,SG,34,ORL,22,22,664,125,266,0.47,27,78,0.346,98,188,0.521,0.521,56,75,0.747,11,79,90,64,20,3,36,70,333
2011,Vince Carter,SG,34,PHO,51,41,1387,264,625,0.422,89,243,0.366,175,382,0.458,0.494,72,98,0.735,43,142,185,82,47,17,54,123,689
2011,Omri Casspi,SF,22,SAC,71,27,1702,225,546,0.412,92,247,0.372,133,299,0.445,0.496,68,101,0.673,74,233,307,74,54,13,68,115,610
2011,Mario Chalmers,PG,24,MIA,70,28,1579,155,388,0.399,83,231,0.359,72,157,0.459,0.506,54,62,0.871,12,134,146,177,76,7,91,158,447
2011,Tyson Chandler,C,28,DAL,74,74,2059,266,407,0.654,0,0,NA,266,407,0.654,0.654,216,295,0.732,206,486,692,32,36,80,88,240,748
2011,Wilson Chandler,SF,23,NYK,51,30,1759,328,712,0.461,86,245,0.351,242,467,0.518,0.521,96,119,0.807,62,241,303,86,34,70,67,152,838
2011,Wilson Chandler,SF,23,DEN,21,19,642,101,241,0.419,26,75,0.347,75,166,0.452,0.473,34,42,0.81,13,92,105,34,14,24,37,47,262
2011,Earl Clark,SF,23,PHO,9,0,72,12,31,0.387,0,0,NA,12,31,0.387,0.387,5,10,0.5,4,13,17,4,1,3,2,6,29
2011,Earl Clark,SF,23,ORL,33,0,392,56,127,0.441,0,5,0,56,122,0.459,0.441,22,37,0.595,33,51,84,5,7,15,26,39,134
2011,Jarron Collins,C,32,LAC,23,0,157,5,15,0.333,0,0,NA,5,15,0.333,0.333,7,10,0.7,7,10,17,1,4,1,5,24,17
2011,Jarron Collins,C,32,POR,5,0,24,1,6,0.167,0,0,NA,1,6,0.167,0.167,0,0,NA,7,0,7,1,0,0,2,5,2
2011,Jason Collins,C,32,ATL,49,28,593,34,71,0.479,1,1,1,33,70,0.471,0.486,27,41,0.659,30,72,102,22,9,9,26,97,96
2011,Brian Cook,PF,30,LAC,40,0,447,72,170,0.424,34,79,0.43,38,91,0.418,0.524,15,24,0.625,19,77,96,15,12,11,25,75,193
2011,Daequan Cook,SG,23,OKC,43,0,598,79,181,0.436,65,154,0.422,14,27,0.519,0.616,16,20,0.8,8,64,72,20,14,1,17,51,239
2011,DeMarcus Cousins,C,20,SAC,81,62,2309,432,1004,0.43,3,18,0.167,429,986,0.435,0.432,276,402,0.687,217,482,699,204,85,68,268,332,1143
2011,Jamal Crawford,SG,30,ATL,76,0,2297,368,874,0.421,119,349,0.341,249,525,0.474,0.489,222,260,0.854,22,108,130,241,57,14,145,97,1077
2011,Jordan Crawford,SG,22,ATL,16,0,160,27,77,0.351,9,27,0.333,18,50,0.36,0.409,4,6,0.667,9,19,28,15,3,0,15,13,67
2011,Jordan Crawford,SG,22,WAS,26,18,867,165,423,0.39,24,101,0.238,141,322,0.438,0.418,69,78,0.885,22,55,77,102,36,3,68,50,423
2011,Dante Cunningham,PF,23,POR,56,9,1108,126,291,0.433,0,4,0,126,287,0.439,0.433,32,45,0.711,73,116,189,30,39,32,33,139,284
2011,Dante Cunningham,PF,23,CHA,22,9,529,92,181,0.508,1,9,0.111,91,172,0.529,0.511,13,17,0.765,23,65,88,13,15,11,18,38,198
2011,Antonio Daniels,PG,35,PHI,4,0,35,2,5,0.4,0,2,0,2,3,0.667,0.4,2,2,1,0,5,5,2,0,0,1,0,6
2011,Baron Davis,PG,31,LAC,43,35,1269,214,515,0.416,45,152,0.296,169,363,0.466,0.459,79,104,0.76,29,91,120,299,62,22,107,114,552
2011,Baron Davis,PG,31,CLE,15,9,380,75,178,0.421,36,87,0.414,39,91,0.429,0.522,22,27,0.815,6,30,36,92,16,6,39,29,208
2011,Ed Davis,PF,21,TOR,65,17,1602,215,373,0.576,0,0,NA,215,373,0.576,0.576,71,128,0.555,168,294,462,40,39,67,48,183,501
2011,Glen Davis,C,25,BOS,78,13,2298,359,801,0.448,2,15,0.133,357,786,0.454,0.449,195,265,0.736,101,324,425,92,78,30,85,231,915
2011,Austin Daye,SF,22,DET,72,16,1446,193,471,0.41,69,172,0.401,124,299,0.415,0.483,82,108,0.759,64,210,274,78,39,39,59,165,537
2011,Luol Deng,SF,25,CHI,82,82,3208,531,1155,0.46,115,333,0.345,416,822,0.506,0.51,253,336,0.753,116,360,476,230,78,48,156,162,1430
2011,Boris Diaw,PF,28,CHA,82,82,2778,381,774,0.492,78,226,0.345,303,548,0.553,0.543,84,123,0.683,105,309,414,337,74,46,166,190,924
2011,Ike Diogu,PF,27,LAC,36,0,470,83,148,0.561,0,0,NA,83,148,0.561,0.561,41,62,0.661,41,74,115,2,3,3,22,72,207
2011,DeSagana Diop,C,29,CHA,16,0,181,8,24,0.333,0,0,NA,8,24,0.333,0.333,4,11,0.364,12,28,40,7,4,15,11,26,20
2011,Joey Dorsey,C,27,TOR,43,9,522,52,99,0.525,0,0,NA,52,99,0.525,0.525,31,65,0.477,79,111,190,27,24,17,39,78,135
2011,Toney Douglas,SG,24,NYK,81,9,1971,314,755,0.416,143,383,0.373,171,372,0.46,0.511,85,107,0.794,65,179,244,244,89,4,89,177,856
2011,Goran Dragić,PG,24,PHO,48,2,856,133,316,0.421,28,101,0.277,105,215,0.488,0.465,59,97,0.608,24,62,86,149,36,6,96,90,353
2011,Goran Dragić,PG,24,HOU,22,3,378,59,125,0.472,28,54,0.519,31,71,0.437,0.584,24,36,0.667,12,44,56,55,14,4,21,35,170
2011,Jared Dudley,SF,25,PHO,82,15,2140,300,629,0.477,105,253,0.415,195,376,0.519,0.56,162,218,0.743,111,207,318,108,87,20,77,139,867
2011,Mike Dunleavy,SG,30,IND,61,44,1683,240,520,0.462,102,254,0.402,138,266,0.519,0.56,100,125,0.8,28,248,276,105,40,30,69,107,682
2011,Ronald Dupree,SF,30,TOR,3,0,13,1,4,0.25,0,1,0,1,3,0.333,0.25,0,0,NA,0,3,3,1,0,0,0,2,2
2011,Wayne Ellington,SG,23,MIN,62,8,1181,160,397,0.403,48,121,0.397,112,276,0.406,0.463,42,53,0.792,26,82,108,72,28,3,53,85,410
2011,Monta Ellis,SG,25,GSW,80,80,3227,726,1611,0.451,137,379,0.361,589,1232,0.478,0.493,340,431,0.789,44,237,281,450,168,23,252,203,1929
2011,Francisco Elson,C,34,UTA,62,1,610,54,113,0.478,0,0,NA,54,113,0.478,0.478,26,31,0.839,35,80,115,33,21,14,32,84,134
2011,Melvin Ely,C,32,DEN,30,2,366,28,51,0.549,0,0,NA,28,51,0.549,0.549,13,21,0.619,27,47,74,14,4,11,14,50,69
2011,Semih Erden,C,24,BOS,37,7,531,58,97,0.598,0,0,NA,58,97,0.598,0.598,34,54,0.63,31,76,107,19,13,21,32,92,150
2011,Semih Erden,C,24,CLE,4,1,64,4,14,0.286,0,0,NA,4,14,0.286,0.286,5,6,0.833,6,5,11,1,2,3,2,12,13
2011,Maurice Evans,SF,32,ATL,47,12,837,79,201,0.393,28,89,0.315,51,112,0.455,0.463,24,28,0.857,23,61,84,30,16,5,15,74,210
2011,Maurice Evans,SF,32,WAS,26,12,712,98,223,0.439,27,78,0.346,71,145,0.49,0.5,28,30,0.933,29,43,72,15,18,9,18,55,251
2011,Reggie Evans,PF,30,TOR,30,18,798,42,103,0.408,0,1,0,42,102,0.412,0.408,48,88,0.545,119,226,345,38,29,6,39,89,132
2011,Tyreke Evans,SG,21,SAC,57,53,2107,382,933,0.409,43,148,0.291,339,785,0.432,0.432,205,266,0.771,46,229,275,319,85,30,184,143,1012
2011,Christian Eyenga,SF,21,CLE,44,18,947,130,306,0.425,25,91,0.275,105,215,0.488,0.466,18,28,0.643,27,96,123,35,34,28,47,78,303
2011,Derrick Favors,PF,19,NJN,56,23,1091,141,276,0.511,0,0,NA,141,276,0.511,0.511,71,116,0.612,126,171,297,21,18,41,56,183,353
2011,Derrick Favors,PF,19,UTA,22,4,444,74,140,0.529,0,0,NA,74,140,0.529,0.529,32,57,0.561,45,70,115,18,11,27,21,63,180
2011,Raymond Felton,PG,26,NYK,54,54,2074,339,801,0.423,88,268,0.328,251,533,0.471,0.478,157,181,0.867,40,154,194,488,97,11,176,113,923
2011,Raymond Felton,SG,26,DEN,21,0,663,88,204,0.431,28,61,0.459,60,143,0.42,0.5,37,60,0.617,8,67,75,137,28,0,45,37,241
2011,Derek Fisher,PG,36,LAL,82,82,2297,206,529,0.389,63,159,0.396,143,370,0.386,0.449,83,103,0.806,14,138,152,224,99,8,70,192,558
2011,Jonny Flynn,PG,21,MIN,53,8,983,108,296,0.365,31,100,0.31,77,196,0.393,0.417,32,42,0.762,12,65,77,182,34,3,113,58,279
2011,Randy Foye,SG,27,LAC,63,24,1551,206,531,0.388,71,217,0.327,135,314,0.43,0.455,133,149,0.893,13,90,103,170,47,21,95,122,616
2011,Channing Frye,PF,27,PHO,77,64,2541,358,829,0.432,171,439,0.39,187,390,0.479,0.535,89,107,0.832,65,448,513,96,46,79,73,272,976
2011,Dan Gadzuric,C,32,GSW,28,4,297,37,88,0.42,0,1,0,37,87,0.425,0.42,5,14,0.357,53,33,86,11,10,18,21,63,79
2011,Dan Gadzuric,PF,32,NJN,14,5,166,17,41,0.415,0,0,NA,17,41,0.415,0.415,5,13,0.385,18,31,49,3,3,11,8,28,39
2011,Sundiata Gaines,PG,24,MIN,8,0,65,7,22,0.318,2,6,0.333,5,16,0.313,0.364,5,10,0.5,1,5,6,6,3,0,6,4,21
2011,Sundiata Gaines,PG,24,TOR,6,0,90,15,35,0.429,3,15,0.2,12,20,0.6,0.471,2,6,0.333,2,6,8,11,4,1,8,10,35
2011,Sundiata Gaines,PG,24,NJN,10,0,146,20,48,0.417,4,17,0.235,16,31,0.516,0.458,11,20,0.55,10,14,24,25,9,0,13,11,55
2011,Danilo Gallinari,PF,22,NYK,48,48,1671,211,509,0.415,83,239,0.347,128,270,0.474,0.496,259,290,0.893,48,181,229,82,38,18,58,117,764
2011,Danilo Gallinari,SF,22,DEN,14,12,433,54,131,0.412,20,54,0.37,34,77,0.442,0.489,78,101,0.772,11,65,76,22,13,9,25,27,206
2011,Francisco García,SF,29,SAC,58,34,1386,207,475,0.436,81,224,0.362,126,251,0.502,0.521,65,76,0.855,24,109,133,71,51,49,45,126,560
2011,Kevin Garnett,PF,34,BOS,71,71,2220,434,822,0.528,1,5,0.2,433,817,0.53,0.529,187,217,0.862,83,548,631,171,95,57,115,148,1056
2011,Marc Gasol,C,26,MEM,81,81,2586,364,691,0.527,3,7,0.429,361,684,0.528,0.529,220,294,0.748,154,415,569,200,74,136,146,265,951
2011,Pau Gasol,C,30,LAL,82,82,3037,593,1120,0.529,1,3,0.333,592,1117,0.53,0.53,354,430,0.823,268,568,836,273,48,130,142,203,1541
2011,Rudy Gay,SF,24,MEM,54,54,2152,409,869,0.471,57,144,0.396,352,725,0.486,0.503,194,241,0.805,82,254,336,153,91,58,135,131,1069
2011,Alonzo Gee,SG,23,SAS,5,0,18,1,3,0.333,0,0,NA,1,3,0.333,0.333,0,0,NA,2,1,3,0,0,2,3,3,2
2011,Alonzo Gee,SG,23,WAS,11,5,127,12,27,0.444,0,2,0,12,25,0.48,0.444,8,12,0.667,11,11,22,5,7,0,8,10,32
2011,Alonzo Gee,SG,23,CLE,40,29,973,108,234,0.462,17,49,0.347,91,185,0.492,0.498,64,80,0.8,49,108,157,33,33,16,44,81,297
2011,Taj Gibson,PF,25,CHI,80,19,1742,234,502,0.466,1,8,0.125,233,494,0.472,0.467,100,148,0.676,162,296,458,58,39,106,71,203,569
2011,Drew Gooden,PF,29,MIL,35,18,860,156,362,0.431,3,20,0.15,153,342,0.447,0.435,81,102,0.794,73,165,238,47,21,18,46,98,396
2011,Marcin Gortat,C,26,ORL,25,2,396,44,81,0.543,0,0,NA,44,81,0.543,0.543,12,18,0.667,38,80,118,17,7,21,17,52,100
2011,Marcin Gortat,C,26,PHO,55,12,1636,294,522,0.563,1,4,0.25,293,518,0.566,0.564,128,175,0.731,110,403,513,53,29,70,64,136,717
2011,Stephen Graham,SG,28,NJN,59,28,959,81,200,0.405,5,21,0.238,76,179,0.425,0.418,31,38,0.816,17,106,123,40,14,1,38,106,198
2011,Danny Granger,SF,27,IND,79,79,2763,535,1260,0.425,157,407,0.386,378,853,0.443,0.487,395,466,0.848,87,338,425,203,89,62,206,213,1622
2011,Aaron Gray,C,26,NOH,41,6,531,56,99,0.566,0,0,NA,56,99,0.566,0.566,17,34,0.5,59,112,171,16,11,12,32,96,129
2011,Jeff Green,PF,24,OKC,49,49,1815,270,618,0.437,56,184,0.304,214,434,0.493,0.482,148,181,0.818,57,217,274,89,40,21,76,142,744
2011,Jeff Green,SF,24,BOS,26,2,612,98,202,0.485,8,27,0.296,90,175,0.514,0.505,50,63,0.794,16,70,86,19,13,16,23,68,254
2011,Blake Griffin,PF,21,LAC,82,82,3112,696,1376,0.506,7,24,0.292,689,1352,0.51,0.508,446,695,0.642,270,719,989,312,63,45,223,252,1845
2011,Hamed Haddadi,C,25,MEM,31,0,168,30,58,0.517,0,1,0,30,57,0.526,0.517,15,23,0.652,24,44,68,5,2,13,11,29,75
2011,Luke Harangody,PF,23,BOS,28,0,241,28,71,0.394,2,10,0.2,26,61,0.426,0.408,5,8,0.625,17,38,55,10,4,7,5,36,63
2011,Luke Harangody,PF,23,CLE,21,0,399,51,135,0.378,14,56,0.25,37,79,0.468,0.43,14,18,0.778,23,65,88,20,11,10,11,44,130
2011,James Harden,SG,21,OKC,82,5,2189,298,684,0.436,113,324,0.349,185,360,0.514,0.518,289,343,0.843,42,213,255,176,92,24,106,207,998
2011,Al Harrington,PF,30,DEN,73,3,1665,281,675,0.416,117,328,0.357,164,347,0.473,0.503,86,117,0.735,76,256,332,101,39,10,106,202,765
2011,Devin Harris,PG,27,NJN,54,54,1724,260,612,0.425,33,110,0.3,227,502,0.452,0.452,258,307,0.84,11,118,129,411,57,5,158,130,811
2011,Devin Harris,PG,27,UTA,17,16,530,83,201,0.413,25,70,0.357,58,131,0.443,0.475,77,95,0.811,6,34,40,92,13,2,49,33,268
2011,Mike Harris,PF,27,HOU,4,0,16,3,6,0.5,0,0,NA,3,6,0.5,0.5,2,4,0.5,2,3,5,1,0,1,1,2,8
2011,Spencer Hawes,C,22,PHI,81,81,1718,264,568,0.465,9,37,0.243,255,531,0.48,0.473,47,88,0.534,129,336,465,121,29,71,97,201,584
2011,Chuck Hayes,C,27,HOU,74,63,2079,244,463,0.527,0,2,0,244,461,0.529,0.527,94,142,0.662,219,380,599,202,79,49,86,200,582
2011,Brendan Haywood,C,31,DAL,72,8,1331,128,223,0.574,0,1,0,128,222,0.577,0.574,64,177,0.362,129,247,376,19,16,74,51,146,320
2011,Luther Head,PG,28,SAC,36,14,586,68,164,0.415,25,64,0.391,43,100,0.43,0.491,39,50,0.78,16,44,60,70,10,9,32,43,200
2011,Gerald Henderson,SG,23,CHA,68,30,1661,259,570,0.454,7,36,0.194,252,534,0.472,0.461,128,163,0.785,49,158,207,101,50,32,64,118,653
2011,Roy Hibbert,C,24,IND,81,80,2244,410,890,0.461,0,4,0,410,886,0.463,0.461,205,275,0.745,182,428,610,166,33,142,185,256,1025
2011,J.J. Hickson,C,22,CLE,80,66,2256,429,936,0.458,0,5,0,429,931,0.461,0.458,247,367,0.673,217,478,695,91,48,54,173,215,1105
2011,Nenê,C,28,DEN,75,75,2291,402,654,0.615,1,5,0.2,401,649,0.618,0.615,286,402,0.711,145,426,571,149,84,73,134,238,1091
2011,George Hill,PG,24,SAS,76,5,2148,287,633,0.453,77,204,0.377,210,429,0.49,0.514,233,270,0.863,24,175,199,193,66,21,99,153,884
2011,Jordan Hill,C,23,HOU,72,11,1125,173,352,0.491,0,2,0,173,350,0.494,0.491,60,85,0.706,128,178,306,29,14,52,62,157,406
2011,Kirk Hinrich,SG,30,WAS,48,29,1471,198,438,0.452,43,112,0.384,155,326,0.475,0.501,92,105,0.876,14,115,129,210,56,10,84,119,531
2011,Kirk Hinrich,PG,30,ATL,24,22,686,80,185,0.432,32,76,0.421,48,109,0.44,0.519,14,21,0.667,7,46,53,78,19,7,37,66,206
2011,Ryan Hollins,C,26,CLE,70,16,1182,131,219,0.598,0,0,NA,131,219,0.598,0.598,111,163,0.681,70,116,186,26,22,42,67,199,373
2011,Eddie House,SG,32,MIA,56,1,978,128,321,0.399,68,175,0.389,60,146,0.411,0.505,38,40,0.95,9,83,92,62,32,3,29,68,362
2011,Josh Howard,SF,30,WAS,18,10,409,58,162,0.358,7,29,0.241,51,133,0.383,0.38,29,47,0.617,18,56,74,24,13,5,20,34,152
2011,Juwan Howard,PF,37,MIA,57,0,592,55,125,0.44,0,0,NA,55,125,0.44,0.44,29,35,0.829,36,86,122,23,10,4,25,61,139
2011,Lester Hudson,PG,26,WAS,11,0,73,6,24,0.25,4,15,0.267,2,9,0.222,0.333,2,4,0.5,1,4,5,17,4,1,7,10,18
2011,Kris Humphries,PF,25,NJN,74,44,2061,307,583,0.527,0,1,0,307,582,0.527,0.527,127,191,0.665,225,546,771,84,33,80,103,168,741
2011,Serge Ibaka,PF,21,OKC,82,44,2216,335,617,0.543,0,1,0,335,616,0.544,0.543,138,184,0.75,214,408,622,22,31,198,71,267,808
2011,D.J. Mbenga,C,30,NOH,41,0,330,23,49,0.469,0,0,NA,23,49,0.469,0.469,13,18,0.722,35,51,86,6,6,27,21,52,59
2011,Ersan İlyasova,PF,23,MIL,60,34,1505,221,507,0.436,36,121,0.298,185,386,0.479,0.471,93,104,0.894,105,260,365,56,51,24,63,159,571
2011,Royal Ivey,SG,29,OKC,25,0,155,16,38,0.421,7,16,0.438,9,22,0.409,0.513,2,2,1,2,14,16,7,6,1,5,17,41
2011,Jarrett Jack,PG,27,TOR,13,13,347,48,122,0.393,4,24,0.167,44,98,0.449,0.41,40,46,0.87,6,36,42,59,14,0,34,25,140
2011,Jarrett Jack,SG,27,NOH,70,2,1375,212,515,0.412,29,84,0.345,183,431,0.425,0.44,142,168,0.845,14,117,131,183,40,6,76,77,595
2011,Darnell Jackson,PF,25,SAC,59,2,486,77,158,0.487,3,11,0.273,74,147,0.503,0.497,30,49,0.612,49,45,94,14,12,3,23,61,187
2011,Stephen Jackson,SG,32,CHA,67,67,2405,435,1059,0.411,121,359,0.337,314,700,0.449,0.468,249,305,0.816,53,251,304,241,80,28,209,161,1240
2011,Antawn Jamison,PF,34,CLE,56,38,1842,374,876,0.427,91,263,0.346,283,613,0.462,0.479,171,234,0.731,86,289,375,93,50,30,77,137,1010
2011,Othyus Jeffers,SG,25,SAS,1,0,8,1,3,0.333,0,0,NA,1,3,0.333,0.333,0,0,NA,0,2,2,1,0,0,1,1,2
2011,Othyus Jeffers,SG,25,WAS,16,1,314,30,62,0.484,1,4,0.25,29,58,0.5,0.492,30,46,0.652,25,40,65,19,17,0,13,31,91
2011,Richard Jefferson,SF,30,SAS,81,81,2459,304,642,0.474,135,307,0.44,169,335,0.504,0.579,148,195,0.759,54,256,310,107,38,34,93,164,891
2011,Jared Jeffries,PF,29,HOU,18,0,138,11,36,0.306,1,6,0.167,10,30,0.333,0.319,4,10,0.4,20,15,35,11,7,3,4,21,27
2011,Jared Jeffries,PF,29,NYK,24,9,463,19,50,0.38,1,3,0.333,18,47,0.383,0.39,8,19,0.421,42,39,81,25,24,14,17,54,47
2011,Brandon Jennings,PG,21,MIL,63,61,2169,361,926,0.39,98,303,0.323,263,623,0.422,0.443,199,246,0.809,42,192,234,305,95,21,146,131,1019
2011,Armon Johnson,PG,21,POR,38,0,277,46,101,0.455,5,12,0.417,41,89,0.461,0.48,13,22,0.591,11,25,36,45,5,1,38,31,110
2011,Chris Johnson,C,25,POR,10,1,106,7,18,0.389,0,0,NA,7,18,0.389,0.389,13,18,0.722,11,16,27,2,3,6,8,18,27
2011,Chris Johnson,C,25,BOS,4,0,32,2,3,0.667,0,0,NA,2,3,0.667,0.667,2,2,1,1,4,5,1,0,3,2,3,6
2011,James Johnson,SF,23,CHI,13,0,123,17,41,0.415,2,9,0.222,15,32,0.469,0.439,6,13,0.462,6,18,24,14,8,9,18,25,42
2011,James Johnson,SF,23,TOR,25,25,699,91,196,0.464,6,25,0.24,85,171,0.497,0.48,41,58,0.707,31,87,118,75,25,28,46,70,229
2011,Joe Johnson,SG,29,ATL,72,72,2554,514,1161,0.443,89,300,0.297,425,861,0.494,0.481,195,243,0.802,59,232,291,338,47,7,146,131,1312
2011,Trey Johnson,SG,26,TOR,7,0,81,10,30,0.333,1,3,0.333,9,27,0.333,0.35,7,8,0.875,2,5,7,11,1,1,5,11,28
2011,Trey Johnson,SG,26,LAL,1,0,13,2,3,0.667,0,0,NA,2,3,0.667,0.667,2,2,1,0,0,0,0,0,0,0,1,6
2011,Wesley Johnson,SG,23,MIN,79,63,2069,271,682,0.397,103,289,0.356,168,393,0.427,0.473,64,92,0.696,51,189,240,148,58,54,95,163,709
2011,Dahntay Jones,SG,30,IND,45,2,589,100,214,0.467,14,39,0.359,86,175,0.491,0.5,69,90,0.767,4,61,65,33,20,7,31,70,283
2011,Solomon Jones,C,26,IND,39,0,528,49,121,0.405,0,1,0,49,120,0.408,0.405,41,62,0.661,45,68,113,30,12,22,35,94,139
2011,DeAndre Jordan,C,22,LAC,80,66,2047,234,341,0.686,0,1,0,234,340,0.688,0.686,98,217,0.452,207,368,575,42,41,142,101,255,566
2011,Jason Kidd,PG,37,DAL,80,80,2653,215,596,0.361,133,391,0.34,82,205,0.4,0.472,67,77,0.87,35,316,351,655,134,29,179,119,630
2011,Kyle Korver,SG,29,CHI,82,0,1649,242,557,0.434,120,289,0.415,122,268,0.455,0.542,77,87,0.885,12,138,150,124,35,20,60,156,681
2011,Kosta Koufos,C,21,MIN,39,1,336,47,108,0.435,0,2,0,47,106,0.443,0.435,12,24,0.5,42,55,97,7,8,20,25,50,106
2011,Kosta Koufos,C,21,DEN,11,1,98,21,42,0.5,0,0,NA,21,42,0.5,0.5,12,19,0.632,15,18,33,0,2,5,6,9,54
2011,Nenad Krstić,C,27,OKC,47,47,1018,152,305,0.498,0,0,NA,152,305,0.498,0.498,53,66,0.803,77,130,207,19,18,17,33,107,357
2011,Nenad Krstić,C,27,BOS,24,20,553,79,147,0.537,0,0,NA,79,147,0.537,0.537,60,80,0.75,47,81,128,8,8,8,23,77,218
2011,Carl Landry,PF,27,SAC,53,16,1406,238,484,0.492,0,3,0,238,481,0.495,0.492,155,215,0.721,127,126,253,50,30,20,82,125,631
2011,Carl Landry,PF,27,NOH,23,10,602,107,203,0.527,0,1,0,107,202,0.53,0.527,58,73,0.795,38,56,94,13,10,12,27,71,272
2011,Acie Law,PG,26,MEM,11,0,94,3,19,0.158,0,6,0,3,13,0.231,0.158,6,10,0.6,3,8,11,14,4,0,10,10,12
2011,Acie Law,PG,26,GSW,40,0,632,78,167,0.467,6,30,0.2,72,137,0.526,0.485,41,54,0.759,9,43,52,70,28,0,33,51,203
2011,Ty Lawson,PG,23,DEN,80,31,2103,346,688,0.503,69,171,0.404,277,517,0.536,0.553,172,225,0.764,67,142,209,377,80,4,137,133,933
2011,Courtney Lee,SG,25,HOU,81,1,1723,253,576,0.439,71,174,0.408,182,402,0.453,0.501,95,120,0.792,51,158,209,100,58,18,68,102,672
2011,David Lee,PF,27,GSW,73,73,2634,496,978,0.507,1,3,0.333,495,975,0.508,0.508,210,267,0.787,217,497,714,233,74,31,170,211,1203
2011,Rashard Lewis,PF,31,ORL,25,25,810,113,270,0.419,44,120,0.367,69,150,0.46,0.5,34,45,0.756,23,83,106,29,22,10,35,63,304
2011,Rashard Lewis,SF,31,WAS,32,27,1014,139,312,0.446,43,124,0.347,96,188,0.511,0.514,43,51,0.843,48,136,184,63,30,20,52,96,364
2011,Jeremy Lin,PG,22,GSW,29,0,285,28,72,0.389,1,5,0.2,27,67,0.403,0.396,19,25,0.76,12,22,34,42,33,9,18,31,76
2011,Shaun Livingston,PG,25,CHA,73,0,1261,185,397,0.466,1,4,0.25,184,393,0.468,0.467,108,125,0.864,29,120,149,164,47,29,88,109,479
2011,Kyle Lowry,PG,24,HOU,75,71,2563,345,809,0.426,129,343,0.376,216,466,0.464,0.506,192,251,0.765,89,220,309,500,102,23,158,207,1011
2011,Jamaal Magloire,C,32,MIA,18,0,158,13,22,0.591,0,0,NA,13,22,0.591,0.591,9,18,0.5,17,44,61,3,4,2,5,26,35
2011,Shawn Marion,SF,32,DAL,80,27,2253,434,834,0.52,5,33,0.152,429,801,0.536,0.523,126,164,0.768,168,383,551,110,68,50,130,144,999
2011,Cartier Martin,SF,26,WAS,52,1,542,71,182,0.39,39,99,0.394,32,83,0.386,0.497,28,40,0.7,20,54,74,18,18,6,16,52,209
2011,Kevin Martin,SG,27,HOU,80,80,2603,553,1267,0.436,176,459,0.383,377,808,0.467,0.506,594,669,0.888,28,230,258,198,80,15,184,155,1876
2011,Roger Mason,SG,30,NYK,26,0,319,26,77,0.338,16,44,0.364,10,33,0.303,0.442,7,10,0.7,5,38,43,20,6,2,6,25,75
2011,Wesley Matthews,SG,24,POR,82,69,2758,440,979,0.449,154,378,0.407,286,601,0.476,0.528,266,315,0.844,48,210,258,164,102,9,138,195,1300
2011,Eric Maynor,PG,23,OKC,82,0,1200,134,333,0.402,37,96,0.385,97,237,0.409,0.458,43,59,0.729,25,96,121,238,35,6,77,96,348
2011,Luc Mbah a Moute,PF,24,MIL,79,52,2093,198,428,0.463,0,7,0,198,421,0.47,0.463,133,188,0.707,169,251,420,68,72,28,77,180,529
2011,Antonio McDyess,PF,36,SAS,73,16,1387,169,344,0.491,0,1,0,169,343,0.493,0.491,52,77,0.675,122,273,395,84,36,39,72,163,390
2011,JaVale McGee,C,23,WAS,79,75,2193,332,604,0.55,0,3,0,332,601,0.552,0.55,134,230,0.583,223,411,634,38,41,193,102,232,798
2011,Tracy McGrady,SG,31,DET,72,39,1686,227,514,0.442,30,88,0.341,197,426,0.462,0.471,90,129,0.698,49,202,251,252,66,34,102,101,574
2011,Dominic McGuire,SF,25,CHA,52,8,760,72,182,0.396,0,2,0,72,180,0.4,0.396,30,39,0.769,63,136,199,43,10,33,25,94,174
2011,Josh McRoberts,PF,23,IND,72,51,1597,211,386,0.547,23,60,0.383,188,326,0.577,0.576,88,119,0.739,109,273,382,150,47,57,93,165,533
2011,Jodie Meeks,SG,23,PHI,74,64,2062,242,570,0.425,138,348,0.397,104,222,0.468,0.546,152,170,0.894,21,150,171,78,63,4,60,97,774
2011,Pops Mensah-Bonsu,PF,27,NOH,7,0,35,1,3,0.333,0,0,NA,1,3,0.333,0.333,0,0,NA,3,8,11,2,0,0,2,11,2
2011,C.J. Miles,SF,23,UTA,78,19,1969,366,899,0.407,109,339,0.322,257,560,0.459,0.468,159,196,0.811,54,201,255,135,74,38,93,221,1000
2011,Darko Miličić,C,25,MIN,69,69,1686,271,578,0.469,0,0,NA,271,578,0.469,0.469,64,115,0.557,133,227,360,104,54,140,151,229,606
2011,Andre Miller,PG,34,POR,81,81,2650,388,844,0.46,4,37,0.108,384,807,0.476,0.462,249,292,0.853,97,205,302,566,114,12,197,171,1029
2011,Brad Miller,C,34,HOU,60,5,1015,132,296,0.446,40,107,0.374,92,189,0.487,0.514,78,94,0.83,44,178,222,145,28,21,54,98,382
2011,Mike Miller,SG,30,MIA,41,2,838,81,202,0.401,43,118,0.364,38,84,0.452,0.507,23,34,0.676,38,146,184,51,20,2,41,88,228
2011,Nazr Mohammed,C,33,CHA,51,30,851,159,317,0.502,0,1,0,159,316,0.503,0.502,52,88,0.591,94,158,252,17,14,46,51,121,370
2011,Nazr Mohammed,C,33,OKC,24,7,429,75,131,0.573,0,0,NA,75,131,0.573,0.573,15,24,0.625,46,70,116,6,16,10,19,63,165
2011,Greg Monroe,C,20,DET,80,48,2222,303,550,0.551,0,1,0,303,549,0.552,0.551,145,233,0.622,248,353,601,105,93,45,81,196,751
2011,Jamario Moon,SF,30,CLE,40,13,764,76,189,0.402,27,95,0.284,49,94,0.521,0.474,10,11,0.909,14,104,118,45,25,27,17,39,189
2011,Jamario Moon,SF,30,LAC,19,7,278,25,59,0.424,11,28,0.393,14,31,0.452,0.517,5,6,0.833,9,38,47,7,3,6,5,26,66
2011,Anthony Morrow,SG,25,NJN,58,47,1856,279,620,0.45,110,260,0.423,169,360,0.469,0.539,96,107,0.897,37,135,172,68,19,7,54,135,764
2011,Timofey Mozgov,C,24,NYK,34,14,458,52,112,0.464,0,0,NA,52,112,0.464,0.464,31,44,0.705,41,63,104,15,14,23,32,76,135
2011,Timofey Mozgov,C,24,DEN,11,0,66,11,21,0.524,0,0,NA,11,21,0.524,0.524,6,8,0.75,5,12,17,0,1,2,3,8,28
2011,Byron Mullens,PF,21,OKC,13,0,85,9,28,0.321,0,0,NA,9,28,0.321,0.321,7,14,0.5,6,18,24,0,2,3,8,11,25
2011,Troy Murphy,PF,30,NJN,18,4,288,26,76,0.342,4,23,0.174,22,53,0.415,0.368,9,17,0.529,11,64,75,17,7,2,13,28,65
2011,Troy Murphy,PF,30,BOS,17,0,178,16,38,0.421,1,10,0.1,15,28,0.536,0.434,11,13,0.846,11,27,38,6,8,1,7,19,44
2011,Eduardo Nájera,PF,34,CHA,31,0,372,26,72,0.361,11,34,0.324,15,38,0.395,0.438,6,11,0.545,14,30,44,20,11,6,13,52,69
2011,Gary Neal,SG,26,SAS,80,1,1685,285,632,0.451,129,308,0.419,156,324,0.481,0.553,84,104,0.808,21,175,196,96,27,4,78,148,783
2011,Jameer Nelson,PG,28,ORL,76,76,2319,374,838,0.446,119,297,0.401,255,541,0.471,0.517,130,162,0.802,37,189,226,456,75,3,194,209,997
2011,Andrés Nocioni,SF,31,PHI,54,17,931,118,277,0.426,42,118,0.356,76,159,0.478,0.502,49,61,0.803,19,150,169,45,14,15,47,100,327
2011,Steve Novak,SF,27,DAL,7,0,18,4,8,0.5,3,4,0.75,1,4,0.25,0.688,0,0,NA,0,5,5,0,0,0,0,3,11
2011,Steve Novak,SF,27,SAS,23,0,197,31,59,0.525,23,42,0.548,8,17,0.471,0.72,8,8,1,4,19,23,3,1,5,4,11,93
2011,Jermaine O'Neal,C,32,BOS,24,10,431,50,109,0.459,0,1,0,50,108,0.463,0.459,29,43,0.674,25,63,88,12,2,30,27,65,129
2011,Shaquille O'Neal,C,38,BOS,37,36,752,134,201,0.667,0,0,NA,134,201,0.667,0.667,73,131,0.557,48,130,178,26,16,42,56,120,341
2011,Travis Outlaw,SF,26,NJN,82,55,2358,274,731,0.375,76,252,0.302,198,479,0.413,0.427,132,171,0.772,54,271,325,84,34,36,71,148,756
2011,Larry Owens,SF,28,SAS,7,0,31,3,6,0.5,1,3,0.333,2,3,0.667,0.583,2,4,0.5,0,4,4,1,2,0,0,4,9
2011,Larry Owens,SF,28,WAS,5,0,112,12,26,0.462,5,10,0.5,7,16,0.438,0.558,2,5,0.4,1,10,11,7,7,5,5,14,31
2011,Patrick Patterson,PF,21,HOU,52,6,868,149,267,0.558,0,2,0,149,265,0.562,0.558,30,42,0.714,86,114,200,41,17,37,31,77,328
2011,Sasha Pavlović,SF,27,DAL,10,6,163,15,35,0.429,7,16,0.438,8,19,0.421,0.529,4,5,0.8,0,12,12,7,5,3,5,15,41
2011,Sasha Pavlović,SG,27,NOH,4,1,50,2,11,0.182,0,5,0,2,6,0.333,0.182,0,0,NA,0,6,6,6,0,4,1,4,4
2011,Sasha Pavlović,SG,27,BOS,17,0,149,12,26,0.462,5,10,0.5,7,16,0.438,0.558,2,5,0.4,1,13,14,3,5,0,6,15,31
2011,Kendrick Perkins,C,26,BOS,12,7,313,32,59,0.542,0,0,NA,32,59,0.542,0.542,23,40,0.575,23,74,97,10,2,10,25,37,87
2011,Kendrick Perkins,C,26,OKC,17,17,429,35,71,0.493,0,0,NA,35,71,0.493,0.493,17,32,0.531,39,96,135,16,7,16,31,54,87
2011,Johan Petro,C,25,NJN,77,1,893,129,290,0.445,0,4,0,129,286,0.451,0.445,15,28,0.536,62,150,212,44,34,34,46,178,273
2011,Mickaël Piétrus,SF,28,ORL,19,0,418,45,115,0.391,34,87,0.391,11,28,0.393,0.539,3,6,0.5,6,44,50,10,10,3,14,35,127
2011,Mickaël Piétrus,SG,28,PHO,38,4,689,98,250,0.392,51,149,0.342,47,101,0.465,0.494,36,51,0.706,9,67,76,23,19,18,25,66,283
2011,Dexter Pittman,C,22,MIA,2,0,11,1,3,0.333,0,0,NA,1,3,0.333,0.333,0,0,NA,1,2,3,0,0,0,2,2,2
2011,Quincy Pondexter,SF,22,NOH,66,6,734,73,180,0.406,18,50,0.36,55,130,0.423,0.456,24,34,0.706,23,65,88,28,17,10,16,63,188
2011,James Posey,SF,34,IND,49,0,839,81,241,0.336,67,212,0.316,14,29,0.483,0.475,11,15,0.733,10,137,147,34,24,6,24,103,240
2011,Leon Powe,PF,27,CLE,14,3,187,29,59,0.492,0,0,NA,29,59,0.492,0.492,12,26,0.462,16,22,38,2,7,3,5,20,70
2011,Leon Powe,C,27,MEM,16,0,141,30,60,0.5,0,2,0,30,58,0.517,0.5,28,46,0.609,8,17,25,5,3,1,7,24,88
2011,Josh Powell,PF,28,ATL,54,0,653,94,208,0.452,0,1,0,94,207,0.454,0.452,36,45,0.8,49,86,135,22,5,5,53,78,224
2011,A.J. Price,PG,24,IND,50,0,795,114,320,0.356,41,149,0.275,73,171,0.427,0.42,54,81,0.667,16,56,72,111,29,1,53,61,323
2011,Tayshaun Prince,SF,30,DET,78,78,2562,473,1001,0.473,34,98,0.347,439,903,0.486,0.49,118,168,0.702,78,251,329,215,30,41,82,90,1098
2011,Joel Przybilla,C,31,POR,31,9,445,21,34,0.618,0,0,NA,21,34,0.618,0.618,13,23,0.565,28,93,121,13,5,14,22,63,55
2011,Joel Przybilla,C,31,CHA,5,0,74,4,10,0.4,0,0,NA,4,10,0.4,0.4,1,4,0.25,9,15,24,0,0,1,7,16,9
2011,Vladimir Radmanović,PF,30,GSW,74,6,1169,137,318,0.431,70,173,0.405,67,145,0.462,0.541,30,34,0.882,64,148,212,79,44,44,57,157,374
2011,Anthony Randolph,PF,21,NYK,17,0,127,14,45,0.311,1,4,0.25,13,41,0.317,0.322,6,12,0.5,11,29,40,7,4,8,10,15,35
2011,Anthony Randolph,C,21,MIN,23,3,463,109,219,0.498,0,0,NA,109,219,0.498,0.498,52,74,0.703,32,88,120,26,18,16,43,47,270
2011,Zach Randolph,PF,29,MEM,75,74,2724,598,1188,0.503,8,43,0.186,590,1145,0.515,0.507,300,396,0.758,326,588,914,163,63,25,151,175,1504
2011,Theo Ratliff,C,37,LAL,10,0,71,1,6,0.167,0,0,NA,1,6,0.167,0.167,0,2,0,6,7,13,3,2,5,3,7,2
2011,J.J. Redick,SG,26,ORL,59,5,1513,197,447,0.441,87,219,0.397,110,228,0.482,0.538,112,128,0.875,6,107,113,102,29,3,53,80,593
2011,Jason Richardson,SG,30,PHO,25,25,796,183,389,0.47,62,148,0.419,121,241,0.502,0.55,55,72,0.764,33,78,111,36,27,3,30,46,483
2011,Jason Richardson,SG,30,ORL,55,55,1919,289,667,0.433,127,331,0.384,162,336,0.482,0.528,61,87,0.701,34,186,220,111,66,10,65,116,766
2011,Luke Ridnour,PG,29,MIN,71,66,2159,319,681,0.468,81,184,0.44,238,497,0.479,0.528,121,137,0.883,37,162,199,384,89,10,158,146,840
2011,Nate Robinson,PG,26,BOS,55,11,983,146,361,0.404,63,192,0.328,83,169,0.491,0.492,33,40,0.825,15,74,89,105,29,4,66,107,388
2011,Nate Robinson,PG,26,OKC,4,0,30,4,15,0.267,2,8,0.25,2,7,0.286,0.333,3,4,0.75,0,1,1,6,0,0,2,8,13
2011,Rajon Rondo,PG,24,BOS,68,68,2527,318,670,0.475,10,43,0.233,308,627,0.491,0.482,75,132,0.568,87,210,297,760,153,11,234,120,721
2011,Derrick Rose,PG,22,CHI,81,81,3026,711,1597,0.445,128,385,0.332,583,1212,0.481,0.485,476,555,0.858,81,249,330,623,85,51,278,136,2026
2011,Quinton Ross,SF,29,NJN,36,4,353,26,59,0.441,0,3,0,26,56,0.464,0.441,5,14,0.357,10,20,30,10,3,6,7,40,57
2011,John Salmons,SG,31,MIL,73,70,2554,373,898,0.415,83,219,0.379,290,679,0.427,0.462,195,240,0.813,27,239,266,252,72,28,137,157,1024
2011,Thabo Sefolosha,SG,26,OKC,79,79,2049,157,333,0.471,28,102,0.275,129,231,0.558,0.514,59,79,0.747,65,281,346,111,97,38,55,171,401
2011,Ramon Sessions,PG,24,CLE,81,38,2133,362,776,0.466,3,15,0.2,359,761,0.472,0.468,348,423,0.823,46,209,255,419,60,8,178,93,1075
2011,Brian Skinner,C,34,MIL,2,0,6,0,0,NA,0,0,NA,0,0,NA,NA,0,0,NA,0,0,0,0,0,0,0,0,0
2011,Ish Smith,PG,22,HOU,28,3,329,32,83,0.386,3,8,0.375,29,75,0.387,0.404,7,10,0.7,6,36,42,64,13,2,26,26,74
2011,Ish Smith,PG,22,MEM,15,0,113,11,32,0.344,0,2,0,11,30,0.367,0.344,5,11,0.455,1,4,5,15,5,0,8,11,27
2011,J.R. Smith,SF,25,DEN,79,6,1968,341,784,0.435,124,318,0.39,217,466,0.466,0.514,163,221,0.738,45,277,322,175,92,16,100,173,969
2011,Jason Smith,C,24,NOH,77,6,1102,136,307,0.443,0,2,0,136,305,0.446,0.443,59,70,0.843,89,152,241,36,26,32,53,150,331
2011,Joe Smith,PF,35,NJN,4,3,25,1,4,0.25,0,0,NA,1,4,0.25,0.25,0,0,NA,1,2,3,1,0,0,2,3,2
2011,Joe Smith,PF,35,LAL,12,0,44,2,12,0.167,0,0,NA,2,12,0.167,0.167,2,2,1,2,16,18,3,0,4,3,10,6
2011,Josh Smith,PF,25,ATL,77,77,2645,497,1041,0.477,51,154,0.331,446,887,0.503,0.502,229,316,0.725,134,523,657,255,99,120,197,217,1274
2011,Marreese Speights,C,23,PHI,64,1,734,144,291,0.495,1,4,0.25,143,287,0.498,0.497,55,73,0.753,64,146,210,30,8,19,40,120,344
2011,Jerry Stackhouse,SG,36,MIA,7,1,50,3,12,0.25,1,4,0.25,2,8,0.25,0.292,5,7,0.714,1,6,7,3,0,2,2,3,12
2011,Lance Stephenson,SG,20,IND,12,0,115,13,39,0.333,0,5,0,13,34,0.382,0.333,11,14,0.786,1,17,18,21,4,0,16,14,37
2011,DeShawn Stevenson,SG,29,DAL,72,54,1158,128,330,0.388,94,249,0.378,34,81,0.42,0.53,33,43,0.767,20,86,106,77,21,5,44,71,383
2011,Peja Stojaković,SF,33,NOH,6,0,89,14,33,0.424,11,25,0.44,3,8,0.375,0.591,6,7,0.857,0,6,6,6,2,0,4,2,45
2011,Peja Stojaković,SF,33,TOR,2,0,22,7,10,0.7,4,6,0.667,3,4,0.75,0.9,2,2,1,0,3,3,1,0,0,2,0,20
2011,Peja Stojaković,SF,33,DAL,25,13,506,79,184,0.429,42,105,0.4,37,79,0.468,0.543,15,16,0.938,14,52,66,22,11,2,11,22,215
2011,Amar'e Stoudemire,C,28,NYK,78,78,2870,744,1482,0.502,10,23,0.435,734,1459,0.503,0.505,473,597,0.792,198,438,636,202,71,150,250,274,1971
2011,Jermaine Taylor,SG,24,HOU,8,0,77,16,32,0.5,2,5,0.4,14,27,0.519,0.531,5,6,0.833,1,8,9,2,2,2,6,4,39
2011,Jermaine Taylor,SG,24,SAC,26,8,406,78,164,0.476,12,40,0.3,66,124,0.532,0.512,16,22,0.727,25,28,53,30,12,3,40,35,184
2011,Jeff Teague,PG,22,ATL,70,7,963,133,304,0.438,18,48,0.375,115,256,0.449,0.467,77,97,0.794,11,91,102,138,45,25,64,82,361
2011,Sebastian Telfair,PG,25,MIN,37,8,711,97,241,0.402,28,78,0.359,69,163,0.423,0.461,44,60,0.733,17,37,54,111,25,3,64,64,266
2011,Garrett Temple,SG,24,SAS,3,0,21,1,5,0.2,0,1,0,1,4,0.25,0.2,0,2,0,1,1,2,2,1,1,1,2,2
2011,Garrett Temple,SG,24,MIL,9,0,83,7,21,0.333,3,10,0.3,4,11,0.364,0.405,0,4,0,0,6,6,6,1,1,2,8,17
2011,Garrett Temple,PG,24,CHA,12,0,126,12,42,0.286,7,26,0.269,5,16,0.313,0.369,7,11,0.636,0,15,15,24,9,4,20,14,38
2011,Hasheem Thabeet,C,23,MEM,45,0,369,17,39,0.436,0,0,NA,17,39,0.436,0.436,19,35,0.543,24,51,75,4,9,15,17,73,53
2011,Hasheem Thabeet,C,23,HOU,2,0,4,0,1,0,0,0,NA,0,1,0,0,0,0,NA,0,0,0,0,0,1,0,3,0
2011,Kurt Thomas,PF,38,CHI,52,37,1178,95,186,0.511,1,1,1,94,185,0.508,0.513,20,32,0.625,75,226,301,60,32,42,42,164,211
2011,Tyrus Thomas,C,24,CHA,41,2,861,156,331,0.471,0,3,0,156,328,0.476,0.471,107,136,0.787,65,159,224,29,30,66,65,113,419
2011,Jason Thompson,PF,24,SAC,75,39,1748,271,534,0.507,0,3,0,271,531,0.51,0.507,121,200,0.605,144,310,454,88,28,44,99,212,663
2011,Al Thornton,SF,27,WAS,49,23,1069,154,327,0.471,4,25,0.16,150,302,0.497,0.477,81,107,0.757,46,110,156,51,28,9,44,103,393
2011,Al Thornton,PF,27,GSW,22,0,314,51,104,0.49,0,1,0,51,103,0.495,0.49,29,35,0.829,10,47,57,11,7,3,20,40,131
2011,Marcus Thornton,SG,23,NOH,46,0,745,137,334,0.41,35,93,0.376,102,241,0.423,0.463,50,66,0.758,25,106,131,43,19,4,37,50,359
2011,Marcus Thornton,SG,23,SAC,27,23,1030,213,473,0.45,53,147,0.361,160,326,0.491,0.506,95,118,0.805,36,91,127,92,45,5,56,60,574
2011,Anthony Tolliver,SF,25,MIN,65,4,1362,141,313,0.45,47,115,0.409,94,198,0.475,0.526,105,131,0.802,92,203,295,82,28,28,49,145,434
2011,Ronny Turiaf,C,28,NYK,64,21,1141,103,163,0.632,0,0,NA,103,163,0.632,0.632,61,98,0.622,64,143,207,92,35,73,41,160,267
2011,Hedo Türkoğlu,PF,31,PHO,25,16,630,85,193,0.44,41,97,0.423,44,96,0.458,0.547,26,36,0.722,20,80,100,58,18,14,31,77,237
2011,Hedo Türkoğlu,SF,31,ORL,56,56,1910,237,529,0.448,86,213,0.404,151,316,0.478,0.529,80,120,0.667,25,231,256,285,54,20,101,170,640
2011,Evan Turner,SG,22,PHI,78,14,1797,225,529,0.425,14,44,0.318,211,485,0.435,0.439,101,125,0.808,42,264,306,159,49,14,80,138,565
2011,Ekpe Udoh,C,23,GSW,58,18,1030,97,222,0.437,0,0,NA,97,222,0.437,0.437,42,64,0.656,80,101,181,40,22,86,48,144,236
2011,Beno Udrih,PG,28,SAC,79,64,2734,412,824,0.5,65,182,0.357,347,642,0.54,0.539,197,228,0.864,41,224,265,386,94,9,141,181,1086
2011,Ben Uzoh,PG,22,NJN,42,0,438,61,144,0.424,3,8,0.375,58,136,0.426,0.434,33,56,0.589,30,31,61,69,13,8,25,29,158
2011,Anderson Varejão,C,28,CLE,31,31,994,114,216,0.528,0,2,0,114,214,0.533,0.528,54,81,0.667,98,203,301,45,27,38,40,87,282
2011,Greivis Vásquez,PG,24,MEM,70,1,860,95,233,0.408,25,86,0.291,70,147,0.476,0.461,34,44,0.773,12,61,73,151,22,4,70,83,249
2011,Sasha Vujačić,SG,26,LAL,11,0,54,8,23,0.348,3,7,0.429,5,16,0.313,0.413,1,2,0.5,1,3,4,5,1,0,5,7,20
2011,Sasha Vujačić,SG,26,NJN,56,17,1594,231,572,0.404,94,255,0.369,137,317,0.432,0.486,80,94,0.851,29,153,182,127,53,5,61,129,636
2011,Dwyane Wade,SG,29,MIA,76,76,2823,692,1384,0.5,63,206,0.306,629,1178,0.534,0.523,494,652,0.758,123,362,485,346,111,87,237,197,1941
2011,Von Wafer,SG,25,BOS,58,2,553,67,159,0.421,18,67,0.269,49,92,0.533,0.478,32,38,0.842,7,42,49,35,18,5,20,39,184
2011,Henry Walker,SG,23,NYK,61,1,784,104,236,0.441,59,153,0.386,45,83,0.542,0.566,31,44,0.705,16,106,122,34,21,6,37,81,298
2011,Ben Wallace,C,36,DET,54,49,1238,67,149,0.45,1,2,0.5,66,147,0.449,0.453,19,57,0.333,129,221,350,72,54,54,44,81,154
2011,Gerald Wallace,SF,28,CHA,48,48,1872,252,582,0.433,35,106,0.33,217,476,0.456,0.463,210,284,0.739,72,322,394,116,59,48,100,120,749
2011,Gerald Wallace,PF,28,POR,23,15,821,134,269,0.498,27,80,0.338,107,189,0.566,0.548,69,90,0.767,39,136,175,57,46,15,52,63,364
2011,Luke Walton,SF,30,LAL,54,0,484,38,116,0.328,8,34,0.235,30,82,0.366,0.362,7,10,0.7,9,58,67,62,9,4,31,38,91
2011,Hakim Warrick,PF,28,PHO,80,6,1416,228,446,0.511,1,11,0.091,227,435,0.522,0.512,212,294,0.721,88,208,296,69,32,9,79,100,669
2011,Earl Watson,PG,31,UTA,80,13,1567,126,307,0.41,36,107,0.336,90,200,0.45,0.469,55,82,0.671,52,130,182,278,61,17,116,146,343
2011,Sonny Weems,SF,24,TOR,59,28,1413,228,513,0.444,17,61,0.279,211,452,0.467,0.461,72,94,0.766,39,114,153,104,34,2,86,87,545
2011,Delonte West,PG,27,BOS,24,2,453,55,120,0.458,12,33,0.364,43,87,0.494,0.508,13,15,0.867,6,31,37,64,20,10,30,29,135
2011,D.J. White,PF,24,OKC,23,0,219,30,65,0.462,0,0,NA,30,65,0.462,0.462,5,10,0.5,12,40,52,4,6,8,7,31,65
2011,D.J. White,C,24,CHA,24,0,466,81,154,0.526,0,2,0,81,152,0.533,0.526,41,54,0.759,31,75,106,15,6,12,7,46,203
2011,Chris Wilcox,PF,28,DET,57,29,995,187,322,0.581,0,1,0,187,321,0.583,0.581,50,89,0.562,95,176,271,43,29,17,43,145,424
2011,Deron Williams,PG,26,UTA,53,53,2009,369,806,0.458,89,258,0.345,280,548,0.511,0.513,302,354,0.853,32,173,205,514,64,12,187,152,1129
2011,Deron Williams,PG,26,NJN,12,12,456,59,169,0.349,16,59,0.271,43,110,0.391,0.396,46,58,0.793,8,47,55,153,15,3,43,38,180
2011,Jason Williams,PG,35,ORL,16,0,171,13,38,0.342,7,23,0.304,6,15,0.4,0.434,0,0,NA,3,19,22,24,8,0,11,6,33
2011,Jason Williams,PG,35,MEM,11,0,124,9,29,0.31,3,15,0.2,6,14,0.429,0.362,0,0,NA,0,8,8,28,3,1,7,2,21
2011,Lou Williams,SG,24,PHI,75,0,1747,323,795,0.406,88,253,0.348,235,542,0.434,0.462,293,356,0.823,32,117,149,252,47,17,102,128,1027
2011,Marvin Williams,SF,24,ATL,65,52,1865,246,537,0.458,37,110,0.336,209,427,0.489,0.493,147,174,0.845,68,245,313,88,34,23,62,104,676
2011,Mo Williams,PG,28,CLE,36,34,1065,178,462,0.385,36,136,0.265,142,326,0.436,0.424,85,102,0.833,15,82,97,257,33,10,105,91,477
2011,Mo Williams,PG,28,LAC,22,22,723,113,268,0.422,43,108,0.398,70,160,0.438,0.502,66,75,0.88,6,50,56,123,20,0,66,59,335
2011,Reggie Williams,SF,24,GSW,80,9,1626,268,572,0.469,102,241,0.423,166,331,0.502,0.558,100,134,0.746,45,171,216,121,28,3,57,124,738
2011,Shawne Williams,PF,24,NYK,64,11,1323,164,385,0.426,85,212,0.401,79,173,0.457,0.536,41,49,0.837,60,179,239,47,39,51,46,164,454
2011,Shelden Williams,PF,27,DEN,42,32,713,82,181,0.453,0,0,NA,82,181,0.453,0.453,34,46,0.739,74,149,223,19,18,22,37,92,198
2011,Shelden Williams,PF,27,NYK,17,6,198,21,39,0.538,0,0,NA,21,39,0.538,0.538,24,29,0.828,19,31,50,13,5,4,6,34,66
2011,Terrence Williams,SG,23,NJN,10,0,206,29,73,0.397,4,12,0.333,25,61,0.41,0.425,5,10,0.5,3,33,36,31,5,0,25,21,67
2011,Terrence Williams,SG,23,HOU,11,0,84,14,42,0.333,2,10,0.2,12,32,0.375,0.357,9,11,0.818,1,14,15,7,4,0,8,4,39
2011,Metta World Peace,SF,31,LAL,82,82,2410,261,658,0.397,83,233,0.356,178,425,0.419,0.46,92,136,0.676,100,167,267,175,124,36,90,181,697
2011,Antoine Wright,SG,26,SAC,7,0,31,1,8,0.125,0,4,0,1,4,0.25,0.125,0,0,NA,2,1,3,0,1,0,1,3,2
2011,Brandan Wright,PF,23,GSW,21,1,195,38,63,0.603,0,0,NA,38,63,0.603,0.603,7,14,0.5,14,27,41,5,3,10,10,19,83
2011,Brandan Wright,PF,23,NJN,16,1,184,22,54,0.407,0,0,NA,22,54,0.407,0.407,14,17,0.824,17,31,48,7,8,7,4,15,58
2011,Nick Young,SG,25,WAS,64,40,2034,412,935,0.441,105,271,0.387,307,664,0.462,0.497,186,228,0.816,26,148,174,75,45,17,90,144,1115
2011,Sam Young,SF,25,MEM,78,46,1577,233,494,0.472,17,50,0.34,216,444,0.486,0.489,89,116,0.767,40,147,187,71,68,23,61,120,572
2011,Thaddeus Young,PF,22,PHI,82,1,2135,458,847,0.541,6,22,0.273,452,825,0.548,0.544,123,174,0.707,153,281,434,82,90,26,99,170,1045
2012,Jeff Adrien,PF,25,HOU,8,0,63,7,16,0.438,0,0,NA,7,16,0.438,0.438,7,12,0.583,5,17,22,1,0,2,2,13,21
2012,Arron Afflalo,SG,26,DEN,62,62,2086,329,699,0.471,88,221,0.398,241,478,0.504,0.534,197,247,0.798,40,157,197,149,36,13,85,134,943
2012,Cole Aldrich,C,23,OKC,26,0,173,22,42,0.524,0,0,NA,22,42,0.524,0.524,13,14,0.929,13,35,48,3,8,16,9,22,57
2012,LaMarcus Aldridge,PF,26,POR,55,55,1994,483,943,0.512,2,11,0.182,481,932,0.516,0.513,223,274,0.814,150,292,442,134,51,45,111,153,1191
2012,Lavoy Allen,PF,22,PHI,41,15,624,79,167,0.473,0,0,NA,79,167,0.473,0.473,11,14,0.786,47,124,171,34,13,18,20,73,169
2012,Ray Allen,SG,36,BOS,46,42,1565,226,493,0.458,106,234,0.453,120,259,0.463,0.566,97,106,0.915,14,128,142,109,49,8,68,83,655
2012,Al-Farouq Aminu,SF,21,NOH,66,21,1477,150,365,0.411,13,47,0.277,137,318,0.431,0.429,86,114,0.754,95,213,308,66,59,34,91,136,399
2012,Lou Amundson,PF,29,IND,60,0,753,89,207,0.43,0,0,NA,89,207,0.43,0.43,35,82,0.427,94,128,222,14,27,44,45,125,213
2012,Chris Andersen,C,33,DEN,32,1,486,59,108,0.546,0,0,NA,59,108,0.546,0.546,50,82,0.61,48,100,148,6,19,46,17,52,168
2012,James Anderson,SG,22,SAS,51,2,603,66,174,0.379,19,68,0.279,47,106,0.443,0.434,39,52,0.75,16,63,79,41,8,2,30,35,190
2012,Ryan Anderson,PF,23,ORL,61,61,1964,332,757,0.439,166,422,0.393,166,335,0.496,0.548,150,171,0.877,224,247,471,54,50,26,57,146,980
2012,Carmelo Anthony,SF,27,NYK,55,55,1876,441,1025,0.43,68,203,0.335,373,822,0.454,0.463,295,367,0.804,88,256,344,200,62,24,144,156,1245
2012,Joel Anthony,C,29,MIA,64,51,1349,85,152,0.559,0,0,NA,85,152,0.559,0.559,49,71,0.69,100,150,250,9,36,84,45,126,219
2012,Gilbert Arenas,PG,30,MEM,17,0,211,26,64,0.406,13,39,0.333,13,25,0.52,0.508,7,10,0.7,2,16,18,18,11,1,12,35,72
2012,Trevor Ariza,SF,26,NOH,41,41,1350,168,403,0.417,29,87,0.333,139,316,0.44,0.453,79,102,0.775,41,174,215,135,69,25,76,73,444
2012,Ömer Aşık,C,25,CHI,66,2,971,79,156,0.506,0,0,NA,79,156,0.506,0.506,47,103,0.456,127,223,350,32,30,68,68,121,205
2012,D.J. Augustin,PG,24,CHA,48,46,1408,183,487,0.376,61,179,0.341,122,308,0.396,0.438,105,120,0.875,24,85,109,307,36,1,110,65,532
2012,Gustavo Ayón,PF,26,NOH,54,24,1088,140,261,0.536,0,1,0,140,260,0.538,0.536,39,63,0.619,86,179,265,74,53,46,46,118,319
2012,Luke Babbitt,SF,22,POR,40,4,537,71,173,0.41,43,100,0.43,28,73,0.384,0.535,17,20,0.85,16,79,95,16,10,4,27,46,202
2012,Renaldo Balkman,SF,27,NYK,14,0,115,16,32,0.5,2,9,0.222,14,23,0.609,0.531,8,11,0.727,6,20,26,5,4,3,6,14,42
2012,Leandro Barbosa,SG,29,TOR,42,0,946,198,454,0.436,40,111,0.36,158,343,0.461,0.48,76,91,0.835,21,58,79,63,36,7,68,101,512
2012,Leandro Barbosa,SG,29,IND,22,0,436,73,183,0.399,25,59,0.424,48,124,0.387,0.467,25,33,0.758,12,37,49,33,20,0,26,34,196
2012,Matt Barnes,SF,31,LAL,63,16,1440,175,387,0.452,46,138,0.333,129,249,0.518,0.512,95,128,0.742,97,247,344,126,35,48,73,152,491
2012,Earl Barron,C,30,GSW,2,0,9,2,4,0.5,0,0,NA,2,4,0.5,0.5,0,0,NA,1,0,1,0,0,0,0,5,4
2012,Tony Battie,C,35,PHI,27,11,295,19,51,0.373,0,1,0,19,50,0.38,0.373,4,4,1,8,59,67,16,4,6,4,26,42
2012,Shane Battier,SF,33,MIA,65,10,1499,113,292,0.387,62,183,0.339,51,109,0.468,0.493,23,37,0.622,56,100,156,82,64,33,37,105,311
2012,Jerryd Bayless,PG,23,TOR,31,11,705,117,276,0.424,44,104,0.423,73,172,0.424,0.504,75,88,0.852,8,58,66,118,24,4,53,70,353
2012,Marco Belinelli,SG,25,NOH,66,55,1966,286,686,0.417,107,284,0.377,179,402,0.445,0.495,101,129,0.783,19,153,172,101,48,5,69,115,780
2012,Raja Bell,SG,35,UTA,34,33,796,81,174,0.466,34,87,0.391,47,87,0.54,0.563,21,25,0.84,6,43,49,38,13,2,21,78,217
2012,Mike Bibby,PG,33,NYK,39,4,557,35,124,0.282,27,85,0.318,8,39,0.205,0.391,6,8,0.75,5,54,59,80,21,3,20,45,103
2012,Chauncey Billups,SG,35,LAC,20,20,607,83,228,0.364,48,125,0.384,35,103,0.34,0.469,85,95,0.895,4,46,50,80,9,3,38,40,299
2012,Steve Blake,PG,31,LAL,53,5,1237,101,268,0.377,53,158,0.335,48,110,0.436,0.476,21,27,0.778,9,76,85,175,39,2,72,75,276
2012,Eric Bledsoe,PG,22,LAC,40,1,464,49,126,0.389,6,30,0.2,43,96,0.448,0.413,28,44,0.636,22,43,65,66,31,14,47,58,132
2012,Keith Bogans,SF,31,NJN,5,1,94,8,21,0.381,3,12,0.25,5,9,0.556,0.452,2,5,0.4,5,6,11,3,2,0,3,15,21
2012,Andrew Bogut,C,27,MIL,12,12,364,61,136,0.449,0,1,0,61,135,0.452,0.449,14,23,0.609,22,78,100,31,12,24,24,36,136
2012,Trevor Booker,PF,24,WAS,50,32,1261,181,341,0.531,1,2,0.5,180,339,0.531,0.532,56,93,0.602,119,206,325,40,48,43,58,138,419
2012,Earl Boykins,PG,35,HOU,8,0,111,12,36,0.333,2,9,0.222,10,27,0.37,0.361,13,15,0.867,0,11,11,17,1,0,7,5,39
2012,Avery Bradley,PG,21,BOS,64,28,1368,200,402,0.498,22,54,0.407,178,348,0.511,0.525,62,78,0.795,34,81,115,87,43,12,75,109,484
2012,Corey Brewer,SF,25,DEN,59,17,1287,201,463,0.434,33,127,0.26,168,336,0.5,0.47,90,130,0.692,43,107,150,88,72,17,56,113,525
2012,Ronnie Brewer,SG,26,CHI,66,43,1635,190,445,0.427,19,69,0.275,171,376,0.455,0.448,56,100,0.56,72,159,231,137,72,21,59,64,455
2012,MarShon Brooks,SG,23,NJN,56,47,1648,274,640,0.428,47,150,0.313,227,490,0.463,0.465,113,148,0.764,70,130,200,131,52,15,118,116,708
2012,Derrick Brown,SF,24,CHA,65,17,1443,212,409,0.518,6,24,0.25,206,385,0.535,0.526,94,141,0.667,95,141,236,67,48,12,55,96,524
2012,Kwame Brown,C,29,GSW,9,3,187,21,40,0.525,0,0,NA,21,40,0.525,0.525,15,34,0.441,16,41,57,4,8,0,14,21,57
2012,Shannon Brown,SG,26,PHO,59,19,1400,251,598,0.42,68,188,0.362,183,410,0.446,0.477,80,99,0.808,38,119,157,69,44,15,64,66,650
2012,Chase Budinger,SF,23,HOU,58,9,1298,208,471,0.442,88,219,0.402,120,252,0.476,0.535,54,70,0.771,38,179,217,74,29,7,55,65,558
2012,Alec Burks,SG,20,UTA,59,0,939,153,357,0.429,15,45,0.333,138,312,0.442,0.45,104,143,0.727,57,75,132,55,27,5,51,84,425
2012,Caron Butler,SF,31,LAC,63,63,1871,287,705,0.407,92,257,0.358,195,448,0.435,0.472,87,107,0.813,44,186,230,78,52,9,77,123,753
2012,Jimmy Butler,SG,22,CHI,42,0,359,32,79,0.405,2,11,0.182,30,68,0.441,0.418,43,56,0.768,23,33,56,14,11,5,14,20,109
2012,Rasual Butler,SF,32,TOR,34,14,453,41,133,0.308,21,77,0.273,20,56,0.357,0.387,7,12,0.583,6,60,66,19,7,5,15,39,110
2012,Andrew Bynum,C,24,LAL,60,60,2112,444,796,0.558,1,5,0.2,443,791,0.56,0.558,234,338,0.692,192,517,709,85,27,116,152,104,1123
2012,José Calderón,PG,30,TOR,53,53,1799,218,477,0.457,59,159,0.371,159,318,0.5,0.519,60,68,0.882,19,141,160,468,47,3,104,94,555
2012,Marcus Camby,C,37,POR,40,40,894,67,161,0.416,0,0,NA,67,161,0.416,0.416,18,38,0.474,105,249,354,75,33,56,47,88,152
2012,Marcus Camby,C,37,HOU,19,13,458,61,126,0.484,2,5,0.4,59,121,0.488,0.492,11,26,0.423,52,124,176,32,17,29,10,38,135
2012,DeMarre Carroll,PF,25,DEN,4,0,21,6,6,1,0,0,NA,6,6,1,1,0,0,NA,0,3,3,3,0,0,2,1,12
2012,DeMarre Carroll,SF,25,UTA,20,9,327,37,99,0.374,7,19,0.368,30,80,0.375,0.409,14,16,0.875,28,22,50,15,12,1,9,36,95
2012,Matt Carroll,SG,31,CHA,53,2,596,52,157,0.331,8,43,0.186,44,114,0.386,0.357,30,38,0.789,8,50,58,38,16,7,24,52,142
2012,Anthony Carter,PG,36,TOR,24,0,209,17,53,0.321,5,17,0.294,12,36,0.333,0.368,8,10,0.8,5,28,33,34,8,4,17,20,47
2012,Vince Carter,SG,35,DAL,61,40,1542,223,542,0.411,74,205,0.361,149,337,0.442,0.48,95,115,0.826,32,173,205,139,56,25,84,134,615
2012,Omri Casspi,SF,23,CLE,65,35,1341,166,412,0.403,53,168,0.315,113,244,0.463,0.467,74,108,0.685,63,165,228,66,37,21,64,115,459
2012,Mario Chalmers,PG,25,MIA,64,64,1825,223,498,0.448,101,260,0.388,122,238,0.513,0.549,80,101,0.792,16,155,171,222,97,11,142,166,627
2012,Tyson Chandler,C,29,NYK,62,62,2061,241,355,0.679,0,2,0,241,353,0.683,0.679,217,315,0.689,212,400,612,56,56,89,102,186,699
2012,Wilson Chandler,SF,24,DEN,8,6,215,31,79,0.392,3,12,0.25,28,67,0.418,0.411,10,12,0.833,6,35,41,17,6,6,18,18,75
2012,Earl Clark,PF,24,ORL,45,1,559,51,139,0.367,0,0,NA,51,139,0.367,0.367,21,29,0.724,35,89,124,18,12,32,25,72,123
2012,Norris Cole,PG,23,MIA,65,2,1260,177,450,0.393,21,76,0.276,156,374,0.417,0.417,66,85,0.776,21,70,91,133,44,2,105,124,441
2012,Jason Collins,C,33,ATL,30,10,308,16,40,0.4,0,0,NA,16,40,0.4,0.4,7,15,0.467,12,36,48,10,4,3,10,34,39
2012,Brian Cook,PF,31,LAC,16,0,121,11,49,0.224,5,27,0.185,6,22,0.273,0.276,4,4,1,4,19,23,2,2,4,4,26,31
2012,Brian Cook,PF,31,WAS,16,0,155,20,49,0.408,5,23,0.217,15,26,0.577,0.459,5,6,0.833,6,34,40,8,4,1,7,22,50
2012,Daequan Cook,SG,24,OKC,57,22,989,109,296,0.368,79,228,0.346,30,68,0.441,0.502,14,22,0.636,12,110,122,15,22,11,16,69,311
2012,DeMarcus Cousins,C,21,SAC,64,62,1950,448,999,0.448,2,14,0.143,446,985,0.453,0.449,262,373,0.702,265,438,703,102,93,75,170,257,1160
2012,Jamal Crawford,PG,31,POR,60,6,1613,283,737,0.384,80,260,0.308,203,477,0.426,0.438,191,206,0.927,16,102,118,191,55,14,111,74,837
2012,Jordan Crawford,SG,23,WAS,64,32,1753,349,872,0.4,79,273,0.289,270,599,0.451,0.446,161,203,0.793,44,124,168,190,59,5,141,111,938
2012,Dante Cunningham,PF,24,MEM,64,5,1124,144,279,0.516,0,2,0,144,277,0.52,0.516,45,69,0.652,91,155,246,37,42,34,29,98,333
2012,Baron Davis,PG,32,NYK,29,14,595,68,184,0.37,26,85,0.306,42,99,0.424,0.44,16,24,0.667,13,43,56,135,34,3,76,61,178
2012,Ed Davis,PF,22,TOR,66,9,1534,172,335,0.513,0,1,0,172,334,0.515,0.513,71,106,0.67,134,304,438,60,40,63,67,156,415
2012,Glen Davis,PF,26,ORL,61,13,1427,225,534,0.421,2,14,0.143,223,520,0.429,0.423,114,167,0.683,107,224,331,47,43,19,75,106,566
2012,Josh Davis,PF,31,MEM,15,0,130,10,27,0.37,4,13,0.308,6,14,0.429,0.444,4,8,0.5,16,11,27,6,7,1,3,19,28
2012,Austin Daye,SF,23,DET,41,4,603,73,227,0.322,13,62,0.21,60,165,0.364,0.35,35,43,0.814,14,77,91,33,22,21,40,62,194
2012,Luol Deng,SF,26,CHI,54,54,2129,311,755,0.412,79,215,0.367,232,540,0.43,0.464,127,165,0.77,77,273,350,157,56,36,96,81,828
2012,Justin Dentmon,PG,26,SAS,2,0,19,2,6,0.333,0,4,0,2,2,1,0.333,0,0,NA,0,1,1,1,1,0,1,2,4
2012,Justin Dentmon,PG,26,TOR,4,0,72,8,22,0.364,2,10,0.2,6,12,0.5,0.409,4,6,0.667,0,7,7,9,1,0,6,8,22
2012,Boris Diaw,PF,29,CHA,37,28,1018,116,283,0.41,23,86,0.267,93,197,0.472,0.451,17,27,0.63,47,148,195,158,20,19,84,71,272
2012,Boris Diaw,PF,29,SAS,20,7,406,40,68,0.588,8,13,0.615,32,55,0.582,0.647,5,8,0.625,23,62,85,47,14,6,28,54,93
2012,Ike Diogu,PF,28,SAS,2,0,14,0,2,0,0,0,NA,0,2,0,0,2,2,1,0,1,1,0,0,0,1,1,2
2012,DeSagana Diop,C,30,CHA,27,9,325,15,42,0.357,0,0,NA,15,42,0.357,0.357,1,6,0.167,33,52,85,23,6,13,19,36,31
2012,Toney Douglas,PG,25,NYK,38,9,656,94,290,0.324,27,117,0.231,67,173,0.387,0.371,22,26,0.846,16,56,72,77,29,1,56,55,237
2012,Goran Dragić,PG,25,HOU,66,28,1752,277,600,0.462,68,202,0.337,209,398,0.525,0.518,153,190,0.805,53,115,168,351,85,10,157,166,775
2012,Jared Dudley,SG,26,PHO,65,60,2020,312,643,0.485,80,209,0.383,232,434,0.535,0.547,119,164,0.726,95,206,301,112,49,19,72,107,823
2012,Mike Dunleavy,SF,31,MIL,55,3,1445,239,504,0.474,83,208,0.399,156,296,0.527,0.557,116,143,0.811,29,175,204,117,28,8,58,87,677
2012,Wayne Ellington,SG,24,MIN,51,4,973,122,302,0.404,35,108,0.324,87,194,0.448,0.462,32,40,0.8,14,85,99,33,26,10,26,56,311
2012,Monta Ellis,SG,26,GSW,37,37,1365,305,704,0.433,50,156,0.321,255,548,0.465,0.469,151,186,0.812,16,111,127,223,56,12,123,84,811
2012,Monta Ellis,SG,26,MIL,21,21,755,145,336,0.432,12,45,0.267,133,291,0.457,0.449,68,89,0.764,4,69,73,123,29,6,54,52,370
2012,Francisco Elson,C,35,PHI,5,0,16,1,3,0.333,0,0,NA,1,3,0.333,0.333,0,0,NA,0,1,1,1,1,1,1,0,2
2012,Semih Erden,C,25,CLE,28,9,333,39,74,0.527,0,0,NA,39,74,0.527,0.527,21,41,0.512,20,52,72,9,10,5,16,60,99
2012,Maurice Evans,SF,33,WAS,24,0,343,45,112,0.402,17,45,0.378,28,67,0.418,0.478,10,13,0.769,8,16,24,9,14,0,10,36,117
2012,Reggie Evans,PF,31,LAC,56,0,771,34,72,0.472,0,0,NA,34,72,0.472,0.472,36,71,0.507,100,171,271,17,31,6,44,118,104
2012,Tyreke Evans,SG,22,SAC,63,61,2162,408,900,0.453,20,99,0.202,388,801,0.484,0.464,201,258,0.779,64,225,289,283,84,29,171,136,1037
2012,Christian Eyenga,SF,22,CLE,6,0,83,3,19,0.158,1,2,0.5,2,17,0.118,0.184,2,6,0.333,3,9,12,4,3,4,2,7,9
2012,Christian Eyenga,SF,22,LAL,1,0,19,3,6,0.5,0,1,0,3,5,0.6,0.5,2,2,1,1,1,2,1,0,1,1,0,8
2012,Kenneth Faried,PF,22,DEN,46,39,1037,181,309,0.586,0,0,NA,181,309,0.586,0.586,109,164,0.665,142,210,352,36,34,47,54,116,471
2012,Derrick Favors,PF,20,UTA,65,9,1376,222,445,0.499,0,0,NA,222,445,0.499,0.499,126,194,0.649,158,267,425,43,38,65,103,145,570
2012,Raymond Felton,PG,27,POR,60,56,1906,261,642,0.407,62,203,0.305,199,439,0.453,0.455,100,124,0.806,27,122,149,390,78,10,170,122,684
2012,Derek Fisher,PG,37,LAL,43,43,1101,92,240,0.383,24,74,0.324,68,166,0.41,0.433,44,53,0.83,10,82,92,142,40,3,58,85,252
2012,Derek Fisher,PG,37,OKC,20,0,407,37,108,0.343,11,35,0.314,26,73,0.356,0.394,13,14,0.929,2,27,29,28,11,1,15,32,98
2012,Jonny Flynn,PG,22,HOU,11,0,135,12,41,0.293,2,9,0.222,10,32,0.313,0.317,11,14,0.786,1,7,8,28,3,1,9,8,37
2012,Jonny Flynn,PG,22,POR,18,1,281,34,90,0.378,8,25,0.32,26,65,0.4,0.422,18,25,0.72,7,24,31,68,3,1,27,15,94
2012,Courtney Fortson,PG,23,LAC,4,0,46,5,12,0.417,1,4,0.25,4,8,0.5,0.458,6,9,0.667,4,4,8,5,0,0,5,3,17
2012,Courtney Fortson,PG,23,HOU,6,0,49,6,20,0.3,2,9,0.222,4,11,0.364,0.35,4,6,0.667,2,5,7,5,3,0,5,2,18
2012,Randy Foye,SG,28,LAC,65,48,1682,256,644,0.398,127,329,0.386,129,315,0.41,0.496,73,85,0.859,25,113,138,146,46,24,73,130,712
2012,Jimmer Fredette,PG,22,SAC,61,7,1135,172,446,0.386,78,216,0.361,94,230,0.409,0.473,40,48,0.833,17,56,73,108,30,3,67,73,462
2012,Enes Freedom,C,19,UTA,66,0,874,117,236,0.496,0,1,0,117,235,0.498,0.496,70,105,0.667,107,171,278,8,18,23,54,87,304
2012,Channing Frye,PF,28,PHO,64,59,1669,255,613,0.416,91,263,0.346,164,350,0.469,0.49,73,82,0.89,71,308,379,88,42,70,63,176,674
2012,Dan Gadzuric,C,33,NYK,2,0,13,0,2,0,0,0,NA,0,2,0,0,0,2,0,1,4,5,0,1,1,1,4,0
2012,Sundiata Gaines,SG,25,NJN,57,12,793,102,271,0.376,28,82,0.341,74,189,0.392,0.428,59,96,0.615,27,81,108,126,55,2,52,58,291
2012,Danilo Gallinari,SF,23,DEN,43,40,1351,193,466,0.414,60,183,0.328,133,283,0.47,0.479,182,209,0.871,28,174,202,116,42,23,68,86,628
2012,Francisco García,SF,30,SAC,49,3,798,86,229,0.376,38,131,0.29,48,98,0.49,0.459,24,30,0.8,11,88,99,31,36,37,22,73,234
2012,Kevin Garnett,C,35,BOS,60,60,1864,391,777,0.503,3,9,0.333,388,768,0.505,0.505,162,189,0.857,66,428,494,175,56,61,107,141,947
2012,Marc Gasol,C,27,MEM,65,65,2370,357,740,0.482,1,12,0.083,356,728,0.489,0.483,237,317,0.748,120,459,579,204,62,121,121,201,952
2012,Pau Gasol,PF,31,LAL,65,65,2430,459,917,0.501,7,27,0.259,452,890,0.508,0.504,204,261,0.782,183,495,678,237,37,88,142,127,1129
2012,Rudy Gay,SF,25,MEM,65,65,2422,485,1067,0.455,54,173,0.312,431,894,0.482,0.48,208,263,0.791,130,287,417,147,95,55,161,138,1232
2012,Alonzo Gee,SG,24,CLE,63,31,1827,227,551,0.412,44,137,0.321,183,414,0.442,0.452,167,212,0.788,101,221,322,113,83,17,114,149,665
2012,Taj Gibson,PF,26,CHI,63,0,1284,200,404,0.495,0,0,NA,200,404,0.495,0.495,84,135,0.622,135,197,332,47,27,81,60,131,484
2012,Mickell Gladness,PF,25,MIA,8,0,28,1,3,0.333,0,0,NA,1,3,0.333,0.333,0,0,NA,1,10,11,2,1,1,3,8,2
2012,Mickell Gladness,PF,25,GSW,18,7,224,24,56,0.429,0,0,NA,24,56,0.429,0.429,6,12,0.5,13,34,47,3,3,19,4,24,54
2012,Drew Gooden,C,30,MIL,56,46,1469,287,657,0.437,16,55,0.291,271,602,0.45,0.449,176,208,0.846,130,233,363,144,46,34,109,112,766
2012,Marcin Gortat,C,27,PHO,66,66,2114,427,769,0.555,0,2,0,427,767,0.557,0.555,163,251,0.649,185,474,659,59,48,99,90,142,1017
2012,Danny Granger,SF,28,IND,62,62,2062,391,941,0.416,123,323,0.381,268,618,0.434,0.481,254,291,0.873,79,228,307,109,62,40,110,144,1159
2012,Aaron Gray,C,27,TOR,49,40,813,83,161,0.516,0,0,NA,83,161,0.516,0.516,25,47,0.532,83,198,281,27,22,17,51,127,191
2012,Gerald Green,SF,26,NJN,31,2,781,154,320,0.481,43,110,0.391,111,210,0.529,0.548,49,65,0.754,15,93,108,34,28,17,55,80,400
2012,Blake Griffin,PF,22,LAC,66,66,2392,561,1022,0.549,2,16,0.125,559,1006,0.556,0.55,244,468,0.521,218,499,717,210,54,48,150,216,1368
2012,Hamed Haddadi,C,26,MEM,35,0,206,26,48,0.542,0,1,0,26,47,0.553,0.542,18,26,0.692,28,43,71,8,1,26,21,43,70
2012,Jordan Hamilton,SF,21,DEN,26,2,258,48,111,0.432,17,47,0.362,31,64,0.484,0.509,2,5,0.4,11,51,62,20,4,3,16,15,115
2012,Luke Harangody,PF,24,CLE,21,1,231,23,65,0.354,5,21,0.238,18,44,0.409,0.392,9,12,0.75,20,33,53,6,6,3,4,17,60
2012,James Harden,SG,22,OKC,62,2,1946,309,629,0.491,114,292,0.39,195,337,0.579,0.582,312,369,0.846,30,222,252,229,62,15,137,150,1044
2012,Al Harrington,PF,31,DEN,64,1,1761,345,773,0.446,101,303,0.333,244,470,0.519,0.512,119,176,0.676,72,318,390,88,58,12,112,181,910
2012,Devin Harris,PG,28,UTA,63,63,1741,241,542,0.445,77,213,0.362,164,329,0.498,0.516,156,209,0.746,12,100,112,316,64,13,122,136,715
2012,Terrel Harris,SG,24,MIA,22,1,318,29,83,0.349,8,39,0.205,21,44,0.477,0.398,14,21,0.667,18,33,51,26,9,2,25,34,80
2012,Tobias Harris,SF,19,MIL,42,9,479,79,169,0.467,6,23,0.261,73,146,0.5,0.485,44,54,0.815,30,71,101,22,13,7,31,45,208
2012,Spencer Hawes,C,23,PHI,37,29,920,156,319,0.489,3,12,0.25,153,307,0.498,0.494,40,55,0.727,78,192,270,98,16,48,55,100,355
2012,Chuck Hayes,C,28,SAC,54,9,1039,73,170,0.429,0,2,0,73,168,0.435,0.429,26,39,0.667,72,162,234,77,36,17,50,111,172
2012,Brendan Haywood,C,32,DAL,54,54,1146,118,228,0.518,0,0,NA,118,228,0.518,0.518,45,96,0.469,139,185,324,19,24,54,46,121,281
2012,Gerald Henderson,SG,24,CHA,55,55,1831,332,723,0.459,11,47,0.234,321,676,0.475,0.467,155,204,0.76,64,161,225,126,49,20,100,128,830
2012,Roy Hibbert,C,25,IND,65,65,1937,332,668,0.497,0,1,0,332,667,0.498,0.497,170,239,0.711,213,359,572,108,32,128,128,195,834
2012,J.J. Hickson,PF,23,SAC,35,9,644,64,173,0.37,0,1,0,64,172,0.372,0.37,37,58,0.638,67,110,177,22,18,17,39,44,165
2012,J.J. Hickson,PF,23,POR,19,10,600,119,219,0.543,0,1,0,119,218,0.546,0.543,49,76,0.645,66,92,158,23,12,18,31,41,287
2012,Nenê,C,29,DEN,28,27,826,143,281,0.509,0,2,0,143,279,0.513,0.509,90,133,0.677,43,165,208,61,36,25,77,69,376
2012,Nenê,C,29,WAS,11,6,284,68,112,0.607,0,2,0,68,110,0.618,0.607,23,35,0.657,20,63,83,19,6,13,19,26,159
2012,George Hill,PG,25,IND,50,9,1274,168,380,0.442,54,147,0.367,114,233,0.489,0.513,91,117,0.778,31,120,151,145,42,17,52,98,481
2012,Jordan Hill,C,24,HOU,32,7,469,68,135,0.504,0,3,0,68,132,0.515,0.504,25,39,0.641,47,108,155,14,9,21,24,60,161
2012,Jordan Hill,C,24,LAL,7,1,82,14,30,0.467,0,0,NA,14,30,0.467,0.467,5,8,0.625,14,17,31,2,5,6,7,11,33
2012,Kirk Hinrich,SG,31,ATL,48,31,1237,122,295,0.414,47,136,0.346,75,159,0.472,0.493,25,32,0.781,11,90,101,132,38,11,58,100,316
2012,Ryan Hollins,C,27,CLE,24,7,362,28,56,0.5,0,0,NA,28,56,0.5,0.5,33,55,0.6,25,31,56,6,4,12,24,55,89
2012,Ryan Hollins,C,27,BOS,15,1,160,18,28,0.643,0,0,NA,18,28,0.643,0.643,6,20,0.3,9,17,26,3,1,5,11,23,42
2012,Josh Howard,SF,31,UTA,43,18,991,144,361,0.399,9,37,0.243,135,324,0.417,0.411,75,97,0.773,39,119,158,50,32,10,53,91,372
2012,Juwan Howard,PF,38,MIA,28,0,190,17,55,0.309,0,0,NA,17,55,0.309,0.309,8,10,0.8,18,29,47,10,4,1,20,18,42
2012,Lester Hudson,PG,27,CLE,13,0,314,59,151,0.391,15,61,0.246,44,90,0.489,0.44,32,38,0.842,7,39,46,35,14,3,30,26,165
2012,Lester Hudson,PG,27,MEM,3,0,20,3,11,0.273,1,3,0.333,2,8,0.25,0.318,2,3,0.667,0,0,0,1,0,0,2,0,9
2012,Larry Hughes,PG,33,ORL,9,0,114,5,22,0.227,1,7,0.143,4,15,0.267,0.25,1,2,0.5,1,4,5,7,2,0,12,10,12
2012,Kris Humphries,PF,26,NJN,62,62,2162,323,671,0.481,0,0,NA,323,671,0.481,0.481,209,278,0.752,233,448,681,90,50,74,119,173,855
2012,Serge Ibaka,PF,22,OKC,66,66,1792,262,490,0.535,1,3,0.333,261,487,0.536,0.536,78,118,0.661,193,305,498,28,33,241,79,179,603
2012,Ersan İlyasova,PF,24,MIL,60,41,1655,294,597,0.492,51,112,0.455,243,485,0.501,0.535,143,183,0.781,196,333,529,71,42,44,76,133,782
2012,Royal Ivey,SG,30,OKC,34,0,354,26,73,0.356,18,53,0.34,8,20,0.4,0.479,1,8,0.125,1,23,24,10,14,0,9,36,71
2012,Jarrett Jack,PG,28,NOH,45,39,1530,266,583,0.456,39,112,0.348,227,471,0.482,0.49,129,148,0.872,23,153,176,285,31,9,106,93,700
2012,Reggie Jackson,PG,21,OKC,45,0,501,51,159,0.321,13,62,0.21,38,97,0.392,0.362,25,29,0.862,14,39,53,71,25,1,36,31,140
2012,Stephen Jackson,SF,33,MIL,26,13,712,97,272,0.357,30,108,0.278,67,164,0.409,0.412,50,60,0.833,16,66,82,77,26,6,66,61,274
2012,Stephen Jackson,SF,33,SAS,21,1,500,62,153,0.405,19,62,0.306,43,91,0.473,0.467,44,54,0.815,6,75,81,41,28,7,37,38,187
2012,Mike James,PG,36,CHI,11,0,120,20,49,0.408,6,10,0.6,14,39,0.359,0.469,7,8,0.875,2,8,10,29,4,2,14,20,53
2012,Antawn Jamison,PF,35,CLE,65,65,2151,421,1044,0.403,91,267,0.341,330,777,0.425,0.447,185,271,0.683,123,285,408,131,51,43,90,164,1118
2012,Richard Jefferson,SF,31,SAS,41,41,1168,132,319,0.414,80,190,0.421,52,129,0.403,0.539,35,50,0.7,18,125,143,55,25,12,32,83,379
2012,Richard Jefferson,SF,31,GSW,22,3,580,71,169,0.42,33,79,0.418,38,90,0.422,0.518,24,35,0.686,8,68,76,33,12,7,18,38,199
2012,Jared Jeffries,PF,30,NYK,39,4,729,59,144,0.41,3,16,0.188,56,128,0.438,0.42,49,72,0.681,69,83,152,26,29,25,29,89,170
2012,Charles Jenkins,PG,22,GSW,51,28,893,130,291,0.447,3,20,0.15,127,271,0.469,0.452,34,39,0.872,8,60,68,170,33,6,60,85,297
2012,Brandon Jennings,PG,22,MIL,66,66,2331,469,1121,0.418,129,388,0.332,340,733,0.464,0.476,193,239,0.808,49,177,226,365,104,22,146,114,1260
2012,Jonas Jerebko,PF,24,DET,64,13,1468,212,453,0.468,32,106,0.302,180,347,0.519,0.503,100,124,0.806,96,212,308,43,41,21,66,162,556
2012,Armon Johnson,PG,22,POR,1,0,5,1,1,1,0,0,NA,1,1,1,1,0,0,NA,0,1,1,0,1,0,1,0,2
2012,Armon Johnson,PG,22,NJN,8,0,119,19,42,0.452,1,3,0.333,18,39,0.462,0.464,6,6,1,1,11,12,11,4,0,5,9,45
2012,Chris Johnson,C,26,POR,20,0,93,11,23,0.478,0,0,NA,11,23,0.478,0.478,10,12,0.833,8,10,18,1,1,8,7,20,32
2012,Chris Johnson,C,26,NOH,7,0,82,9,18,0.5,0,0,NA,9,18,0.5,0.5,5,7,0.714,7,15,22,1,5,1,8,13,23
2012,James Johnson,SF,24,TOR,62,40,1561,233,518,0.45,19,60,0.317,214,458,0.467,0.468,81,115,0.704,74,218,292,122,71,84,101,177,566
2012,Joe Johnson,SG,30,ATL,60,60,2127,423,931,0.454,125,322,0.388,298,609,0.489,0.521,158,186,0.849,53,168,221,232,48,13,116,75,1129
2012,Trey Johnson,SG,27,NOH,11,0,61,8,14,0.571,0,0,NA,8,14,0.571,0.571,5,5,1,3,9,12,4,1,0,5,10,21
2012,Wesley Johnson,SF,24,MIN,65,64,1469,158,397,0.398,53,169,0.314,105,228,0.461,0.465,24,34,0.706,24,153,177,59,35,48,60,115,393
2012,Dahntay Jones,SF,31,IND,65,3,1052,115,281,0.409,33,77,0.429,82,204,0.402,0.468,83,99,0.838,23,94,117,63,23,11,46,119,346
2012,Solomon Jones,PF,27,LAC,10,0,96,1,8,0.125,0,0,NA,1,8,0.125,0.125,4,5,0.8,11,6,17,2,4,5,5,12,6
2012,Solomon Jones,C,27,NOH,11,1,196,23,53,0.434,0,0,NA,23,53,0.434,0.434,15,18,0.833,21,20,41,7,5,6,13,31,61
2012,DeAndre Jordan,C,23,LAC,66,66,1798,206,326,0.632,0,1,0,206,325,0.634,0.632,74,141,0.525,202,344,546,17,30,134,74,189,486
2012,Cory Joseph,PG,20,SAS,29,1,266,22,70,0.314,3,15,0.2,19,55,0.345,0.336,11,17,0.647,5,20,25,34,7,3,12,16,58
2012,Jason Kidd,PG,38,DAL,48,48,1379,99,273,0.363,79,223,0.354,20,50,0.4,0.507,22,28,0.786,15,183,198,264,82,10,91,83,299
2012,Brandon Knight,PG,20,DET,66,60,2129,319,769,0.415,105,276,0.38,214,493,0.434,0.483,104,137,0.759,33,178,211,251,49,10,171,154,847
2012,Kyle Korver,SG,30,CHI,65,7,1469,178,412,0.432,118,271,0.435,60,141,0.426,0.575,55,66,0.833,26,133,159,112,36,15,53,110,529
2012,Kosta Koufos,C,22,DEN,48,24,792,115,192,0.599,0,0,NA,115,192,0.599,0.599,33,55,0.6,95,163,258,15,24,41,33,96,263
2012,Carl Landry,PF,28,NOH,41,8,999,182,362,0.503,0,3,0,182,359,0.507,0.503,147,184,0.799,78,136,214,38,13,12,64,89,511
2012,Ty Lawson,PG,24,DEN,61,61,2124,374,767,0.488,73,200,0.365,301,567,0.531,0.535,178,216,0.824,54,173,227,401,82,6,149,94,999
2012,Courtney Lee,SG,26,HOU,58,26,1757,251,580,0.433,87,217,0.401,164,363,0.452,0.508,71,86,0.826,26,133,159,88,68,22,64,106,660
2012,David Lee,PF,28,GSW,57,57,2121,464,922,0.503,0,5,0,464,917,0.506,0.503,219,280,0.782,171,374,545,162,54,22,149,179,1147
2012,Jon Leuer,PF,22,MIL,46,12,555,97,191,0.508,3,9,0.333,94,182,0.516,0.516,21,28,0.75,45,75,120,25,14,17,18,67,218
2012,Rashard Lewis,SF,32,WAS,28,15,729,85,221,0.385,16,67,0.239,69,154,0.448,0.421,31,37,0.838,34,75,109,27,23,10,32,49,217
2012,DeAndre Liggins,SF,23,ORL,17,0,115,12,25,0.48,0,4,0,12,21,0.571,0.48,9,19,0.474,6,9,15,5,6,0,10,6,33
2012,Jeremy Lin,PG,23,NYK,35,25,940,171,383,0.446,24,75,0.32,147,308,0.477,0.478,146,183,0.798,18,89,107,216,55,9,126,78,512
2012,Shaun Livingston,SG,26,MIL,58,27,1092,127,271,0.469,2,3,0.667,125,268,0.466,0.472,62,79,0.785,39,84,123,122,27,20,66,79,318
2012,Kyle Lowry,PG,25,HOU,47,38,1510,210,513,0.409,79,211,0.374,131,302,0.434,0.486,171,198,0.864,37,176,213,310,73,14,130,133,670
2012,Shelvin Mack,PG,21,WAS,64,0,779,88,220,0.4,12,42,0.286,76,178,0.427,0.427,42,59,0.712,12,80,92,131,28,2,48,50,230
2012,Jamaal Magloire,C,33,TOR,34,1,374,17,45,0.378,0,0,NA,17,45,0.378,0.378,7,27,0.259,25,88,113,6,4,10,22,66,41
2012,Shawn Marion,SF,33,DAL,63,63,1919,288,646,0.446,20,68,0.294,268,578,0.464,0.461,74,93,0.796,145,320,465,132,67,36,98,87,670
2012,Cartier Martin,SF,27,WAS,17,2,391,59,134,0.44,29,75,0.387,30,59,0.508,0.549,11,19,0.579,12,46,58,10,11,2,13,35,158
2012,Kevin Martin,SG,28,HOU,40,40,1264,222,537,0.413,78,225,0.347,144,312,0.462,0.486,160,179,0.894,13,93,106,110,28,3,70,70,682
2012,Roger Mason,SG,31,WAS,52,0,697,103,258,0.399,59,154,0.383,44,104,0.423,0.514,21,27,0.778,7,62,69,47,13,5,32,33,286
2012,Wesley Matthews,SG,25,POR,66,53,2228,314,763,0.412,129,337,0.383,185,426,0.434,0.496,147,171,0.86,56,168,224,113,96,15,73,148,904
2012,Eric Maynor,PG,24,OKC,9,0,137,14,39,0.359,6,17,0.353,8,22,0.364,0.436,4,4,1,3,10,13,22,5,0,11,13,38
2012,Luc Mbah a Moute,PF,25,MIL,43,22,1009,133,261,0.51,1,4,0.25,132,257,0.514,0.511,66,103,0.641,77,150,227,29,40,22,39,93,333
2012,JaVale McGee,C,24,WAS,41,40,1124,214,400,0.535,0,0,NA,214,400,0.535,0.535,58,116,0.5,127,235,362,25,25,101,68,118,486
2012,JaVale McGee,C,24,DEN,20,5,411,93,152,0.612,0,0,NA,93,152,0.612,0.612,19,51,0.373,36,79,115,6,10,31,19,48,205
2012,Tracy McGrady,SF,32,ATL,52,0,837,101,231,0.437,15,33,0.455,86,198,0.434,0.47,56,83,0.675,23,131,154,110,16,15,53,35,273
2012,Dominic McGuire,PF,26,GSW,64,6,1127,94,210,0.448,0,4,0,94,206,0.456,0.448,39,53,0.736,73,173,246,110,44,36,56,104,227
2012,Josh McRoberts,PF,24,LAL,50,6,718,56,118,0.475,3,7,0.429,53,111,0.477,0.487,23,36,0.639,61,110,171,51,15,18,31,74,138
2012,Jodie Meeks,SG,24,PHI,66,50,1644,191,467,0.409,97,266,0.365,94,201,0.468,0.513,77,85,0.906,17,144,161,54,40,3,29,82,556
2012,C.J. Miles,SG,24,UTA,56,14,1145,177,465,0.381,46,150,0.307,131,315,0.416,0.43,108,136,0.794,27,89,116,69,46,18,53,122,508
2012,Darko Miličić,C,26,MIN,29,23,472,59,130,0.454,0,0,NA,59,130,0.454,0.454,16,37,0.432,35,62,97,17,9,25,32,59,134
2012,Andre Miller,SG,35,DEN,66,7,1809,242,552,0.438,18,83,0.217,224,469,0.478,0.455,137,169,0.811,53,168,221,441,63,9,177,133,639
2012,Brad Miller,C,35,MIN,15,1,146,9,27,0.333,7,15,0.467,2,12,0.167,0.463,10,12,0.833,4,15,19,24,4,2,12,10,35
2012,Mike Miller,SG,31,MIA,39,2,752,91,209,0.435,53,117,0.453,38,92,0.413,0.562,2,5,0.4,22,106,128,42,14,6,30,58,237
2012,Nazr Mohammed,C,34,OKC,63,1,692,79,169,0.467,0,1,0,79,168,0.47,0.467,13,23,0.565,59,111,170,14,20,37,26,101,171
2012,Greg Monroe,C,21,DET,66,66,2082,407,781,0.521,0,1,0,407,780,0.522,0.521,201,272,0.739,239,398,637,152,83,46,161,180,1015
2012,Jamario Moon,SF,31,CHA,8,0,123,7,24,0.292,2,10,0.2,5,14,0.357,0.333,2,2,1,2,20,22,5,1,5,8,5,18
2012,Mikki Moore,C,36,GSW,7,0,118,9,20,0.45,0,0,NA,9,20,0.45,0.45,6,7,0.857,7,15,22,5,3,3,7,24,24
2012,Darius Morris,PG,21,LAL,19,0,169,18,42,0.429,4,9,0.444,14,33,0.424,0.476,6,9,0.667,2,14,16,21,2,0,19,16,46
2012,Marcus Morris,PF,22,HOU,17,0,126,16,54,0.296,2,17,0.118,14,37,0.378,0.315,6,8,0.75,5,11,16,3,2,2,4,12,40
2012,Markieff Morris,PF,22,PHO,63,7,1227,174,436,0.399,43,124,0.347,131,312,0.42,0.448,76,106,0.717,69,210,279,65,41,42,70,179,467
2012,Anthony Morrow,SG,26,NJN,62,18,1636,272,658,0.413,106,286,0.371,166,372,0.446,0.494,97,104,0.933,31,96,127,61,46,9,70,86,747
2012,Timofey Mozgov,C,25,DEN,44,35,687,100,190,0.526,0,0,NA,100,190,0.526,0.526,39,57,0.684,53,126,179,22,15,42,53,86,239
2012,Byron Mullens,C,22,CHA,65,25,1465,251,591,0.425,12,51,0.235,239,540,0.443,0.435,92,112,0.821,96,231,327,57,21,52,74,137,606
2012,Troy Murphy,PF,31,LAL,59,0,956,77,171,0.45,28,67,0.418,49,104,0.471,0.532,6,9,0.667,40,151,191,51,15,16,26,98,188
2012,Eduardo Nájera,PF,35,CHA,22,0,270,24,64,0.375,8,29,0.276,16,35,0.457,0.438,2,4,0.5,11,39,50,12,19,4,7,40,58
2012,Gary Neal,SG,27,SAS,56,7,1206,212,486,0.436,83,198,0.419,129,288,0.448,0.522,50,64,0.781,12,106,118,117,27,2,60,75,557
2012,Jameer Nelson,PG,29,ORL,57,57,1706,259,606,0.427,87,231,0.377,172,375,0.459,0.499,71,88,0.807,29,152,181,325,38,5,135,130,676
2012,Andrés Nocioni,SF,32,PHI,11,1,56,5,20,0.25,1,6,0.167,4,14,0.286,0.275,6,11,0.545,1,13,14,1,1,1,5,4,17
2012,Steve Novak,PF,28,NYK,54,0,1020,161,337,0.478,133,282,0.472,28,55,0.509,0.675,22,26,0.846,9,95,104,12,16,9,21,59,477
2012,Jermaine O'Neal,C,33,BOS,25,24,570,52,120,0.433,0,0,NA,52,120,0.433,0.433,21,31,0.677,37,98,135,10,8,43,21,80,125
2012,Travis Outlaw,SF,27,SAC,39,5,500,60,175,0.343,16,60,0.267,44,115,0.383,0.389,31,46,0.674,19,42,61,16,19,21,20,34,167
2012,Larry Owens,SF,29,NJN,7,0,75,4,11,0.364,2,5,0.4,2,6,0.333,0.455,3,4,0.75,2,11,13,4,0,1,2,10,13
2012,Jannero Pargo,PG,32,ATL,50,0,671,105,253,0.415,53,138,0.384,52,115,0.452,0.52,19,20,0.95,9,64,73,96,20,2,49,64,282
2012,Jeremy Pargo,PG,25,MEM,44,5,424,50,150,0.333,10,38,0.263,40,112,0.357,0.367,16,27,0.593,12,25,37,55,15,0,46,46,126
2012,Patrick Patterson,PF,22,HOU,64,1,1483,225,511,0.44,0,3,0,225,508,0.443,0.44,40,57,0.702,112,174,286,53,27,36,49,113,490
2012,Sasha Pavlović,SF,28,BOS,45,7,527,50,128,0.391,17,58,0.293,33,70,0.471,0.457,3,8,0.375,4,68,72,18,20,15,20,54,120
2012,Kendrick Perkins,C,27,OKC,65,65,1744,128,262,0.489,0,0,NA,128,262,0.489,0.489,73,112,0.652,120,306,426,78,25,73,118,189,329
2012,Johan Petro,C,26,NJN,59,10,920,109,260,0.419,1,1,1,108,259,0.417,0.421,31,37,0.838,68,156,224,45,21,23,38,122,250
2012,Mickaël Piétrus,SG,29,BOS,42,6,921,104,270,0.385,61,182,0.335,43,88,0.489,0.498,20,31,0.645,18,112,130,25,21,10,33,81,289
2012,Dexter Pittman,C,23,MIA,35,6,301,44,94,0.468,0,0,NA,44,94,0.468,0.468,18,28,0.643,27,44,71,9,8,8,17,73,106
2012,Quincy Pondexter,SF,23,MEM,64,8,1002,108,239,0.452,22,73,0.301,86,166,0.518,0.498,33,53,0.623,55,71,126,27,27,5,30,90,271
2012,A.J. Price,PG,25,IND,44,1,568,59,174,0.339,26,88,0.295,33,86,0.384,0.414,28,35,0.8,13,48,61,86,20,2,32,30,172
2012,Tayshaun Prince,SF,31,DET,63,63,2087,336,798,0.421,37,104,0.356,299,694,0.431,0.444,89,115,0.774,72,209,281,153,27,32,74,77,798
2012,Joel Przybilla,C,32,POR,27,19,449,22,48,0.458,0,0,NA,22,48,0.458,0.458,11,18,0.611,29,109,138,6,4,16,22,66,55
2012,Vladimir Radmanović,SF,31,ATL,49,3,755,74,197,0.376,50,135,0.37,24,62,0.387,0.503,22,29,0.759,34,109,143,54,21,15,35,62,220
2012,Anthony Randolph,PF,22,MIN,34,5,517,94,200,0.47,0,1,0,94,199,0.472,0.47,64,84,0.762,42,81,123,19,13,35,40,56,252
2012,Zach Randolph,PF,30,MEM,28,8,735,132,285,0.463,2,8,0.25,130,277,0.469,0.467,58,88,0.659,78,147,225,48,21,4,40,57,324
2012,J.J. Redick,SG,27,ORL,65,22,1765,248,584,0.425,112,268,0.418,136,316,0.43,0.521,143,157,0.911,18,132,150,164,27,6,68,92,751
2012,Jason Richardson,SG,31,ORL,54,54,1591,243,596,0.408,102,277,0.368,141,319,0.442,0.493,41,69,0.594,36,158,194,107,53,22,60,91,629
2012,Luke Ridnour,SG,30,MIN,53,53,1750,242,550,0.44,49,152,0.322,193,398,0.485,0.485,106,119,0.891,19,122,141,252,56,16,96,136,639
2012,Nate Robinson,PG,27,GSW,51,9,1192,205,484,0.424,66,181,0.365,139,303,0.459,0.492,94,113,0.832,15,85,100,231,59,2,75,118,570
2012,Rajon Rondo,PG,25,BOS,53,53,1957,256,572,0.448,10,42,0.238,246,530,0.464,0.456,108,181,0.597,62,195,257,620,95,3,193,99,630
2012,Derrick Rose,PG,23,CHI,39,39,1375,302,695,0.435,54,173,0.312,248,522,0.475,0.473,194,239,0.812,26,105,131,307,35,28,119,52,852
2012,John Salmons,SF,32,SAC,46,32,1250,141,345,0.409,33,112,0.295,108,233,0.464,0.457,29,45,0.644,20,114,134,93,37,7,45,77,344
2012,Thabo Sefolosha,SG,27,OKC,42,42,914,67,155,0.432,31,71,0.437,36,84,0.429,0.532,38,43,0.884,21,107,128,47,37,17,40,78,203
2012,Ramon Sessions,PG,25,CLE,41,4,1006,141,354,0.398,26,62,0.419,115,292,0.394,0.435,122,147,0.83,19,108,127,212,27,1,82,63,430
2012,Ramon Sessions,PG,25,LAL,23,19,701,101,211,0.479,17,35,0.486,84,176,0.477,0.519,72,101,0.713,14,73,87,142,17,2,59,37,291
2012,Iman Shumpert,PG,21,NYK,59,35,1705,214,534,0.401,48,157,0.306,166,377,0.44,0.446,87,109,0.798,42,144,186,164,101,8,111,173,563
2012,James Singleton,PF,30,WAS,12,0,262,41,75,0.547,2,9,0.222,39,66,0.591,0.56,14,15,0.933,25,56,81,15,9,8,10,27,98
2012,Brian Skinner,C,35,MEM,1,0,4,0,1,0,0,0,NA,0,1,0,0,0,0,NA,0,0,0,0,0,0,0,1,0
2012,Donald Sloan,PG,24,ATL,5,0,20,3,8,0.375,0,1,0,3,7,0.429,0.375,0,0,NA,1,4,5,5,1,0,2,3,6
2012,Donald Sloan,PG,24,NOH,3,0,41,5,14,0.357,0,2,0,5,12,0.417,0.357,2,4,0.5,2,1,3,8,2,0,5,2,12
2012,Donald Sloan,PG,24,CLE,25,11,608,71,176,0.403,2,22,0.091,69,154,0.448,0.409,21,26,0.808,15,44,59,92,10,3,42,32,165
2012,Ish Smith,PG,23,GSW,6,1,63,12,30,0.4,2,5,0.4,10,25,0.4,0.433,1,2,0.5,2,7,9,9,4,0,1,4,27
2012,Ish Smith,PG,23,ORL,20,0,171,19,51,0.373,1,4,0.25,18,47,0.383,0.382,6,8,0.75,5,21,26,32,11,2,12,11,45
2012,J.R. Smith,SG,26,NYK,35,1,967,165,405,0.407,67,193,0.347,98,212,0.462,0.49,39,55,0.709,29,107,136,84,54,6,46,87,436
2012,Jason Smith,PF,25,NOH,40,29,947,181,348,0.52,1,9,0.111,180,339,0.531,0.522,33,47,0.702,72,124,196,34,21,41,40,102,396
2012,Josh Smith,PF,26,ATL,66,66,2329,504,1101,0.458,28,109,0.257,476,992,0.48,0.47,203,322,0.63,136,496,632,257,93,115,164,172,1239
2012,Marreese Speights,PF,24,MEM,60,54,1345,221,488,0.453,0,3,0,221,485,0.456,0.453,84,109,0.771,133,241,374,48,21,29,74,147,526
2012,Jerry Stackhouse,SF,37,ATL,30,0,273,37,100,0.37,13,38,0.342,24,62,0.387,0.435,21,23,0.913,6,17,23,14,10,3,13,12,108
2012,Lance Stephenson,SG,21,IND,42,1,442,47,125,0.376,4,30,0.133,43,95,0.453,0.392,8,17,0.471,12,41,53,46,21,5,36,30,106
2012,DeShawn Stevenson,SF,30,NJN,51,30,960,49,172,0.285,41,145,0.283,8,27,0.296,0.404,9,16,0.563,7,94,101,41,19,4,19,59,148
2012,Amar'e Stoudemire,PF,29,NYK,47,47,1543,316,654,0.483,5,21,0.238,311,633,0.491,0.487,186,243,0.765,106,261,367,52,38,45,112,138,823
2012,Jeff Teague,PG,23,ATL,66,66,2183,320,672,0.476,51,149,0.342,269,523,0.514,0.514,140,185,0.757,21,138,159,321,106,37,134,145,831
2012,Sebastian Telfair,PG,26,PHO,60,1,895,141,342,0.412,33,105,0.314,108,237,0.456,0.461,53,67,0.791,20,71,91,138,41,12,68,120,368
2012,Hasheem Thabeet,C,24,HOU,5,0,23,3,3,1,0,0,NA,3,3,1,1,0,0,NA,1,6,7,0,0,2,0,5,6
2012,Hasheem Thabeet,C,24,POR,15,3,116,8,18,0.444,0,0,NA,8,18,0.444,0.444,13,20,0.65,15,20,35,0,1,8,8,15,29
2012,Isaiah Thomas,PG,22,SAC,65,37,1656,256,571,0.448,83,219,0.379,173,352,0.491,0.521,154,185,0.832,48,120,168,266,53,8,105,121,749
2012,Kurt Thomas,C,39,POR,53,3,803,73,157,0.465,0,0,NA,73,157,0.465,0.465,14,20,0.7,39,149,188,46,24,31,31,123,160
2012,Lance Thomas,PF,23,NOH,42,10,630,57,126,0.452,0,1,0,57,125,0.456,0.452,52,62,0.839,49,77,126,12,10,7,24,78,166
2012,Malcolm Thomas,PF,23,SAS,3,0,15,0,3,0,0,0,NA,0,3,0,0,1,2,0.5,1,2,3,1,1,1,0,0,1
2012,Tyrus Thomas,PF,25,CHA,54,30,1013,120,327,0.367,1,3,0.333,119,324,0.367,0.369,63,83,0.759,49,151,200,35,36,60,53,144,304
2012,Jason Thompson,PF,25,SAC,64,47,1657,237,443,0.535,0,2,0,237,441,0.537,0.535,109,181,0.602,166,277,443,79,43,44,68,149,583
2012,Marcus Thornton,SG,24,SAC,51,51,1780,352,803,0.438,107,310,0.345,245,493,0.497,0.505,141,163,0.865,84,104,188,98,71,12,84,111,952
2012,Anthony Tolliver,SF,26,MIN,51,0,882,71,182,0.39,25,101,0.248,46,81,0.568,0.459,41,55,0.745,50,103,153,22,18,19,35,86,208
2012,Ronny Turiaf,C,29,WAS,4,0,58,3,3,1,0,0,NA,3,3,1,1,0,0,NA,1,11,12,5,6,3,6,7,6
2012,Ronny Turiaf,C,29,MIA,13,5,221,16,30,0.533,0,1,0,16,29,0.552,0.533,13,22,0.591,19,39,58,5,8,14,8,32,45
2012,Hedo Türkoğlu,SF,32,ORL,53,53,1653,209,504,0.415,91,258,0.353,118,246,0.48,0.505,67,95,0.705,24,175,199,233,45,17,142,139,576
2012,Evan Turner,SF,23,PHI,65,20,1713,263,590,0.446,11,49,0.224,252,541,0.466,0.455,73,108,0.676,27,349,376,180,40,20,105,117,610
2012,Jeremy Tyler,C,20,GSW,42,23,568,88,209,0.421,0,1,0,88,208,0.423,0.421,29,52,0.558,54,86,140,16,16,20,36,84,205
2012,Ekpe Udoh,C,24,GSW,38,6,827,82,185,0.443,0,0,NA,82,185,0.443,0.443,46,64,0.719,58,89,147,31,25,65,35,115,210
2012,Ekpe Udoh,C,24,MIL,23,5,463,45,110,0.409,0,2,0,45,108,0.417,0.409,40,50,0.8,42,65,107,26,15,37,18,59,130
2012,Beno Udrih,SG,29,MIL,59,0,1080,146,332,0.44,17,59,0.288,129,273,0.473,0.465,39,55,0.709,26,76,102,227,37,1,77,69,348
2012,Ben Uzoh,PG,23,CLE,2,0,13,2,5,0.4,0,0,NA,2,5,0.4,0.4,0,0,NA,2,2,4,2,1,0,0,1,4
2012,Ben Uzoh,PG,23,TOR,16,8,357,33,94,0.351,0,1,0,33,93,0.355,0.351,11,19,0.579,17,46,63,59,16,3,19,30,77
2012,Anderson Varejão,C,29,CLE,25,25,785,114,222,0.514,0,4,0,114,218,0.523,0.514,43,64,0.672,109,178,287,43,35,17,45,62,271
2012,Greivis Vásquez,PG,25,NOH,66,26,1706,225,523,0.43,43,135,0.319,182,388,0.469,0.471,96,117,0.821,23,150,173,359,60,8,148,126,589
2012,Jan Veselý,PF,21,WAS,57,20,1078,117,218,0.537,0,1,0,117,217,0.539,0.537,33,62,0.532,101,148,249,47,39,32,60,156,267
2012,Nikola Vučević,C,21,PHI,51,15,812,131,291,0.45,3,8,0.375,128,283,0.452,0.455,18,34,0.529,88,158,246,31,20,34,33,111,283
2012,Dwyane Wade,SG,30,MIA,49,49,1625,416,837,0.497,15,56,0.268,401,781,0.513,0.506,235,297,0.791,73,164,237,225,82,63,129,110,1082
2012,Von Wafer,SG,26,ORL,33,1,469,71,157,0.452,14,39,0.359,57,118,0.483,0.497,38,54,0.704,6,39,45,29,10,3,35,26,194
2012,Henry Walker,SG,24,NYK,32,8,620,68,171,0.398,36,113,0.319,32,58,0.552,0.503,17,20,0.85,9,71,80,37,19,7,35,84,189
2012,Ben Wallace,C,37,DET,62,11,980,34,86,0.395,1,4,0.25,33,82,0.402,0.401,16,47,0.34,81,188,269,43,47,51,34,60,85
2012,Gerald Wallace,SF,29,POR,42,42,1503,203,430,0.472,26,98,0.265,177,332,0.533,0.502,125,161,0.776,63,214,277,115,62,25,84,107,557
2012,Gerald Wallace,SF,29,NJN,16,16,573,84,202,0.416,20,52,0.385,64,150,0.427,0.465,55,64,0.859,24,85,109,49,23,11,27,38,243
2012,Luke Walton,SF,31,LAL,9,0,65,6,14,0.429,0,4,0,6,10,0.6,0.429,0,0,NA,6,8,14,5,2,0,2,9,12
2012,Luke Walton,PF,31,CLE,21,0,299,18,51,0.353,7,16,0.438,11,35,0.314,0.422,0,0,NA,7,28,35,30,3,1,25,32,43
2012,Hakim Warrick,PF,29,PHO,35,0,503,74,180,0.411,1,10,0.1,73,170,0.429,0.414,76,99,0.768,31,61,92,30,8,3,36,35,225
2012,Earl Watson,PG,32,UTA,50,2,1033,54,160,0.338,10,52,0.192,44,108,0.407,0.369,31,46,0.674,30,91,121,217,54,22,85,105,149
2012,Delonte West,PG,28,DAL,44,33,1060,166,360,0.461,27,76,0.355,139,284,0.489,0.499,62,70,0.886,13,88,101,139,58,11,76,67,421
2012,D.J. White,PF,25,CHA,58,11,1098,174,353,0.493,1,1,1,173,352,0.491,0.494,43,61,0.705,50,159,209,47,17,23,43,94,392
2012,Chris Wilcox,C,29,BOS,28,4,481,64,107,0.598,0,0,NA,64,107,0.598,0.598,24,39,0.615,38,84,122,12,11,9,30,64,152
2012,Deron Williams,PG,27,NJN,55,55,1999,391,961,0.407,115,342,0.336,276,619,0.446,0.467,257,305,0.843,23,160,183,481,67,20,219,121,1154
2012,Derrick Williams,PF,20,MIN,66,15,1418,205,498,0.412,37,138,0.268,168,360,0.467,0.449,136,195,0.697,77,234,311,38,30,31,77,95,583
2012,Elliot Williams,SG,22,POR,24,0,149,37,74,0.5,8,27,0.296,29,47,0.617,0.554,6,18,0.333,7,12,19,6,6,3,5,18,88
2012,Lou Williams,PG,25,PHI,64,0,1682,318,782,0.407,83,229,0.362,235,553,0.425,0.46,237,292,0.812,30,125,155,221,53,18,71,90,956
2012,Marvin Williams,SF,25,ATL,57,37,1500,203,470,0.432,58,149,0.389,145,321,0.452,0.494,115,146,0.788,76,218,294,71,47,18,39,84,579
2012,Mo Williams,SG,29,LAC,52,1,1472,260,611,0.426,93,239,0.389,167,372,0.449,0.502,72,80,0.9,23,76,99,160,51,7,86,103,685
2012,Reggie Williams,SF,25,CHA,33,13,747,106,255,0.416,33,107,0.308,73,148,0.493,0.48,29,40,0.725,27,66,93,60,20,3,33,34,274
2012,Sean Williams,C,25,DAL,8,0,65,12,16,0.75,0,0,NA,12,16,0.75,0.75,5,6,0.833,9,4,13,2,1,5,7,14,29
2012,Sean Williams,C,25,BOS,3,0,42,2,6,0.333,0,0,NA,2,6,0.333,0.333,7,7,1,4,8,12,3,3,3,3,4,11
2012,Shawne Williams,SF,25,NJN,25,6,514,42,147,0.286,21,87,0.241,21,60,0.35,0.357,8,11,0.727,20,48,68,16,10,11,13,44,113
2012,Shelden Williams,C,28,NJN,58,35,1276,96,201,0.478,0,0,NA,96,201,0.478,0.478,76,104,0.731,141,209,350,35,47,39,66,149,268
2012,Terrence Williams,SG,24,HOU,12,0,181,20,57,0.351,8,19,0.421,12,38,0.316,0.421,6,12,0.5,2,26,28,10,4,1,10,16,54
2012,Terrence Williams,SG,24,SAC,18,0,369,65,141,0.461,8,27,0.296,57,114,0.5,0.489,21,34,0.618,11,63,74,55,16,6,33,19,159
2012,Metta World Peace,SF,32,LAL,64,45,1720,183,465,0.394,56,189,0.296,127,276,0.46,0.454,71,115,0.617,71,147,218,140,69,27,69,137,493
2012,Brandan Wright,C,24,DAL,49,0,791,144,233,0.618,0,1,0,144,232,0.621,0.618,52,82,0.634,62,112,174,13,22,63,21,61,340
2012,Nick Young,SG,26,WAS,40,32,1211,240,591,0.406,73,197,0.371,167,394,0.424,0.468,112,130,0.862,20,77,97,46,30,11,59,90,665
2012,Nick Young,SG,26,LAC,22,3,518,76,193,0.394,30,85,0.353,46,108,0.426,0.472,32,39,0.821,11,25,36,10,14,6,24,51,214
2012,Sam Young,SF,26,MEM,21,2,240,32,83,0.386,0,9,0,32,74,0.432,0.386,10,12,0.833,14,27,41,9,11,2,9,12,74
2012,Sam Young,SF,26,PHI,14,0,135,13,44,0.295,5,8,0.625,8,36,0.222,0.352,9,14,0.643,6,15,21,6,6,4,7,11,40
2012,Thaddeus Young,PF,23,PHI,63,1,1755,348,687,0.507,1,4,0.25,347,683,0.508,0.507,111,144,0.771,137,188,325,74,64,41,55,127,808
2013,Quincy Acy,PF,22,TOR,29,0,342,42,75,0.56,1,2,0.5,41,73,0.562,0.567,31,38,0.816,30,47,77,11,13,15,17,53,116
2013,Jeff Adrien,PF,26,CHA,52,5,713,72,168,0.429,0,2,0,72,166,0.434,0.429,65,100,0.65,68,128,196,36,18,27,32,80,209
2013,Arron Afflalo,SF,27,ORL,64,64,2307,397,905,0.439,72,240,0.3,325,665,0.489,0.478,191,223,0.857,29,210,239,206,40,11,138,137,1057
2013,Cole Aldrich,C,24,HOU,30,0,213,23,43,0.535,0,0,NA,23,43,0.535,0.535,4,9,0.444,12,45,57,6,3,9,14,41,50
2013,Cole Aldrich,C,24,SAC,15,0,175,21,37,0.568,0,0,NA,21,37,0.568,0.568,8,11,0.727,18,45,63,3,2,14,9,19,50
2013,LaMarcus Aldridge,PF,27,POR,74,74,2790,638,1318,0.484,2,14,0.143,636,1304,0.488,0.485,282,348,0.81,175,495,670,192,62,91,143,187,1560
2013,Lavoy Allen,C,23,PHI,79,37,1669,206,454,0.454,0,1,0,206,453,0.455,0.454,43,60,0.717,159,236,395,73,24,55,55,180,455
2013,Ray Allen,SG,37,MIA,79,0,2035,292,651,0.449,139,332,0.419,153,319,0.48,0.555,140,158,0.886,40,177,217,135,67,15,103,129,863
2013,Al-Farouq Aminu,SF,22,NOH,76,71,2066,225,474,0.475,4,19,0.211,221,455,0.486,0.479,101,137,0.737,139,446,585,103,92,51,116,153,555
2013,Lou Amundson,PF,30,MIN,20,0,161,14,38,0.368,0,0,NA,14,38,0.368,0.368,4,20,0.2,23,24,47,3,7,6,11,26,32
2013,Lou Amundson,PF,30,CHI,1,0,2,0,1,0,0,0,NA,0,1,0,0,0,0,NA,1,0,1,0,0,0,0,0,0
2013,Lou Amundson,PF,30,NOH,18,0,209,18,42,0.429,0,0,NA,18,42,0.429,0.429,8,16,0.5,24,34,58,8,9,6,8,27,44
2013,Chris Andersen,C,34,MIA,42,0,624,71,123,0.577,2,3,0.667,69,120,0.575,0.585,63,93,0.677,57,115,172,17,16,44,24,89,207
2013,James Anderson,SF,23,SAS,10,0,94,11,25,0.44,5,11,0.455,6,14,0.429,0.54,7,9,0.778,3,11,14,9,3,2,7,7,34
2013,James Anderson,SG,23,HOU,29,2,307,41,101,0.406,16,49,0.327,25,52,0.481,0.485,17,19,0.895,15,43,58,33,12,3,18,18,115
2013,Ryan Anderson,PF,24,NOH,81,22,2503,472,1115,0.423,213,557,0.382,259,558,0.464,0.519,152,180,0.844,191,328,519,97,42,31,97,179,1309
2013,Carmelo Anthony,PF,28,NYK,67,67,2482,669,1489,0.449,157,414,0.379,512,1075,0.476,0.502,425,512,0.83,134,326,460,171,52,32,175,205,1920
2013,Joel Anthony,C,30,MIA,62,3,566,35,68,0.515,0,0,NA,35,68,0.515,0.515,17,28,0.607,45,70,115,13,13,42,22,49,87
2013,Trevor Ariza,SF,27,WAS,56,15,1471,188,451,0.417,76,209,0.364,112,242,0.463,0.501,78,95,0.821,44,222,266,113,72,20,84,72,530
2013,Ömer Aşık,C,26,HOU,82,82,2464,332,614,0.541,0,1,0,332,613,0.542,0.541,168,299,0.562,275,681,956,75,46,87,173,223,832
2013,D.J. Augustin,PG,25,IND,76,5,1226,103,294,0.35,67,190,0.353,36,104,0.346,0.464,83,99,0.838,20,71,91,170,34,3,68,64,356
2013,Gustavo Ayón,C,27,ORL,43,3,571,67,125,0.536,0,0,NA,67,125,0.536,0.536,19,38,0.5,40,100,140,59,13,13,38,83,153
2013,Gustavo Ayón,C,27,MIL,12,0,163,25,42,0.595,0,0,NA,25,42,0.595,0.595,1,12,0.083,20,39,59,12,9,4,9,24,51
2013,Luke Babbitt,PF,23,POR,62,0,730,86,234,0.368,62,178,0.348,24,56,0.429,0.5,10,13,0.769,15,122,137,29,14,5,22,82,244
2013,Leandro Barbosa,PG,30,BOS,41,2,513,83,193,0.43,18,47,0.383,65,146,0.445,0.477,31,41,0.756,8,38,46,58,17,6,21,51,215
2013,Harrison Barnes,SF,20,GSW,81,81,2058,276,628,0.439,52,145,0.359,224,483,0.464,0.481,144,190,0.758,53,280,333,98,52,14,101,140,748
2013,Matt Barnes,SF,32,LAC,80,4,2058,312,675,0.462,111,325,0.342,201,350,0.574,0.544,87,117,0.744,111,255,366,123,82,63,90,233,822
2013,Earl Barron,C,31,WAS,11,1,122,13,37,0.351,0,0,NA,13,37,0.351,0.351,2,5,0.4,16,27,43,3,5,5,10,23,28
2013,Earl Barron,C,31,NYK,1,1,37,5,14,0.357,0,0,NA,5,14,0.357,0.357,1,2,0.5,6,12,18,2,0,1,1,1,11
2013,Will Barton,SG,22,POR,73,5,894,118,309,0.382,9,65,0.138,109,244,0.447,0.396,50,65,0.769,36,109,145,58,34,9,60,56,295
2013,Shane Battier,SF,34,MIA,72,20,1786,152,362,0.42,136,316,0.43,16,46,0.348,0.608,32,38,0.842,37,128,165,72,41,55,34,149,472
2013,Jerryd Bayless,PG,24,MEM,80,4,1765,260,621,0.419,71,201,0.353,189,420,0.45,0.476,102,122,0.836,22,154,176,264,59,17,120,168,693
2013,Kent Bazemore,SG,23,GSW,61,0,267,43,116,0.371,10,34,0.294,33,82,0.402,0.414,27,44,0.614,5,17,22,22,17,4,18,27,123
2013,Marco Belinelli,SG,26,CHI,73,27,1882,241,610,0.395,79,221,0.357,162,389,0.416,0.46,141,168,0.839,13,127,140,148,44,6,82,140,702
2013,Chauncey Billups,SG,36,LAC,22,22,418,53,132,0.402,33,90,0.367,20,42,0.476,0.527,45,48,0.938,2,30,32,49,12,1,26,25,184
2013,Steve Blake,PG,32,LAL,45,13,1175,114,270,0.422,72,171,0.421,42,99,0.424,0.556,27,35,0.771,21,111,132,173,34,6,62,83,327
2013,Eric Bledsoe,PG,23,LAC,76,12,1553,253,568,0.445,31,78,0.397,222,490,0.453,0.473,106,134,0.791,78,147,225,233,109,55,137,112,643
2013,Keith Bogans,SG,32,BRK,74,23,1408,108,284,0.38,84,245,0.343,24,39,0.615,0.528,11,17,0.647,16,104,120,76,28,4,49,108,311
2013,Andrew Bogut,C,28,GSW,32,32,786,83,184,0.451,1,1,1,82,183,0.448,0.454,19,38,0.5,68,177,245,67,20,55,35,85,186
2013,Trevor Booker,PF,25,WAS,48,14,887,108,220,0.491,0,5,0,108,215,0.502,0.491,40,72,0.556,98,141,239,40,32,16,31,95,256
2013,Avery Bradley,PG,22,BOS,50,50,1435,192,478,0.402,40,126,0.317,152,352,0.432,0.444,37,49,0.755,30,81,111,104,64,19,72,129,461
2013,Corey Brewer,SF,26,DEN,82,2,2003,375,883,0.425,91,307,0.296,284,576,0.493,0.476,149,216,0.69,55,180,235,124,118,23,102,154,990
2013,Ronnie Brewer,SF,27,NYK,46,34,711,64,175,0.366,22,71,0.31,42,104,0.404,0.429,16,39,0.41,29,71,100,40,34,6,14,27,166
2013,Ronnie Brewer,SF,27,OKC,14,0,142,6,23,0.261,1,5,0.2,5,18,0.278,0.283,0,0,NA,13,27,40,10,9,0,4,6,13
2013,Aaron Brooks,PG,28,SAC,46,20,959,139,303,0.459,48,127,0.378,91,176,0.517,0.538,40,52,0.769,12,66,78,108,29,7,63,89,366
2013,Aaron Brooks,PG,28,HOU,7,0,38,4,13,0.308,2,7,0.286,2,6,0.333,0.385,0,0,NA,1,1,2,6,1,3,4,5,10
2013,MarShon Brooks,SG,24,BRK,73,2,912,155,335,0.463,15,55,0.273,140,280,0.5,0.485,69,94,0.734,32,72,104,76,34,16,69,93,394
2013,Kwame Brown,C,30,PHI,22,11,269,17,37,0.459,0,0,NA,17,37,0.459,0.459,7,19,0.368,23,51,74,9,6,10,8,37,41
2013,Shannon Brown,SG,27,PHO,59,22,1402,240,571,0.42,39,141,0.277,201,430,0.467,0.454,98,125,0.784,44,105,149,108,59,15,74,92,617
2013,Chase Budinger,SF,24,MIN,23,1,508,79,191,0.414,26,81,0.321,53,110,0.482,0.482,32,42,0.762,15,56,71,25,14,7,23,29,216
2013,Alec Burks,SG,21,UTA,64,0,1137,163,388,0.42,33,92,0.359,130,296,0.439,0.463,92,129,0.713,37,108,145,92,35,13,74,114,451
2013,Caron Butler,SF,32,LAC,78,78,1879,305,720,0.424,128,330,0.388,177,390,0.454,0.513,75,90,0.833,41,182,223,78,51,11,72,139,813
2013,Jimmy Butler,SF,23,CHI,82,20,2134,239,512,0.467,40,105,0.381,199,407,0.489,0.506,187,233,0.803,136,192,328,115,78,31,62,97,705
2013,José Calderón,PG,31,TOR,45,30,1273,187,398,0.47,79,184,0.429,108,214,0.505,0.569,47,52,0.904,14,92,106,333,28,6,75,58,500
2013,José Calderón,PG,31,DET,28,28,887,125,237,0.527,51,98,0.52,74,139,0.532,0.635,25,28,0.893,6,64,70,185,30,2,51,41,326
2013,Marcus Camby,PF,38,NYK,24,4,250,17,53,0.321,0,0,NA,17,53,0.321,0.321,8,19,0.421,24,56,80,14,7,14,15,28,42
2013,DeMarre Carroll,SF,26,UTA,66,12,1111,149,324,0.46,20,70,0.286,129,254,0.508,0.491,75,98,0.765,87,101,188,61,58,24,34,119,393
2013,Matt Carroll,SG,32,CHA,1,0,6,0,0,NA,0,0,NA,0,0,NA,NA,0,0,NA,0,0,0,1,0,0,0,1,0
2013,Vince Carter,SF,36,DAL,81,3,2093,372,855,0.435,162,399,0.406,210,456,0.461,0.53,182,223,0.816,58,276,334,194,74,44,106,226,1088
2013,Omri Casspi,SF,24,CLE,43,1,503,63,160,0.394,25,76,0.329,38,84,0.452,0.472,22,41,0.537,20,94,114,28,25,12,22,45,173
2013,Mario Chalmers,PG,26,MIA,77,77,2068,227,529,0.429,123,301,0.409,104,228,0.456,0.545,89,112,0.795,19,152,171,273,118,12,119,196,666
2013,Tyson Chandler,C,30,NYK,66,66,2164,255,400,0.638,0,0,NA,255,400,0.638,0.638,179,258,0.694,269,434,703,62,42,75,87,188,689
2013,Wilson Chandler,PF,25,DEN,43,8,1079,210,455,0.462,52,126,0.413,158,329,0.48,0.519,88,111,0.793,45,173,218,58,45,12,60,119,560
2013,Earl Clark,PF,25,LAL,59,36,1363,170,386,0.44,35,104,0.337,135,282,0.479,0.486,53,76,0.697,82,243,325,65,36,44,62,102,428
2013,Norris Cole,PG,24,MIA,80,4,1590,179,425,0.421,35,98,0.357,144,327,0.44,0.462,52,80,0.65,18,112,130,164,57,7,104,155,445
2013,Jason Collins,C,34,BOS,32,7,330,8,23,0.348,0,0,NA,8,23,0.348,0.348,21,30,0.7,21,31,52,6,10,6,16,74,37
2013,Jason Collins,C,34,WAS,6,2,54,1,6,0.167,0,0,NA,1,6,0.167,0.167,2,2,1,1,7,8,2,2,4,2,11,4
2013,Will Conroy,PG,30,MIN,4,0,20,0,9,0,0,3,0,0,6,0,0,1,2,0.5,1,0,1,0,0,0,0,1,1
2013,Daequan Cook,SG,25,HOU,16,1,165,21,59,0.356,11,30,0.367,10,29,0.345,0.449,2,3,0.667,5,13,18,10,6,2,6,13,55
2013,Daequan Cook,SG,25,CHI,33,0,276,30,108,0.278,15,61,0.246,15,47,0.319,0.347,7,9,0.778,2,41,43,9,2,5,9,13,82
2013,DeMarcus Cousins,C,22,SAC,75,74,2289,482,1036,0.465,4,22,0.182,478,1014,0.471,0.467,312,423,0.738,222,524,746,199,108,55,225,269,1280
2013,Jamal Crawford,SG,32,LAC,76,0,2230,445,1016,0.438,149,396,0.376,296,620,0.477,0.511,216,248,0.871,22,106,128,193,79,13,146,71,1255
2013,Jordan Crawford,SG,24,WAS,43,12,1127,211,508,0.415,59,171,0.345,152,337,0.451,0.473,87,106,0.821,31,104,135,157,27,5,97,61,568
2013,Jordan Crawford,SG,24,BOS,27,2,582,90,217,0.415,24,75,0.32,66,142,0.465,0.47,42,53,0.792,13,61,74,68,12,2,44,45,246
2013,Jae Crowder,SF,22,DAL,78,16,1353,141,367,0.384,63,192,0.328,78,175,0.446,0.47,47,73,0.644,35,152,187,94,63,17,49,128,392
2013,Dante Cunningham,PF,25,MIN,80,9,2010,314,671,0.468,0,6,0,314,665,0.472,0.468,67,103,0.65,142,266,408,67,84,38,56,153,695
2013,Jared Cunningham,SG,21,DAL,8,0,26,6,14,0.429,2,3,0.667,4,11,0.364,0.5,2,2,1,1,2,3,1,1,0,2,3,16
2013,Ed Davis,C,23,TOR,45,24,1087,186,339,0.549,0,0,NA,186,339,0.549,0.549,66,102,0.647,95,205,300,55,25,38,45,111,438
2013,Ed Davis,PF,23,MEM,36,4,544,74,143,0.517,0,0,NA,74,143,0.517,0.517,37,65,0.569,57,103,160,8,13,47,18,80,185
2013,Glen Davis,PF,27,ORL,34,33,1064,214,478,0.448,0,2,0,214,476,0.45,0.448,84,117,0.718,55,191,246,70,32,21,64,88,512
2013,Austin Daye,SF,24,DET,24,0,348,43,97,0.443,21,40,0.525,22,57,0.386,0.552,15,18,0.833,10,53,63,21,5,8,13,43,122
2013,Austin Daye,SF,24,MEM,31,0,328,47,111,0.423,20,58,0.345,27,53,0.509,0.514,11,16,0.688,6,54,60,21,9,14,16,39,125
2013,Nando De Colo,SG,25,SAS,72,6,920,105,241,0.436,31,82,0.378,74,159,0.465,0.5,35,44,0.795,23,115,138,138,41,6,81,87,276
2013,Luol Deng,SF,27,CHI,75,75,2903,466,1093,0.426,75,233,0.322,391,860,0.455,0.461,230,282,0.816,162,314,476,222,81,32,144,105,1237
2013,Justin Dentmon,PG,27,DAL,2,0,4,0,2,0,0,0,NA,0,2,0,0,0,0,NA,0,0,0,0,0,0,0,0,0
2013,Boris Diaw,PF,30,SAS,75,20,1709,179,332,0.539,30,78,0.385,149,254,0.587,0.584,47,65,0.723,66,188,254,180,52,27,84,143,435
2013,DeSagana Diop,C,31,CHA,22,1,226,8,27,0.296,0,1,0,8,26,0.308,0.296,0,1,0,10,41,51,13,5,16,8,19,16
2013,Toney Douglas,PG,26,HOU,49,0,913,139,352,0.395,61,162,0.377,78,190,0.411,0.482,60,68,0.882,23,67,90,93,40,2,56,103,399
2013,Toney Douglas,PG,26,SAC,22,0,376,49,114,0.43,21,54,0.389,28,60,0.467,0.522,16,16,1,11,37,48,58,31,1,25,42,135
2013,Goran Dragić,PG,26,PHO,77,77,2581,401,906,0.443,88,276,0.319,313,630,0.497,0.491,244,326,0.748,60,178,238,569,124,26,212,214,1134
2013,Andre Drummond,C,19,DET,60,10,1243,208,342,0.608,1,2,0.5,207,340,0.609,0.61,59,159,0.371,169,288,457,30,59,95,57,144,476
2013,Jared Dudley,SF,27,PHO,79,50,2170,313,669,0.468,106,271,0.391,207,398,0.52,0.547,129,162,0.796,79,166,245,203,75,8,101,128,861
2013,Mike Dunleavy,SF,32,MIL,75,3,1943,276,624,0.442,128,299,0.428,148,325,0.455,0.545,105,128,0.82,31,260,291,145,39,35,90,135,785
2013,Wayne Ellington,SG,25,MEM,40,4,676,81,199,0.407,41,97,0.423,40,102,0.392,0.51,15,16,0.938,5,47,52,42,16,1,24,38,218
2013,Wayne Ellington,SG,25,CLE,38,17,985,145,330,0.439,53,143,0.371,92,187,0.492,0.52,53,59,0.898,20,94,114,62,29,2,33,43,396
2013,Monta Ellis,SG,27,MIL,82,82,3076,597,1436,0.416,94,328,0.287,503,1108,0.454,0.448,289,374,0.773,45,271,316,496,169,36,254,164,1577
2013,Reggie Evans,PF,32,BRK,80,56,1967,125,261,0.479,0,0,NA,125,261,0.479,0.479,113,222,0.509,260,628,888,43,74,13,111,199,363
2013,Tyreke Evans,SG,23,SAC,65,61,2016,366,765,0.478,45,133,0.338,321,632,0.508,0.508,210,271,0.775,56,231,287,229,90,27,128,133,987
2013,Kenneth Faried,PF,23,DEN,80,80,2248,380,689,0.552,0,0,NA,380,689,0.552,0.552,163,266,0.613,260,474,734,77,81,83,113,234,923
2013,Derrick Favors,PF,21,UTA,77,8,1787,274,568,0.482,0,5,0,274,563,0.487,0.482,179,260,0.688,184,362,546,75,67,130,129,247,727
2013,Raymond Felton,PG,28,NYK,68,68,2313,377,882,0.427,93,258,0.36,284,624,0.455,0.48,101,128,0.789,51,143,194,372,94,14,155,130,948
2013,Derek Fisher,PG,38,DAL,9,9,229,23,65,0.354,10,23,0.435,13,42,0.31,0.431,21,23,0.913,0,15,15,31,5,2,18,24,77
2013,Derek Fisher,SG,38,OKC,24,0,346,32,96,0.333,20,57,0.351,12,39,0.308,0.438,14,15,0.933,2,20,22,16,14,1,12,31,98
2013,Evan Fournier,SG,20,DEN,38,4,428,75,152,0.493,22,54,0.407,53,98,0.541,0.566,30,39,0.769,6,29,35,44,19,1,32,65,202
2013,Randy Foye,SG,29,UTA,82,72,2249,293,738,0.397,178,434,0.41,115,304,0.378,0.518,118,144,0.819,17,110,127,167,66,27,92,190,882
2013,Jimmer Fredette,SG,23,SAC,69,0,967,172,409,0.421,65,156,0.417,107,253,0.423,0.5,85,99,0.859,19,52,71,92,31,3,68,64,494
2013,Enes Freedom,C,20,UTA,70,2,1078,206,379,0.544,1,1,1,205,378,0.542,0.545,93,117,0.795,135,169,304,31,28,32,101,116,506
2013,Danilo Gallinari,SF,24,DEN,71,71,2309,364,871,0.418,135,362,0.373,229,509,0.45,0.495,286,348,0.822,65,302,367,176,64,36,111,130,1149
2013,Francisco García,SG,31,SAC,40,15,710,77,205,0.376,40,109,0.367,37,96,0.385,0.473,12,14,0.857,7,61,68,43,32,31,20,66,206
2013,Francisco García,SF,31,HOU,18,5,319,41,95,0.432,27,70,0.386,14,25,0.56,0.574,6,7,0.857,1,22,23,20,14,7,12,22,115
2013,Kevin Garnett,C,36,BOS,68,68,2022,422,850,0.496,2,16,0.125,420,834,0.504,0.498,158,201,0.786,75,455,530,159,78,62,110,154,1004
2013,Marc Gasol,C,28,MEM,80,80,2796,429,869,0.494,1,14,0.071,428,855,0.501,0.494,268,316,0.848,184,438,622,318,80,139,157,255,1127
2013,Pau Gasol,PF,32,LAL,49,42,1655,270,579,0.466,8,28,0.286,262,551,0.475,0.473,125,178,0.702,111,310,421,200,24,61,104,93,673
2013,Rudy Gay,SF,26,MEM,42,42,1541,281,688,0.408,40,129,0.31,241,559,0.431,0.438,121,156,0.776,56,193,249,108,56,31,104,87,723
2013,Rudy Gay,SF,26,TOR,33,32,1146,240,565,0.425,44,131,0.336,196,434,0.452,0.464,119,139,0.856,43,169,212,94,57,22,94,95,643
2013,Alonzo Gee,SF,25,CLE,82,82,2541,305,744,0.41,69,219,0.315,236,525,0.45,0.456,163,205,0.795,75,245,320,133,107,29,132,199,842
2013,Taj Gibson,PF,27,CHI,65,5,1459,214,441,0.485,0,4,0,214,437,0.49,0.485,89,131,0.679,125,220,345,61,27,90,76,166,517
2013,Drew Gooden,C,31,MIL,16,0,151,20,61,0.328,1,5,0.2,19,56,0.339,0.336,11,16,0.688,13,18,31,6,5,6,9,21,52
2013,Marcin Gortat,C,28,PHO,61,61,1876,295,566,0.521,0,3,0,295,563,0.524,0.521,90,138,0.652,128,388,516,75,40,98,99,127,680
2013,Danny Granger,SF,29,IND,5,0,74,10,35,0.286,2,10,0.2,8,25,0.32,0.314,5,8,0.625,3,6,9,3,2,1,4,6,27
2013,Aaron Gray,C,28,TOR,42,16,513,48,90,0.533,0,0,NA,48,90,0.533,0.533,23,44,0.523,48,85,133,33,7,5,36,85,119
2013,Gerald Green,SF,27,IND,60,7,1080,155,424,0.366,59,188,0.314,96,236,0.407,0.435,52,65,0.8,31,110,141,50,19,23,53,64,421
2013,Jeff Green,PF,26,BOS,81,17,2252,376,806,0.467,70,182,0.385,306,624,0.49,0.51,214,265,0.808,55,263,318,128,56,68,132,175,1036
2013,Blake Griffin,PF,23,LAC,80,80,2598,577,1072,0.538,5,28,0.179,572,1044,0.548,0.541,281,426,0.66,186,476,662,299,97,50,185,231,1440
2013,Hamed Haddadi,C,27,MEM,13,0,87,7,21,0.333,0,0,NA,7,21,0.333,0.333,1,2,0.5,10,14,24,4,1,6,4,15,15
2013,Hamed Haddadi,C,27,PHO,17,0,235,28,61,0.459,0,0,NA,28,61,0.459,0.459,13,25,0.52,33,54,87,8,5,21,27,45,69
2013,Jordan Hamilton,SF,22,DEN,40,1,397,84,201,0.418,27,73,0.37,57,128,0.445,0.485,13,26,0.5,32,63,95,23,15,8,19,24,208
2013,James Harden,SG,23,HOU,78,78,2985,585,1337,0.438,179,486,0.368,406,851,0.477,0.504,674,792,0.851,62,317,379,455,142,38,295,178,2023
2013,Maurice Harkless,SF,19,ORL,76,59,1974,260,564,0.461,32,117,0.274,228,447,0.51,0.489,73,128,0.57,122,213,335,50,88,62,69,144,625
2013,Al Harrington,C,32,ORL,10,0,119,20,57,0.351,8,30,0.267,12,27,0.444,0.421,3,4,0.75,6,21,27,10,4,1,7,18,51
2013,Devin Harris,SG,29,ATL,58,34,1421,194,443,0.438,77,230,0.335,117,213,0.549,0.525,112,154,0.727,6,110,116,197,64,13,88,103,577
2013,Terrel Harris,SG,25,MIA,7,0,29,2,8,0.25,0,1,0,2,7,0.286,0.25,6,8,0.75,4,5,9,2,0,0,4,3,10
2013,Terrel Harris,SG,25,NOH,13,0,108,2,19,0.105,0,7,0,2,12,0.167,0.105,1,2,0.5,0,17,17,7,2,3,13,14,5
2013,Tobias Harris,SF,20,MIL,28,14,325,53,115,0.461,7,21,0.333,46,94,0.489,0.491,23,26,0.885,17,40,57,13,8,7,18,31,136
2013,Tobias Harris,PF,20,ORL,27,20,974,180,397,0.453,27,87,0.31,153,310,0.494,0.487,80,111,0.721,56,174,230,56,24,37,48,89,467
2013,Spencer Hawes,C,24,PHI,82,40,2233,376,811,0.464,31,87,0.356,345,724,0.477,0.483,122,157,0.777,173,417,590,183,24,113,131,233,905
2013,Chuck Hayes,C,29,SAC,74,1,1209,84,190,0.442,0,1,0,84,189,0.444,0.442,30,48,0.625,113,186,299,112,31,18,44,114,198
2013,Brendan Haywood,C,33,CHA,61,17,1162,93,216,0.431,0,1,0,93,215,0.433,0.431,30,66,0.455,125,165,290,29,16,49,50,125,216
2013,Gerald Henderson,SG,25,CHA,68,58,2133,382,855,0.447,33,100,0.33,349,755,0.462,0.466,258,313,0.824,55,195,250,177,68,34,108,149,1055
2013,John Henson,PF,22,MIL,63,9,827,162,336,0.482,0,3,0,162,333,0.486,0.482,56,105,0.533,116,181,297,31,19,42,47,83,380
2013,Roy Hibbert,C,26,IND,79,79,2269,385,859,0.448,1,4,0.25,384,855,0.449,0.449,166,224,0.741,296,360,656,113,39,206,162,279,937
2013,J.J. Hickson,C,24,POR,80,80,2323,418,744,0.562,0,2,0,418,742,0.563,0.562,182,268,0.679,266,562,828,88,48,51,145,160,1018
2013,Nenê,PF,30,WAS,61,49,1659,285,594,0.48,0,1,0,285,593,0.481,0.48,196,269,0.729,101,306,407,177,55,37,139,171,766
2013,George Hill,PG,26,IND,76,76,2620,386,871,0.443,130,353,0.368,256,518,0.494,0.518,174,213,0.817,47,237,284,355,81,26,116,134,1076
2013,Jordan Hill,PF,25,LAL,29,1,458,77,155,0.497,0,2,0,77,153,0.503,0.497,40,61,0.656,82,84,166,13,8,19,26,55,194
2013,Kirk Hinrich,PG,32,CHI,60,60,1764,159,422,0.377,71,182,0.39,88,240,0.367,0.461,70,98,0.714,16,142,158,314,63,25,99,192,459
2013,Justin Holiday,SG,23,PHI,9,0,142,16,48,0.333,4,16,0.25,12,32,0.375,0.375,6,8,0.75,0,14,14,15,3,6,9,7,42
2013,Ryan Hollins,C,28,LAC,60,0,663,70,114,0.614,0,0,NA,70,114,0.614,0.614,66,88,0.75,50,89,139,11,6,34,44,133,206
2013,Josh Howard,SF,32,MIN,11,4,207,31,77,0.403,5,16,0.313,26,61,0.426,0.435,7,12,0.583,9,27,36,4,10,3,10,18,74
2013,Juwan Howard,PF,39,MIA,7,2,51,10,19,0.526,0,0,NA,10,19,0.526,0.526,1,1,1,0,8,8,6,0,0,4,9,21
2013,Kris Humphries,PF,27,BRK,65,21,1191,139,310,0.448,0,2,0,139,308,0.451,0.448,97,123,0.789,126,239,365,32,16,33,57,127,375
2013,Serge Ibaka,PF,23,OKC,80,80,2486,446,778,0.573,20,57,0.351,426,721,0.591,0.586,143,191,0.749,222,395,617,43,28,242,125,213,1055
2013,Ersan İlyasova,PF,25,MIL,73,54,2012,371,803,0.462,95,214,0.444,276,589,0.469,0.521,125,157,0.796,154,366,520,117,68,36,75,185,962
2013,Royal Ivey,SG,31,PHI,53,5,698,62,144,0.431,37,88,0.42,25,56,0.446,0.559,9,16,0.563,16,41,57,32,23,3,20,73,170
2013,Jarrett Jack,SG,29,GSW,79,4,2349,387,857,0.452,82,203,0.404,305,654,0.466,0.499,167,198,0.843,21,222,243,439,60,11,157,134,1023
2013,Reggie Jackson,PG,22,OKC,70,0,993,149,325,0.458,24,104,0.231,125,221,0.566,0.495,52,62,0.839,21,145,166,122,29,13,53,84,374
2013,Stephen Jackson,SF,34,SAS,55,6,1075,123,330,0.373,46,170,0.271,77,160,0.481,0.442,49,70,0.7,22,133,155,80,37,14,77,89,341
2013,Mike James,PG,37,DAL,45,23,862,101,271,0.373,48,125,0.384,53,146,0.363,0.461,23,29,0.793,9,63,72,139,26,3,55,95,273
2013,Antawn Jamison,PF,36,LAL,76,6,1636,267,575,0.464,84,233,0.361,183,342,0.535,0.537,94,136,0.691,109,253,362,50,30,22,53,124,712
2013,Richard Jefferson,SF,32,GSW,56,1,568,62,136,0.456,14,45,0.311,48,91,0.527,0.507,38,53,0.717,5,79,84,31,14,7,23,45,176
2013,Jared Jeffries,PF,31,POR,38,0,350,16,54,0.296,0,2,0,16,52,0.308,0.296,12,23,0.522,26,34,60,14,6,6,17,58,44
2013,Charles Jenkins,SG,23,GSW,47,0,291,35,83,0.422,1,2,0.5,34,81,0.42,0.428,10,18,0.556,5,16,21,28,9,1,19,18,81
2013,Charles Jenkins,PG,23,PHI,12,1,150,14,38,0.368,0,0,NA,14,38,0.368,0.368,2,4,0.5,3,8,11,16,6,1,2,4,30
2013,John Jenkins,SG,21,ATL,61,2,902,131,294,0.446,53,138,0.384,78,156,0.5,0.536,59,70,0.843,17,77,94,56,12,10,40,37,374
2013,Brandon Jennings,PG,23,MIL,80,80,2897,497,1247,0.399,173,461,0.375,324,786,0.412,0.468,230,281,0.819,59,187,246,521,125,10,203,155,1397
2013,Jonas Jerebko,PF,25,DET,49,2,892,142,316,0.449,25,83,0.301,117,233,0.502,0.489,68,88,0.773,68,117,185,43,38,8,42,90,377
2013,Chris Johnson,C,27,MIN,30,0,284,48,75,0.64,0,0,NA,48,75,0.64,0.64,21,34,0.618,20,40,60,8,7,28,13,49,117
2013,Chris Johnson,SF,22,MEM,8,0,102,11,25,0.44,6,18,0.333,5,7,0.714,0.56,1,2,0.5,5,6,11,2,4,0,3,5,29
2013,James Johnson,SF,25,SAC,54,11,878,117,283,0.413,2,21,0.095,115,262,0.439,0.417,40,67,0.597,49,96,145,58,41,50,68,99,276
2013,Joe Johnson,SG,31,BRK,72,72,2642,445,1052,0.423,148,395,0.375,297,657,0.452,0.493,132,161,0.82,53,165,218,253,49,14,123,99,1170
2013,Orlando Johnson,SG,23,IND,51,0,619,72,180,0.4,36,94,0.383,36,86,0.419,0.5,23,32,0.719,20,90,110,47,11,9,29,51,203
2013,Wesley Johnson,SF,25,PHO,50,21,953,161,396,0.407,50,155,0.323,111,241,0.461,0.47,27,35,0.771,21,102,123,34,22,18,48,56,399
2013,Dahntay Jones,SF,32,DAL,50,15,635,50,140,0.357,8,37,0.216,42,103,0.408,0.386,66,82,0.805,13,57,70,28,10,5,22,73,174
2013,Dahntay Jones,SF,32,ATL,28,4,381,32,82,0.39,3,12,0.25,29,70,0.414,0.409,21,31,0.677,11,20,31,20,12,1,16,46,88
2013,Solomon Jones,PF,28,NYK,2,1,26,0,1,0,0,0,NA,0,1,0,0,0,0,NA,1,2,3,0,0,1,3,3,0
2013,Terrence Jones,PF,21,HOU,19,0,276,43,94,0.457,5,19,0.263,38,75,0.507,0.484,13,17,0.765,28,37,65,15,12,19,13,21,104
2013,DeAndre Jordan,C,24,LAC,82,82,2010,314,488,0.643,0,0,NA,314,488,0.643,0.643,96,249,0.386,210,384,594,28,48,112,100,192,724
2013,Cory Joseph,PG,21,SAS,28,9,388,51,110,0.464,6,21,0.286,45,89,0.506,0.491,18,21,0.857,12,40,52,53,15,4,21,25,126
2013,Kris Joseph,SF,24,BOS,6,0,24,2,11,0.182,0,2,0,2,9,0.222,0.182,3,4,0.75,1,4,5,1,0,0,2,2,7
2013,Kris Joseph,SF,24,BRK,4,0,30,0,3,0,0,1,0,0,2,0,0,2,4,0.5,0,2,2,0,3,0,0,1,2
2013,Jason Kidd,SG,39,NYK,76,48,2043,152,409,0.372,114,325,0.351,38,84,0.452,0.511,40,48,0.833,50,273,323,249,125,25,76,125,458
2013,Michael Kidd-Gilchrist,SF,19,CHA,78,77,2025,281,613,0.458,2,9,0.222,279,604,0.462,0.46,140,187,0.749,131,324,455,117,54,70,101,164,704
2013,Brandon Knight,PG,21,DET,75,75,2365,357,878,0.407,120,327,0.367,237,551,0.43,0.475,165,225,0.733,54,193,247,303,58,8,205,157,999
2013,Kyle Korver,SF,31,ATL,74,60,2259,277,601,0.461,189,414,0.457,88,187,0.471,0.618,67,78,0.859,23,270,293,146,70,37,70,170,810
2013,Kosta Koufos,C,23,DEN,81,81,1817,295,508,0.581,0,1,0,295,507,0.582,0.581,58,104,0.558,211,351,562,32,44,103,53,246,648
2013,Doron Lamb,SG,21,MIL,23,0,280,33,95,0.347,4,16,0.25,29,79,0.367,0.368,8,15,0.533,3,14,17,20,7,0,16,27,78
2013,Doron Lamb,SG,21,ORL,24,0,297,27,68,0.397,10,21,0.476,17,47,0.362,0.471,12,19,0.632,5,24,29,12,6,0,10,25,76
2013,Carl Landry,PF,29,GSW,81,2,1876,325,602,0.54,1,3,0.333,324,599,0.541,0.541,223,273,0.817,180,303,483,65,35,31,115,190,874
2013,Ty Lawson,PG,25,DEN,73,71,2513,448,971,0.461,85,232,0.366,363,739,0.491,0.505,235,311,0.756,36,162,198,501,107,8,182,135,1216
2013,Courtney Lee,SG,27,BOS,78,39,1941,246,530,0.464,58,156,0.372,188,374,0.503,0.519,62,72,0.861,31,159,190,143,89,21,84,139,612
2013,David Lee,PF,29,GSW,79,79,2907,602,1160,0.519,0,4,0,602,1156,0.521,0.519,255,320,0.797,218,668,886,279,67,22,207,246,1459
2013,Jon Leuer,C,23,CLE,9,0,91,10,28,0.357,0,3,0,10,25,0.4,0.357,2,6,0.333,5,8,13,5,2,0,5,11,22
2013,Jon Leuer,PF,23,MEM,19,0,96,15,24,0.625,0,0,NA,15,24,0.625,0.625,4,7,0.571,8,16,24,3,4,0,3,10,34
2013,Rashard Lewis,PF,33,MIA,55,9,792,103,249,0.414,51,131,0.389,52,118,0.441,0.516,28,45,0.622,19,102,121,30,21,14,33,67,285
2013,DeAndre Liggins,SG,24,OKC,39,1,290,21,47,0.447,7,19,0.368,14,28,0.5,0.521,9,18,0.5,13,40,53,15,18,3,14,33,58
2013,Jeremy Lin,PG,24,HOU,82,82,2640,396,897,0.441,87,257,0.339,309,640,0.483,0.49,216,275,0.785,32,215,247,497,134,29,236,205,1095
2013,Shaun Livingston,PG,27,WAS,17,4,320,24,66,0.364,0,3,0,24,63,0.381,0.364,15,15,1,2,35,37,38,11,2,17,22,63
2013,Shaun Livingston,PG,27,CLE,49,12,1135,142,280,0.507,0,1,0,142,279,0.509,0.507,70,83,0.843,29,92,121,177,37,29,59,105,354
2013,Kyle Lowry,PG,26,TOR,68,52,2020,250,623,0.401,101,279,0.362,149,344,0.433,0.482,190,239,0.795,56,265,321,435,94,24,157,218,791
2013,Shelvin Mack,PG,22,WAS,7,2,141,16,40,0.4,4,13,0.308,12,27,0.444,0.45,1,2,0.5,3,13,16,23,6,0,8,10,37
2013,Shelvin Mack,SG,22,PHI,4,0,7,1,2,0.5,0,1,0,1,1,1,0.5,0,0,NA,0,0,0,1,0,0,2,1,2
2013,Shelvin Mack,PG,22,ATL,20,1,268,41,84,0.488,14,35,0.4,27,49,0.551,0.571,8,14,0.571,0,24,24,44,9,0,24,28,104
2013,Shawn Marion,PF,34,DAL,67,67,2010,355,690,0.514,23,73,0.315,332,617,0.538,0.531,79,101,0.782,146,379,525,163,75,47,103,111,812
2013,Cartier Martin,SF,28,WAS,41,3,694,96,252,0.381,58,146,0.397,38,106,0.358,0.496,20,28,0.714,11,89,100,20,19,6,32,58,270
2013,Kevin Martin,SG,29,OKC,77,0,2136,350,778,0.45,158,371,0.426,192,407,0.472,0.551,219,246,0.89,31,147,178,106,72,8,101,138,1077
2013,Roger Mason,SG,32,NOH,69,13,1219,132,305,0.433,66,159,0.415,66,146,0.452,0.541,39,43,0.907,11,121,132,74,26,11,51,104,369
2013,Wesley Matthews,SG,26,POR,69,69,2403,352,808,0.436,169,425,0.398,183,383,0.478,0.54,149,187,0.797,35,156,191,174,90,18,109,172,1022
2013,Eric Maynor,PG,25,OKC,37,0,391,36,115,0.313,15,46,0.326,21,69,0.304,0.378,17,21,0.81,5,13,18,73,10,0,31,19,104
2013,Eric Maynor,SG,25,POR,27,0,572,70,166,0.422,19,50,0.38,51,116,0.44,0.479,28,41,0.683,4,24,28,109,12,1,48,36,187
2013,Luc Mbah a Moute,SF,26,MIL,58,45,1326,151,377,0.401,13,37,0.351,138,340,0.406,0.418,72,126,0.571,89,167,256,55,42,14,70,82,387
2013,JaVale McGee,C,25,DEN,79,0,1433,303,527,0.575,1,1,1,302,526,0.574,0.576,110,186,0.591,158,223,381,24,30,157,90,184,717
2013,Dominic McGuire,SF,27,TOR,15,9,230,15,32,0.469,0,0,NA,15,32,0.469,0.469,2,6,0.333,11,37,48,10,5,8,7,26,32
2013,Dominic McGuire,SF,27,NOH,9,0,145,9,21,0.429,0,0,NA,9,21,0.429,0.429,1,2,0.5,7,21,28,9,8,3,5,13,19
2013,Dominic McGuire,SF,27,IND,2,1,12,0,3,0,0,0,NA,0,3,0,0,0,2,0,1,1,2,1,0,0,0,0,0
2013,Josh McRoberts,PF,25,ORL,41,3,685,60,153,0.392,17,55,0.309,43,98,0.439,0.448,22,30,0.733,41,96,137,70,10,12,28,65,159
2013,Josh McRoberts,PF,25,CHA,26,19,802,96,190,0.505,7,29,0.241,89,161,0.553,0.524,43,55,0.782,52,136,188,71,22,15,38,66,242
2013,Jodie Meeks,SG,25,LAL,78,10,1663,205,530,0.387,122,342,0.357,83,188,0.441,0.502,86,96,0.896,37,134,171,69,58,5,52,103,618
2013,C.J. Miles,SF,25,CLE,65,13,1364,255,614,0.415,126,328,0.384,129,286,0.451,0.518,93,107,0.869,24,150,174,63,49,17,69,138,729
2013,Darko Miličić,C,27,BOS,1,0,5,0,1,0,0,0,NA,0,1,0,0,0,0,NA,0,1,1,0,0,0,2,1,0
2013,Andre Miller,PG,36,DEN,82,11,2151,303,632,0.479,17,64,0.266,286,568,0.504,0.493,163,194,0.84,60,178,238,484,73,11,172,159,786
2013,Mike Miller,SF,32,MIA,59,17,900,100,231,0.433,73,175,0.417,27,56,0.482,0.591,8,11,0.727,18,139,157,99,21,4,35,63,281
2013,Quincy Miller,PF,20,DEN,7,0,26,4,12,0.333,0,1,0,4,11,0.364,0.333,1,2,0.5,1,1,2,3,1,0,1,3,9
2013,Nazr Mohammed,C,35,CHI,63,12,693,66,180,0.367,0,2,0,66,178,0.371,0.367,34,47,0.723,73,122,195,26,21,32,24,97,166
2013,Greg Monroe,C,22,DET,81,81,2687,514,1058,0.486,0,4,0,514,1054,0.488,0.486,270,392,0.689,236,541,777,281,105,55,234,190,1298
2013,Darius Morris,PG,22,LAL,48,17,683,73,188,0.388,24,66,0.364,49,122,0.402,0.452,24,37,0.649,24,33,57,76,21,2,45,58,194
2013,Marcus Morris,PF,23,HOU,54,17,1154,171,400,0.428,74,194,0.381,97,206,0.471,0.52,49,75,0.653,63,156,219,47,27,16,53,120,465
2013,Marcus Morris,SF,23,PHO,23,6,370,51,126,0.405,12,39,0.308,39,87,0.448,0.452,17,42,0.405,17,41,58,15,18,4,24,40,131
2013,Markieff Morris,PF,23,PHO,82,32,1837,266,653,0.407,45,134,0.336,221,519,0.426,0.442,93,127,0.732,131,265,396,108,77,64,104,209,670
2013,Anthony Morrow,SG,27,ATL,24,1,301,47,111,0.423,15,38,0.395,32,73,0.438,0.491,16,18,0.889,10,16,26,9,12,1,4,33,125
2013,Anthony Morrow,SG,27,DAL,17,0,82,17,34,0.5,1,5,0.2,16,29,0.552,0.515,4,4,1,1,3,4,4,1,0,4,10,39
2013,Timofey Mozgov,C,26,DEN,41,1,366,44,87,0.506,0,2,0,44,85,0.518,0.506,20,26,0.769,50,57,107,9,6,18,25,57,108
2013,Byron Mullens,PF,23,CHA,53,41,1428,217,563,0.385,66,208,0.317,151,355,0.425,0.444,64,99,0.646,71,266,337,81,34,32,74,110,564
2013,Troy Murphy,PF,32,DAL,14,1,256,22,61,0.361,11,35,0.314,11,26,0.423,0.451,10,11,0.909,7,42,49,7,10,6,7,29,65
2013,Gary Neal,SG,28,SAS,68,17,1484,246,597,0.412,89,251,0.355,157,346,0.454,0.487,64,74,0.865,13,130,143,129,30,2,69,93,645
2013,Jameer Nelson,PG,30,ORL,56,56,1977,306,780,0.392,121,355,0.341,185,425,0.435,0.47,89,102,0.873,23,186,209,413,71,6,154,161,822
2013,Andrew Nicholson,PF,23,ORL,75,28,1249,256,486,0.527,0,0,NA,256,486,0.527,0.527,75,94,0.798,69,189,258,44,24,32,79,133,587
2013,Steve Novak,SF,29,NYK,81,1,1641,178,430,0.414,149,351,0.425,29,79,0.367,0.587,30,33,0.909,17,135,152,35,28,8,12,97,535
2013,Jermaine O'Neal,C,34,PHO,55,4,1029,179,371,0.482,0,0,NA,179,371,0.482,0.482,96,115,0.835,82,211,293,42,19,78,73,126,454
2013,Travis Outlaw,SF,28,SAC,38,2,444,74,177,0.418,14,50,0.28,60,127,0.472,0.458,38,52,0.731,17,44,61,21,11,8,19,35,200
2013,Jannero Pargo,PG,33,WAS,7,0,102,8,32,0.25,3,20,0.15,5,12,0.417,0.297,2,2,1,0,6,6,14,0,1,8,8,21
2013,Jannero Pargo,PG,33,ATL,7,0,113,13,38,0.342,7,20,0.35,6,18,0.333,0.434,2,2,1,1,6,7,19,3,0,5,8,35
2013,Jannero Pargo,PG,33,CHA,18,0,292,57,142,0.401,29,76,0.382,28,66,0.424,0.504,8,9,0.889,9,13,22,34,15,2,28,26,151
2013,Jeremy Pargo,PG,26,CLE,25,11,447,75,187,0.401,18,57,0.316,57,130,0.438,0.449,28,41,0.683,7,25,32,64,12,2,37,32,196
2013,Jeremy Pargo,SG,26,PHI,14,0,208,24,63,0.381,7,17,0.412,17,46,0.37,0.437,14,21,0.667,1,16,17,28,1,0,13,14,69
2013,Patrick Patterson,PF,23,HOU,47,38,1219,236,455,0.519,35,96,0.365,201,359,0.56,0.557,37,49,0.755,73,148,221,51,18,27,42,90,544
2013,Patrick Patterson,PF,23,SAC,24,3,556,83,168,0.494,16,36,0.444,67,132,0.508,0.542,11,14,0.786,40,76,116,30,13,13,19,48,193
2013,Sasha Pavlović,SG,29,POR,39,1,528,42,119,0.353,18,60,0.3,24,59,0.407,0.429,1,6,0.167,7,49,56,32,24,5,14,59,103
2013,Kendrick Perkins,C,28,OKC,78,78,1954,143,313,0.457,0,1,0,143,312,0.458,0.457,44,72,0.611,110,356,466,111,43,83,109,227,330
2013,Johan Petro,C,27,ATL,31,8,352,48,110,0.436,1,4,0.25,47,106,0.443,0.441,11,12,0.917,33,79,112,16,10,9,24,48,108
2013,Mickaël Piétrus,SF,30,TOR,19,16,386,34,98,0.347,20,64,0.313,14,34,0.412,0.449,12,18,0.667,5,31,36,9,12,6,16,33,100
2013,Dexter Pittman,C,24,MIA,4,0,12,3,5,0.6,0,0,NA,3,5,0.6,0.6,0,0,NA,4,3,7,0,0,0,2,4,6
2013,Dexter Pittman,C,24,MEM,7,0,20,1,6,0.167,0,0,NA,1,6,0.167,0.167,0,3,0,3,2,5,0,0,0,1,4,2
2013,Miles Plumlee,C,24,IND,14,0,55,5,21,0.238,0,0,NA,5,21,0.238,0.238,3,4,0.75,12,10,22,2,0,3,3,5,13
2013,Quincy Pondexter,SF,24,MEM,59,1,1243,128,299,0.428,60,152,0.395,68,147,0.463,0.528,59,75,0.787,43,89,132,61,35,6,42,95,375
2013,A.J. Price,PG,26,WAS,57,22,1278,161,413,0.39,70,200,0.35,91,213,0.427,0.475,49,62,0.79,20,94,114,205,33,3,64,73,441
2013,Pablo Prigioni,PG,35,NYK,78,18,1263,100,220,0.455,53,134,0.396,47,86,0.547,0.575,22,25,0.88,41,102,143,236,69,2,86,127,275
2013,Tayshaun Prince,SF,32,DET,45,45,1457,215,484,0.444,23,53,0.434,192,431,0.445,0.468,74,93,0.796,43,166,209,111,21,13,54,45,527
2013,Tayshaun Prince,SF,32,MEM,37,36,1174,144,336,0.429,15,41,0.366,129,295,0.437,0.451,22,37,0.595,29,126,155,85,27,12,35,41,325
2013,Joel Przybilla,C,33,MIL,12,1,68,1,4,0.25,0,0,NA,1,4,0.25,0.25,0,2,0,5,16,21,4,1,2,4,10,2
2013,Vladimir Radmanović,PF,32,CHI,25,0,144,13,43,0.302,5,27,0.185,8,16,0.5,0.36,2,3,0.667,10,18,28,8,8,4,7,29,33
2013,Anthony Randolph,PF,23,DEN,39,0,329,56,114,0.491,0,8,0,56,106,0.528,0.491,31,45,0.689,29,66,95,12,19,21,37,41,143
2013,Shavlik Randolph,PF,29,BOS,16,0,198,28,48,0.583,0,0,NA,28,48,0.583,0.583,11,27,0.407,28,42,70,4,8,7,10,38,67
2013,Zach Randolph,PF,31,MEM,76,75,2607,471,1024,0.46,2,23,0.087,469,1001,0.469,0.461,225,300,0.75,310,544,854,108,61,31,150,180,1169
2013,J.J. Redick,SG,28,ORL,50,11,1575,262,582,0.45,117,300,0.39,145,282,0.514,0.551,115,129,0.891,9,110,119,220,29,5,105,70,756
2013,J.J. Redick,SG,28,MIL,28,2,804,120,298,0.403,48,151,0.318,72,147,0.49,0.483,56,61,0.918,8,44,52,76,9,4,33,47,344
2013,Jason Richardson,SG,32,PHI,33,33,936,135,336,0.402,57,167,0.341,78,169,0.462,0.487,20,33,0.606,19,108,127,51,40,15,26,57,347
2013,Luke Ridnour,SG,31,MIN,82,82,2474,367,811,0.453,66,212,0.311,301,599,0.503,0.493,139,164,0.848,41,165,206,311,82,15,130,187,939
2013,Austin Rivers,SG,20,NOH,61,26,1418,145,390,0.372,28,86,0.326,117,304,0.385,0.408,59,108,0.546,16,93,109,127,26,9,74,122,377
2013,Brian Roberts,PG,27,NOH,78,5,1324,213,511,0.417,59,153,0.386,154,358,0.43,0.475,70,77,0.909,17,80,97,219,37,3,71,108,555
2013,Nate Robinson,PG,28,CHI,82,23,2086,399,921,0.433,141,348,0.405,258,573,0.45,0.51,135,169,0.799,29,155,184,358,85,10,144,207,1074
2013,Thomas Robinson,PF,21,SAC,51,0,809,103,243,0.424,0,0,NA,103,243,0.424,0.424,41,71,0.577,92,146,238,36,25,21,65,95,247
2013,Thomas Robinson,PF,21,HOU,19,0,247,35,78,0.449,0,1,0,35,77,0.455,0.449,16,38,0.421,30,47,77,10,16,5,23,29,86
2013,Rajon Rondo,PG,26,BOS,38,38,1423,225,465,0.484,12,50,0.24,213,415,0.513,0.497,60,93,0.645,43,169,212,420,70,9,148,96,522
2013,Terrence Ross,SG,21,TOR,73,2,1239,186,457,0.407,65,196,0.332,121,261,0.464,0.478,30,42,0.714,35,109,144,53,43,14,48,122,467
2013,John Salmons,SF,33,SAC,76,72,2278,244,612,0.399,99,267,0.371,145,345,0.42,0.48,85,110,0.773,33,174,207,226,51,25,85,143,672
2013,Mike Scott,PF,24,ATL,40,1,376,70,147,0.476,0,1,0,70,146,0.479,0.476,43,56,0.768,39,71,110,12,4,2,21,32,183
2013,Thabo Sefolosha,SG,28,OKC,81,81,2229,224,466,0.481,108,258,0.419,116,208,0.558,0.597,57,69,0.826,58,259,317,125,103,44,64,177,613
2013,Ramon Sessions,SG,26,CHA,61,0,1652,276,676,0.408,33,107,0.308,243,569,0.427,0.433,291,347,0.839,27,142,169,230,48,7,104,91,876
2013,Tornike Shengelia,SF,21,BRK,19,0,93,10,23,0.435,1,2,0.5,9,21,0.429,0.457,9,16,0.563,9,14,23,3,3,1,11,11,30
2013,Iman Shumpert,SG,22,NYK,45,45,996,109,275,0.396,51,127,0.402,58,148,0.392,0.489,36,47,0.766,31,105,136,75,43,7,37,99,305
2013,Alexey Shved,SG,24,MIN,77,16,1840,236,635,0.372,85,288,0.295,151,347,0.435,0.439,108,150,0.72,41,134,175,286,54,27,147,117,665
2013,Henry Sims,C,22,NOH,2,0,5,2,3,0.667,0,0,NA,2,3,0.667,0.667,0,0,NA,2,0,2,0,0,0,1,1,4
2013,Kyle Singler,SF,24,DET,82,74,2293,275,642,0.428,70,200,0.35,205,442,0.464,0.483,100,124,0.806,109,221,330,77,57,37,98,217,720
2013,Donald Sloan,SG,25,CLE,20,0,257,27,78,0.346,7,19,0.368,20,59,0.339,0.391,20,25,0.8,3,25,28,37,5,0,13,17,81
2013,Donald Sloan,PG,25,NOH,3,0,6,0,0,NA,0,0,NA,0,0,NA,NA,0,0,NA,0,0,0,1,0,0,1,0,0
2013,Ish Smith,PG,24,ORL,36,3,378,39,116,0.336,4,17,0.235,35,99,0.354,0.353,3,7,0.429,11,35,46,57,13,6,27,14,85
2013,Ish Smith,PG,24,MIL,16,0,138,17,43,0.395,4,10,0.4,13,33,0.394,0.442,0,0,NA,1,14,15,30,8,3,10,12,38
2013,J.R. Smith,SG,27,NYK,80,0,2678,527,1249,0.422,155,436,0.356,372,813,0.458,0.484,237,311,0.762,64,361,425,218,100,24,134,226,1446
2013,Jason Smith,C,26,NOH,51,0,876,167,341,0.49,0,4,0,167,337,0.496,0.49,86,102,0.843,64,122,186,34,15,45,55,123,420
2013,Josh Smith,PF,27,ATL,76,76,2683,550,1182,0.465,61,201,0.303,489,981,0.498,0.491,166,321,0.517,133,506,639,321,94,136,226,175,1327
2013,Marreese Speights,C,25,MEM,40,2,579,106,247,0.429,2,5,0.4,104,242,0.43,0.433,48,67,0.716,76,113,189,18,10,27,35,86,262
2013,Marreese Speights,C,25,CLE,39,1,721,154,337,0.457,1,5,0.2,153,332,0.461,0.458,87,108,0.806,70,127,197,29,14,26,45,89,396
2013,Jerry Stackhouse,SF,38,BRK,37,0,544,66,172,0.384,30,89,0.337,36,83,0.434,0.471,20,23,0.87,5,28,33,35,7,4,24,31,182
2013,Lance Stephenson,SG,22,IND,78,72,2278,275,598,0.46,62,188,0.33,213,410,0.52,0.512,75,115,0.652,47,257,304,223,81,16,109,162,687
2013,DeShawn Stevenson,SG,31,ATL,56,31,1158,98,262,0.374,76,209,0.364,22,53,0.415,0.519,12,23,0.522,18,104,122,52,29,6,23,69,284
2013,Amar'e Stoudemire,PF,30,NYK,29,0,682,154,267,0.577,0,0,NA,154,267,0.577,0.577,105,130,0.808,60,85,145,13,10,21,50,89,413
2013,Jeff Teague,PG,24,ATL,80,78,2628,439,974,0.451,89,248,0.359,350,726,0.482,0.496,199,226,0.881,25,155,180,579,117,28,230,181,1166
2013,Marquis Teague,PG,19,CHI,48,0,392,43,113,0.381,4,23,0.174,39,90,0.433,0.398,9,16,0.563,3,41,44,63,9,7,35,47,99
2013,Sebastian Telfair,PG,27,PHO,46,2,795,94,247,0.381,43,113,0.381,51,134,0.381,0.468,44,57,0.772,12,56,68,114,28,10,53,84,275
2013,Sebastian Telfair,PG,27,TOR,13,0,185,18,62,0.29,10,37,0.27,8,25,0.32,0.371,10,12,0.833,1,15,16,39,9,1,11,20,56
2013,Garrett Temple,SG,26,WAS,51,36,1156,105,258,0.407,26,80,0.325,79,178,0.444,0.457,26,37,0.703,29,94,123,115,50,17,61,94,262
2013,Hasheem Thabeet,C,25,OKC,66,4,770,64,106,0.604,0,0,NA,64,106,0.604,0.604,32,53,0.604,69,126,195,11,30,60,41,148,160
2013,Isaiah Thomas,PG,23,SAC,79,62,2122,366,832,0.44,115,321,0.358,251,511,0.491,0.509,253,287,0.882,29,132,161,316,67,3,140,167,1100
2013,Kurt Thomas,PF,40,NYK,39,17,392,45,83,0.542,1,1,1,44,82,0.537,0.548,6,13,0.462,24,65,89,21,10,16,8,52,97
2013,Lance Thomas,SF,24,NOH,59,9,646,53,106,0.5,0,0,NA,53,106,0.5,0.5,43,59,0.729,44,71,115,17,11,7,14,78,149
2013,Malcolm Thomas,PF,24,GSW,5,0,21,0,1,0,0,0,NA,0,1,0,0,3,4,0.75,0,5,5,2,0,1,1,1,3
2013,Malcolm Thomas,PF,24,CHI,7,0,36,5,9,0.556,0,0,NA,5,9,0.556,0.556,2,4,0.5,5,6,11,2,2,1,2,7,12
2013,Tyrus Thomas,PF,26,CHA,26,2,360,48,136,0.353,3,8,0.375,45,128,0.352,0.364,26,31,0.839,16,44,60,19,14,15,17,51,125
2013,Jason Thompson,PF,26,SAC,82,81,2285,374,745,0.502,0,3,0,374,742,0.504,0.502,143,206,0.694,172,377,549,84,48,61,101,227,891
2013,Marcus Thornton,SG,25,SAC,72,8,1726,332,774,0.429,141,379,0.372,191,395,0.484,0.52,111,126,0.881,50,131,181,91,61,4,68,105,916
2013,Anthony Tolliver,SF,27,ATL,62,11,963,82,216,0.38,45,133,0.338,37,83,0.446,0.484,44,51,0.863,31,124,155,32,15,12,36,66,253
2013,P.J. Tucker,SG,27,PHO,79,45,1910,210,444,0.473,22,70,0.314,188,374,0.503,0.498,64,86,0.744,132,218,350,109,62,19,67,145,506
2013,Ronny Turiaf,C,30,LAC,65,0,701,49,97,0.505,0,0,NA,49,97,0.505,0.505,23,63,0.365,45,107,152,35,19,35,29,80,121
2013,Hedo Türkoğlu,SF,33,ORL,11,1,189,14,53,0.264,1,24,0.042,13,29,0.448,0.274,3,6,0.5,4,22,26,23,7,1,12,11,32
2013,Evan Turner,SF,24,PHI,82,82,2892,441,1053,0.419,58,159,0.365,383,894,0.428,0.446,154,208,0.74,56,461,517,354,71,17,187,197,1094
2013,Jeremy Tyler,C,21,GSW,20,0,63,9,24,0.375,0,0,NA,9,24,0.375,0.375,4,6,0.667,6,11,17,1,1,2,6,10,22
2013,Jeremy Tyler,C,21,ATL,1,0,5,0,0,NA,0,0,NA,0,0,NA,NA,0,0,NA,0,3,3,0,0,0,0,0,0
2013,Ekpe Udoh,C,25,MIL,76,9,1312,117,269,0.435,0,1,0,117,268,0.437,0.435,89,119,0.748,113,138,251,43,39,85,43,139,323
2013,Beno Udrih,SG,30,MIL,39,0,719,113,238,0.475,13,49,0.265,100,189,0.529,0.502,24,33,0.727,17,61,78,138,16,2,53,39,263
2013,Beno Udrih,PG,30,ORL,27,9,738,97,238,0.408,21,53,0.396,76,185,0.411,0.452,60,70,0.857,17,46,63,164,25,1,55,51,275
2013,Jonas Valančiūnas,C,20,TOR,62,57,1482,204,366,0.557,0,0,NA,204,366,0.557,0.557,146,185,0.789,121,251,372,45,17,78,94,188,554
2013,Anderson Varejão,C,30,CLE,25,25,901,138,289,0.478,0,5,0,138,284,0.486,0.478,77,102,0.755,138,223,361,84,37,14,44,68,353
2013,Jarvis Varnado,PF,24,BOS,5,0,18,2,4,0.5,0,0,NA,2,4,0.5,0.5,2,4,0.5,1,2,3,1,1,0,1,1,6
2013,Jarvis Varnado,PF,24,MIA,8,0,40,1,3,0.333,0,0,NA,1,3,0.333,0.333,0,0,NA,1,5,6,2,0,2,5,9,2
2013,Greivis Vásquez,PG,26,NOH,78,78,2685,438,1012,0.433,83,243,0.342,355,769,0.462,0.474,124,154,0.805,43,294,337,704,66,6,247,190,1083
2013,Jan Veselý,PF,22,WAS,51,4,601,57,114,0.5,0,1,0,57,113,0.504,0.5,12,39,0.308,43,79,122,28,15,17,27,107,126
2013,Nikola Vučević,C,22,ORL,77,77,2559,461,889,0.519,0,3,0,461,886,0.52,0.519,86,126,0.683,273,644,917,143,61,79,141,218,1008
2013,Dwyane Wade,SG,31,MIA,69,69,2391,569,1093,0.521,17,66,0.258,552,1027,0.537,0.528,308,425,0.725,86,258,344,352,128,56,194,140,1463
2013,Dion Waiters,SG,21,CLE,61,48,1756,336,815,0.412,63,203,0.31,273,612,0.446,0.451,159,213,0.746,22,127,149,183,59,16,121,113,894
2013,Gerald Wallace,SF,30,BRK,69,68,2076,182,458,0.397,46,163,0.282,136,295,0.461,0.448,121,190,0.637,69,250,319,181,97,46,110,118,531
2013,Rasheed Wallace,C,38,NYK,21,0,296,55,142,0.387,22,69,0.319,33,73,0.452,0.465,14,20,0.7,11,72,83,6,13,15,10,40,146
2013,Luke Walton,PF,32,CLE,50,0,857,71,181,0.392,20,67,0.299,51,114,0.447,0.448,10,20,0.5,38,107,145,166,42,13,60,98,172
2013,Hakim Warrick,PF,30,NOH,1,0,7,1,2,0.5,0,0,NA,1,2,0.5,0.5,2,2,1,0,0,0,0,1,0,0,0,4
2013,Hakim Warrick,PF,30,CHA,27,14,482,66,163,0.405,0,3,0,66,160,0.413,0.405,58,86,0.674,21,68,89,25,12,6,29,37,190
2013,Earl Watson,PG,33,UTA,48,4,829,37,120,0.308,5,28,0.179,32,92,0.348,0.329,17,25,0.68,23,64,87,190,40,8,69,94,96
2013,Maalik Wayns,PG,21,PHI,21,1,165,19,72,0.264,5,25,0.2,14,47,0.298,0.299,13,15,0.867,1,4,5,20,3,0,13,18,56
2013,Maalik Wayns,PG,21,LAC,6,0,37,7,16,0.438,2,6,0.333,5,10,0.5,0.5,4,4,1,0,2,2,7,3,0,2,8,20
2013,D.J. White,PF,26,BOS,12,0,86,12,23,0.522,0,0,NA,12,23,0.522,0.522,5,9,0.556,4,9,13,4,1,6,2,5,29
2013,Chris Wilcox,C,30,BOS,61,7,830,110,153,0.719,0,1,0,110,152,0.724,0.719,39,58,0.672,55,125,180,22,32,28,34,125,259
2013,Deron Williams,PG,28,BRK,78,78,2842,495,1124,0.44,169,447,0.378,326,677,0.482,0.516,317,369,0.859,29,203,232,604,75,30,218,194,1476
2013,Derrick Williams,PF,21,MIN,78,56,1916,338,786,0.43,65,196,0.332,273,590,0.463,0.471,192,272,0.706,96,334,430,46,44,37,101,127,933
2013,Lou Williams,SG,26,ATL,39,9,1119,187,443,0.422,72,196,0.367,115,247,0.466,0.503,105,121,0.868,8,72,80,139,44,10,74,55,551
2013,Marvin Williams,SF,26,UTA,73,51,1727,199,470,0.423,54,166,0.325,145,304,0.477,0.481,77,99,0.778,55,208,263,77,37,38,60,98,529
2013,Mo Williams,PG,30,UTA,46,46,1418,229,533,0.43,59,154,0.383,170,379,0.449,0.485,75,85,0.882,24,86,110,285,46,9,125,105,592
2013,Reggie Williams,SF,26,CHA,40,0,380,57,132,0.432,22,72,0.306,35,60,0.583,0.515,10,21,0.476,8,43,51,39,12,1,19,19,146
2013,Terrence Williams,SF,25,BOS,24,0,318,48,97,0.495,5,15,0.333,43,82,0.524,0.521,9,21,0.429,4,40,44,38,11,2,22,13,110
2013,Metta World Peace,SF,33,LAL,75,66,2530,332,824,0.403,141,412,0.342,191,412,0.464,0.488,124,169,0.734,101,271,372,112,122,42,98,198,929
2013,Brandan Wright,C,25,DAL,64,16,1149,241,404,0.597,0,3,0,241,401,0.601,0.597,59,96,0.615,85,175,260,38,26,76,34,78,541
2013,Nick Young,SG,27,PHI,59,17,1411,224,542,0.413,75,210,0.357,149,332,0.449,0.482,105,128,0.82,24,106,130,84,36,14,50,84,628
2013,Sam Young,SG,27,IND,56,3,693,58,148,0.392,16,52,0.308,42,96,0.438,0.446,23,43,0.535,26,97,123,42,15,8,33,62,155
2013,Thaddeus Young,PF,24,PHI,76,76,2629,509,958,0.531,1,8,0.125,508,950,0.535,0.532,108,188,0.574,182,389,571,125,133,55,90,191,1127
2013,Tyler Zeller,C,23,CLE,77,55,2033,245,559,0.438,0,4,0,245,555,0.441,0.438,120,157,0.764,159,279,438,96,35,70,95,251,610
2014,Quincy Acy,SF,23,TOR,7,0,61,6,14,0.429,2,5,0.4,4,9,0.444,0.5,5,8,0.625,5,10,15,4,4,3,2,8,19
2014,Quincy Acy,SF,23,SAC,56,0,786,60,127,0.472,2,10,0.2,58,117,0.496,0.48,30,45,0.667,67,134,201,24,19,23,28,114,152
2014,Jeff Adrien,PF,27,CHA,25,0,256,22,40,0.55,0,0,NA,22,40,0.55,0.55,13,25,0.52,33,55,88,7,7,15,8,35,57
2014,Jeff Adrien,PF,27,MIL,28,12,705,121,235,0.515,0,0,NA,121,235,0.515,0.515,63,94,0.67,69,149,218,31,17,21,31,73,305
2014,Arron Afflalo,SG,28,ORL,73,73,2552,464,1011,0.459,128,300,0.427,336,711,0.473,0.522,274,336,0.815,32,230,262,248,35,3,146,136,1330
2014,Alexis Ajinça,C,25,NOP,56,30,951,136,249,0.546,0,1,0,136,248,0.548,0.546,56,67,0.836,94,183,277,40,23,46,63,187,328
2014,Cole Aldrich,C,25,NYK,46,2,330,33,61,0.541,0,0,NA,33,61,0.541,0.541,26,30,0.867,37,92,129,14,8,30,18,40,92
2014,LaMarcus Aldridge,PF,28,POR,69,69,2498,652,1423,0.458,3,15,0.2,649,1408,0.461,0.459,296,360,0.822,166,599,765,178,63,68,123,147,1603
2014,Lavoy Allen,PF,24,PHI,51,2,960,117,266,0.44,2,13,0.154,115,253,0.455,0.444,27,40,0.675,106,171,277,65,22,27,40,115,263
2014,Lavoy Allen,PF,24,IND,14,0,112,17,34,0.5,0,0,NA,17,34,0.5,0.5,6,10,0.6,13,21,34,6,2,6,4,11,40
2014,Ray Allen,SG,38,MIA,73,9,1936,240,543,0.442,116,309,0.375,124,234,0.53,0.549,105,116,0.905,23,182,205,143,54,8,84,115,701
2014,Al-Farouq Aminu,SF,23,NOP,80,65,2045,234,494,0.474,13,48,0.271,221,446,0.496,0.487,91,137,0.664,129,367,496,114,82,38,88,147,572
2014,Lou Amundson,PF,31,NOP,18,0,184,16,32,0.5,0,0,NA,16,32,0.5,0.5,6,24,0.25,28,27,55,6,9,11,14,49,38
2014,Lou Amundson,PF,31,CHI,1,0,1,0,0,NA,0,0,NA,0,0,NA,NA,0,0,NA,0,0,0,0,0,0,0,0,0
2014,Chris Andersen,C,35,MIA,72,0,1396,177,275,0.644,3,12,0.25,174,263,0.662,0.649,120,169,0.71,129,250,379,19,32,97,53,162,477
2014,James Anderson,SG,24,PHI,80,62,2309,309,717,0.431,115,351,0.328,194,366,0.53,0.511,77,106,0.726,59,241,300,149,74,28,106,154,810
2014,Ryan Anderson,PF,25,NOP,22,14,795,155,354,0.438,67,164,0.409,88,190,0.463,0.532,59,62,0.952,66,76,142,17,10,7,20,47,436
2014,Carmelo Anthony,PF,29,NYK,77,77,2982,743,1643,0.452,167,415,0.402,576,1228,0.469,0.503,459,541,0.848,145,477,622,242,95,51,198,224,2112
2014,Joel Anthony,C,31,MIA,12,0,37,2,6,0.333,0,0,NA,2,6,0.333,0.333,2,2,1,2,5,7,0,0,4,1,4,6
2014,Joel Anthony,C,31,BOS,21,0,149,10,26,0.385,0,0,NA,10,26,0.385,0.385,2,6,0.333,13,18,31,2,3,8,2,13,22
2014,Trevor Ariza,SF,28,WAS,77,77,2723,389,853,0.456,180,442,0.407,209,411,0.509,0.562,149,193,0.772,99,376,475,191,126,20,132,179,1107
2014,Hilton Armstrong,C,29,GSW,15,1,97,9,19,0.474,0,0,NA,9,19,0.474,0.474,7,16,0.438,19,28,47,5,4,4,6,11,25
2014,Ömer Aşık,C,27,HOU,48,19,968,101,190,0.532,0,0,NA,101,190,0.532,0.532,78,126,0.619,101,277,378,25,14,37,59,92,280
2014,D.J. Augustin,PG,26,TOR,10,0,82,7,24,0.292,1,11,0.091,6,13,0.462,0.313,6,6,1,0,4,4,10,1,0,9,7,21
2014,D.J. Augustin,PG,26,CHI,61,9,1857,291,694,0.419,132,321,0.411,159,373,0.426,0.514,195,221,0.882,15,111,126,303,52,3,116,140,909
2014,Gustavo Ayón,C,28,ATL,26,14,429,52,102,0.51,0,0,NA,52,102,0.51,0.51,8,20,0.4,42,83,125,28,25,10,29,47,112
2014,Luke Babbitt,PF,24,NOP,27,2,473,60,154,0.39,36,95,0.379,24,59,0.407,0.506,14,18,0.778,18,70,88,29,7,11,15,52,170
2014,Leandro Barbosa,PG,31,PHO,20,0,368,56,131,0.427,7,25,0.28,49,106,0.462,0.454,31,39,0.795,5,32,37,32,7,4,19,30,150
2014,Harrison Barnes,SF,21,GSW,78,24,2204,271,679,0.399,66,190,0.347,205,489,0.419,0.448,130,181,0.718,66,245,311,116,65,20,84,158,738
2014,Matt Barnes,SF,33,LAC,63,40,1735,231,527,0.438,97,283,0.343,134,244,0.549,0.53,66,90,0.733,60,232,292,125,56,28,85,185,625
2014,Will Barton,SG,23,POR,41,0,387,65,156,0.417,10,33,0.303,55,123,0.447,0.449,26,32,0.813,16,58,74,33,9,7,18,31,166
2014,Shane Battier,SF,35,MIA,73,56,1468,105,275,0.382,73,210,0.348,32,65,0.492,0.515,15,23,0.652,34,104,138,63,50,39,21,124,298
2014,Jerryd Bayless,PG,25,MEM,31,5,650,90,239,0.377,25,83,0.301,65,156,0.417,0.429,45,57,0.789,8,51,59,66,20,5,22,72,250
2014,Jerryd Bayless,PG,25,BOS,41,14,1036,158,378,0.418,51,129,0.395,107,249,0.43,0.485,49,61,0.803,14,72,86,128,40,4,60,89,416
2014,Kent Bazemore,SG,24,GSW,44,0,268,36,97,0.371,10,39,0.256,26,58,0.448,0.423,19,36,0.528,5,35,40,20,12,6,28,42,101
2014,Kent Bazemore,SG,24,LAL,23,15,643,111,246,0.451,33,89,0.371,78,157,0.497,0.518,47,73,0.644,5,72,77,71,31,7,51,60,302
2014,Marco Belinelli,SF,27,SAS,80,25,2016,337,695,0.485,126,293,0.43,211,402,0.525,0.576,111,131,0.847,18,208,226,179,50,7,95,130,911
2014,Chauncey Billups,SG,37,DET,19,7,309,24,79,0.304,14,48,0.292,10,31,0.323,0.392,10,12,0.833,4,24,28,42,8,1,25,25,72
2014,Steve Blake,PG,33,LAL,27,27,891,88,233,0.378,52,131,0.397,36,102,0.353,0.489,28,35,0.8,8,95,103,205,34,2,71,49,256
2014,Steve Blake,PG,33,GSW,28,1,607,45,120,0.375,27,79,0.342,18,41,0.439,0.488,5,8,0.625,5,51,56,102,20,6,31,36,122
2014,Eric Bledsoe,PG,24,PHO,43,40,1416,265,556,0.477,50,140,0.357,215,416,0.517,0.522,183,237,0.772,27,175,202,235,69,14,143,99,763
2014,Keith Bogans,SG,33,BOS,6,0,55,3,6,0.5,3,6,0.5,0,0,NA,0.75,3,3,1,0,3,3,3,1,0,1,2,12
2014,Andrew Bogut,C,29,GSW,67,67,1769,235,375,0.627,0,0,NA,235,375,0.627,0.627,22,64,0.344,182,489,671,112,47,121,97,210,492
2014,Trevor Booker,PF,26,WAS,72,45,1553,222,403,0.551,0,2,0,222,401,0.554,0.551,47,76,0.618,149,230,379,64,41,45,58,131,491
2014,Avery Bradley,SG,23,BOS,60,58,1855,361,825,0.438,79,200,0.395,282,625,0.451,0.485,90,112,0.804,48,178,226,85,63,11,96,145,891
2014,Corey Brewer,SF,27,MIN,81,81,2609,388,807,0.481,59,211,0.28,329,596,0.552,0.517,163,227,0.718,63,144,207,135,151,30,105,210,998
2014,Ronnie Brewer,SF,28,HOU,23,3,158,3,15,0.2,1,8,0.125,2,7,0.286,0.233,0,2,0,2,12,14,10,6,1,2,4,7
2014,Ronnie Brewer,SF,28,CHI,1,0,2,0,0,NA,0,0,NA,0,0,NA,NA,0,0,NA,0,0,0,0,0,0,0,0,0
2014,Aaron Brooks,PG,29,HOU,43,0,716,104,263,0.395,54,132,0.409,50,131,0.382,0.498,37,44,0.841,23,39,62,83,25,6,51,76,299
2014,Aaron Brooks,PG,29,DEN,29,12,841,129,318,0.406,42,116,0.362,87,202,0.431,0.472,46,51,0.902,20,58,78,150,27,7,66,70,346
2014,MarShon Brooks,SG,25,BOS,10,0,73,9,24,0.375,2,4,0.5,7,20,0.35,0.417,11,14,0.786,1,18,19,4,1,1,7,5,31
2014,MarShon Brooks,SG,25,GSW,7,0,15,5,13,0.385,0,2,0,5,11,0.455,0.385,3,4,0.75,1,4,5,0,1,0,0,0,13
2014,MarShon Brooks,SG,25,LAL,18,0,228,43,88,0.489,11,19,0.579,32,69,0.464,0.551,18,26,0.692,8,22,30,21,12,3,17,16,115
2014,Shannon Brown,SG,28,SAS,10,1,103,8,28,0.286,0,2,0,8,26,0.308,0.286,7,9,0.778,1,12,13,5,1,0,8,12,23
2014,Shannon Brown,SG,28,NYK,19,0,148,16,38,0.421,0,0,NA,16,38,0.421,0.421,8,12,0.667,6,9,15,4,12,0,10,12,40
2014,Chase Budinger,SF,25,MIN,41,8,751,100,254,0.394,42,120,0.35,58,134,0.433,0.476,32,39,0.821,19,84,103,31,19,2,24,58,274
2014,Reggie Bullock,SF,22,LAC,43,0,395,43,121,0.355,22,73,0.301,21,48,0.438,0.446,7,9,0.778,11,43,54,12,9,1,13,26,115
2014,Trey Burke,PG,21,UTA,70,68,2262,341,897,0.38,111,336,0.33,230,561,0.41,0.442,102,113,0.903,37,171,208,396,42,6,131,145,895
2014,Alec Burks,SG,22,UTA,78,12,2193,380,831,0.457,50,143,0.35,330,688,0.48,0.487,279,373,0.748,59,198,257,212,69,14,149,190,1089
2014,Caron Butler,SF,33,MIL,34,13,821,137,354,0.387,53,147,0.361,84,207,0.406,0.462,47,56,0.839,16,142,158,56,23,11,52,64,374
2014,Caron Butler,SF,33,OKC,22,0,598,76,186,0.409,45,102,0.441,31,84,0.369,0.53,16,19,0.842,5,66,71,26,24,6,8,56,213
2014,Jimmy Butler,SG,24,CHI,67,67,2591,275,693,0.397,68,240,0.283,207,453,0.457,0.446,260,338,0.769,87,243,330,175,127,36,102,106,878
2014,Rasual Butler,SG,34,IND,50,2,378,51,110,0.464,26,62,0.419,25,48,0.521,0.582,8,14,0.571,6,35,41,17,7,9,11,30,136
2014,Andrew Bynum,C,26,CLE,24,19,480,85,203,0.419,0,0,NA,85,203,0.419,0.419,32,42,0.762,47,79,126,27,6,28,30,28,202
2014,Andrew Bynum,C,26,IND,2,0,36,9,22,0.409,0,0,NA,9,22,0.409,0.409,5,7,0.714,6,13,19,2,0,1,4,3,23
2014,José Calderón,PG,32,DAL,81,81,2468,341,748,0.456,191,425,0.449,150,323,0.464,0.584,52,63,0.825,29,163,192,377,69,11,103,136,925
2014,Isaiah Canaan,PG,22,HOU,22,0,252,31,87,0.356,18,55,0.327,13,32,0.406,0.46,21,29,0.724,7,17,24,22,8,4,21,25,101
2014,DeMarre Carroll,SF,27,ATL,73,73,2341,302,642,0.47,97,268,0.362,205,374,0.548,0.546,109,141,0.773,107,296,403,134,108,21,79,188,810
2014,Vince Carter,SG,37,DAL,81,0,1973,330,811,0.407,146,371,0.394,184,440,0.418,0.497,161,196,0.821,67,217,284,212,61,35,108,209,967
2014,Michael Carter-Williams,PG,22,PHI,70,70,2414,427,1054,0.405,55,208,0.264,372,846,0.44,0.431,258,367,0.703,101,336,437,441,130,43,247,213,1167
2014,Omri Casspi,PF,25,HOU,71,2,1283,173,410,0.422,61,176,0.347,112,234,0.479,0.496,83,122,0.68,55,205,260,88,44,14,72,100,490
2014,Mario Chalmers,PG,27,MIA,73,73,2178,254,560,0.454,87,226,0.385,167,334,0.5,0.531,121,163,0.742,41,173,214,357,119,16,162,210,716
2014,Tyson Chandler,C,31,NYK,55,55,1662,191,322,0.593,0,1,0,191,321,0.595,0.593,98,155,0.632,159,370,529,59,36,63,71,145,480
2014,Wilson Chandler,SF,26,DEN,62,55,1927,307,738,0.416,122,351,0.348,185,387,0.478,0.499,110,152,0.724,58,236,294,114,46,31,79,193,846
2014,Earl Clark,PF,26,CLE,45,17,698,90,240,0.375,40,116,0.345,50,124,0.403,0.458,14,24,0.583,20,107,127,16,16,19,30,61,234
2014,Earl Clark,PF,26,NYK,9,0,70,7,21,0.333,1,6,0.167,6,15,0.4,0.357,8,10,0.8,2,14,16,2,1,6,1,6,23
2014,Ian Clark,SG,22,UTA,23,0,172,26,67,0.388,11,31,0.355,15,36,0.417,0.47,5,7,0.714,3,16,19,15,8,2,14,24,68
2014,Norris Cole,PG,25,MIA,82,6,2014,207,500,0.414,60,174,0.345,147,326,0.451,0.474,53,68,0.779,17,143,160,248,77,5,127,156,527
2014,Jason Collins,C,35,BRK,22,1,172,11,24,0.458,0,3,0,11,21,0.524,0.458,3,4,0.75,7,12,19,4,8,1,7,30,25
2014,DeMarcus Cousins,C,23,SAC,71,71,2298,591,1191,0.496,0,7,0,591,1184,0.499,0.496,432,595,0.726,218,613,831,207,109,91,251,270,1614
2014,Robert Covington,SF,23,HOU,7,0,34,6,14,0.429,4,11,0.364,2,3,0.667,0.571,0,0,NA,2,3,5,0,2,0,1,3,16
2014,Allen Crabbe,SG,21,POR,15,0,100,12,33,0.364,6,14,0.429,6,19,0.316,0.455,3,4,0.75,1,8,9,6,2,1,3,10,33
2014,Jamal Crawford,SG,33,LAC,69,24,2094,421,1011,0.416,161,446,0.361,260,565,0.46,0.496,279,322,0.866,34,124,158,223,59,12,135,120,1282
2014,Jordan Crawford,PG,25,BOS,39,35,1198,188,455,0.413,50,157,0.318,138,298,0.463,0.468,110,126,0.873,18,102,120,224,34,3,84,76,536
2014,Jordan Crawford,SG,25,GSW,42,0,661,139,333,0.417,40,128,0.313,99,205,0.483,0.477,36,43,0.837,10,53,63,57,13,2,50,44,354
2014,Jae Crowder,SF,23,DAL,78,8,1254,130,296,0.439,50,151,0.331,80,145,0.552,0.524,46,61,0.754,46,148,194,60,59,21,41,100,356
2014,Dante Cunningham,PF,26,MIN,81,7,1635,236,509,0.464,0,5,0,236,504,0.468,0.464,38,67,0.567,112,218,330,83,62,58,42,146,510
2014,Jared Cunningham,SG,22,ATL,5,0,22,1,2,0.5,0,1,0,1,1,1,0.5,0,2,0,0,1,1,3,0,0,2,3,2
2014,Jared Cunningham,SG,22,SAC,8,0,58,5,19,0.263,1,6,0.167,4,13,0.308,0.289,13,14,0.929,1,4,5,5,3,0,0,13,24
2014,Seth Curry,PG,23,MEM,1,0,4,0,0,NA,0,0,NA,0,0,NA,NA,0,0,NA,0,0,0,0,0,0,0,0,0
2014,Seth Curry,PG,23,CLE,1,0,9,1,3,0.333,1,1,1,0,2,0,0.5,0,0,NA,0,1,1,0,2,0,0,0,3
2014,Troy Daniels,SG,22,HOU,5,1,75,15,31,0.484,12,25,0.48,3,6,0.5,0.677,0,0,NA,0,4,4,5,0,0,3,6,42
2014,Gigi Datome,SF,26,DET,34,0,238,34,97,0.351,7,39,0.179,27,58,0.466,0.387,8,10,0.8,14,32,46,11,6,1,11,20,83
2014,Brandon Davies,PF,22,PHI,51,0,575,54,128,0.422,2,10,0.2,52,118,0.441,0.43,34,53,0.642,38,71,109,28,24,8,35,92,144
2014,Ed Davis,PF,24,MEM,63,4,956,155,290,0.534,0,0,NA,155,290,0.534,0.534,47,89,0.528,92,168,260,27,17,43,40,114,357
2014,Glen Davis,PF,28,ORL,45,43,1354,232,512,0.453,4,10,0.4,228,502,0.454,0.457,77,114,0.675,87,195,282,70,46,22,59,111,545
2014,Glen Davis,PF,28,LAC,23,1,308,39,81,0.481,0,1,0,39,80,0.488,0.481,18,23,0.783,21,48,69,7,12,7,17,48,96
2014,Austin Daye,SF,25,TOR,8,0,33,3,13,0.231,0,8,0,3,5,0.6,0.231,2,3,0.667,2,5,7,2,0,0,0,4,8
2014,Austin Daye,SF,25,SAS,14,1,115,21,55,0.382,12,29,0.414,9,26,0.346,0.491,4,7,0.571,3,17,20,6,4,4,5,14,58
2014,Nando De Colo,SF,26,SAS,26,3,301,42,93,0.452,10,31,0.323,32,62,0.516,0.505,18,22,0.818,6,39,45,32,15,3,21,25,112
2014,Nando De Colo,SF,26,TOR,21,0,193,22,60,0.367,8,22,0.364,14,38,0.368,0.433,13,13,1,8,20,28,33,7,3,14,23,65
2014,Dewayne Dedmon,C,24,GSW,4,0,6,0,1,0,0,0,NA,0,1,0,0,1,2,0.5,0,0,0,0,0,0,0,1,1
2014,Dewayne Dedmon,C,24,PHI,11,0,150,15,29,0.517,0,0,NA,15,29,0.517,0.517,7,13,0.538,11,38,49,3,0,9,9,28,37
2014,Dewayne Dedmon,C,24,ORL,16,6,234,23,53,0.434,0,0,NA,23,53,0.434,0.434,13,17,0.765,27,51,78,2,7,13,9,37,59
2014,Matthew Dellavedova,SG,23,CLE,72,4,1271,122,296,0.412,57,155,0.368,65,141,0.461,0.508,38,48,0.792,29,94,123,187,33,5,60,121,339
2014,Luol Deng,SF,28,CHI,23,23,860,160,354,0.452,17,62,0.274,143,292,0.49,0.476,101,124,0.815,40,118,158,85,24,4,59,53,438
2014,Luol Deng,SF,28,CLE,40,40,1353,211,506,0.417,40,127,0.315,171,379,0.451,0.457,111,144,0.771,59,144,203,98,38,5,55,58,573
2014,Boris Diaw,PF,31,SAS,79,24,1974,302,580,0.521,45,112,0.402,257,468,0.549,0.559,68,92,0.739,74,252,326,222,44,32,121,140,717
2014,Gorgui Dieng,C,24,MIN,60,15,818,113,227,0.498,1,1,1,112,226,0.496,0.5,59,93,0.634,103,197,300,39,30,50,54,108,286
2014,Toney Douglas,PG,27,GSW,24,0,265,32,86,0.372,19,59,0.322,13,27,0.481,0.483,5,8,0.625,4,22,26,19,6,2,16,34,88
2014,Toney Douglas,PG,27,MIA,27,17,410,41,104,0.394,12,43,0.279,29,61,0.475,0.452,20,26,0.769,14,47,61,49,13,3,18,47,114
2014,Goran Dragić,SG,27,PHO,76,75,2668,552,1093,0.505,122,299,0.408,430,794,0.542,0.561,316,416,0.76,69,176,245,447,104,22,213,206,1542
2014,Andre Drummond,C,20,DET,81,81,2619,479,769,0.623,0,2,0,479,767,0.625,0.623,137,328,0.418,440,631,1071,35,101,131,110,273,1095
2014,Jared Dudley,SF,28,LAC,74,43,1729,196,447,0.438,81,225,0.36,115,222,0.518,0.529,38,58,0.655,36,124,160,104,41,10,56,146,511
2014,Mike Dunleavy,SF,33,CHI,82,61,2584,333,774,0.43,123,324,0.38,210,450,0.467,0.51,140,164,0.854,46,299,345,186,64,46,108,163,929
2014,Wayne Ellington,SG,26,DAL,45,1,393,55,126,0.437,25,59,0.424,30,67,0.448,0.536,10,11,0.909,8,35,43,19,16,2,11,33,145
2014,Monta Ellis,SG,28,DAL,82,82,3023,576,1278,0.451,69,209,0.33,507,1069,0.474,0.478,339,430,0.788,38,257,295,471,141,23,264,197,1560
2014,Melvin Ely,C,35,NOP,2,0,27,3,6,0.5,0,0,NA,3,6,0.5,0.5,0,0,NA,0,1,1,0,0,1,0,5,6
2014,Reggie Evans,PF,33,BRK,30,6,399,23,59,0.39,0,0,NA,23,59,0.39,0.39,35,65,0.538,53,96,149,5,13,2,28,54,81
2014,Reggie Evans,PF,33,SAC,24,14,500,48,91,0.527,0,0,NA,48,91,0.527,0.527,37,65,0.569,62,123,185,16,24,1,30,65,133
2014,Tyreke Evans,SF,24,NOP,72,22,2028,391,897,0.436,21,95,0.221,370,802,0.461,0.448,239,310,0.771,76,265,341,363,84,21,175,155,1042
2014,Kenneth Faried,PF,24,DEN,80,77,2178,447,820,0.545,0,3,0,447,817,0.547,0.545,202,311,0.65,238,446,684,96,70,69,135,193,1096
2014,Derrick Favors,PF,22,UTA,73,73,2201,390,747,0.522,0,1,0,390,746,0.523,0.522,190,284,0.669,199,438,637,91,75,108,129,236,970
2014,Raymond Felton,PG,29,NYK,65,65,2017,240,608,0.395,62,195,0.318,178,413,0.431,0.446,88,122,0.721,54,143,197,365,78,27,129,157,630
2014,Derek Fisher,SG,39,OKC,81,0,1428,141,361,0.391,88,229,0.384,53,132,0.402,0.512,55,71,0.775,12,110,122,117,70,3,49,157,425
2014,Evan Fournier,SG,21,DEN,76,4,1503,228,544,0.419,89,237,0.376,139,307,0.453,0.501,93,123,0.756,34,168,202,112,34,7,100,179,638
2014,Randy Foye,SG,30,DEN,81,78,2485,361,875,0.413,189,498,0.38,172,377,0.456,0.521,157,185,0.849,36,196,232,287,67,39,145,205,1068
2014,Jimmer Fredette,SG,24,SAC,41,0,463,94,198,0.475,36,73,0.493,58,125,0.464,0.566,17,19,0.895,7,38,45,61,14,3,44,28,241
2014,Jimmer Fredette,SG,24,CHI,8,0,56,13,29,0.448,4,11,0.364,9,18,0.5,0.517,2,2,1,1,6,7,3,0,0,4,7,32
2014,Enes Freedom,C,21,UTA,80,37,2138,419,853,0.491,0,1,0,419,852,0.492,0.491,149,204,0.73,222,376,598,75,28,42,144,230,987
2014,Channing Frye,PF,30,PHO,82,82,2312,336,778,0.432,160,432,0.37,176,346,0.509,0.535,78,95,0.821,73,343,416,98,60,63,89,245,910
2014,Francisco García,SF,32,HOU,55,4,1083,118,294,0.401,69,193,0.358,49,101,0.485,0.519,10,19,0.526,21,101,122,63,27,33,30,120,315
2014,Kevin Garnett,C,37,BRK,54,54,1109,157,356,0.441,0,3,0,157,353,0.445,0.441,38,47,0.809,60,298,358,82,43,40,69,123,352
2014,Marc Gasol,C,29,MEM,59,59,1970,336,711,0.473,2,11,0.182,334,700,0.477,0.474,185,241,0.768,84,340,424,215,59,76,111,150,859
2014,Pau Gasol,C,33,LAL,60,60,1884,425,885,0.48,4,14,0.286,421,871,0.483,0.482,187,254,0.736,124,456,580,201,27,92,141,124,1041
2014,Rudy Gay,SF,27,TOR,18,18,639,130,335,0.388,22,59,0.373,108,276,0.391,0.421,68,88,0.773,29,104,133,40,28,23,59,47,350
2014,Rudy Gay,SF,27,SAC,55,55,1892,407,844,0.482,43,138,0.312,364,706,0.516,0.508,250,299,0.836,84,220,304,169,67,33,165,124,1107
2014,Alonzo Gee,SF,26,CLE,65,24,1020,98,236,0.415,19,58,0.328,79,178,0.444,0.456,43,61,0.705,35,114,149,47,39,15,44,96,258
2014,Taj Gibson,PF,28,CHI,82,8,2351,429,896,0.479,0,7,0,429,889,0.483,0.479,211,281,0.751,200,358,558,91,41,112,150,207,1069
2014,Drew Gooden,C,32,WAS,22,0,395,76,143,0.531,7,17,0.412,69,126,0.548,0.556,24,27,0.889,37,77,114,15,10,7,17,53,183
2014,Archie Goodwin,SG,19,PHO,52,0,533,76,167,0.455,5,36,0.139,71,131,0.542,0.47,37,55,0.673,25,62,87,20,20,11,44,45,194
2014,Marcin Gortat,C,29,WAS,81,80,2655,455,840,0.542,1,1,1,454,839,0.541,0.542,157,229,0.686,202,565,767,138,41,121,126,201,1068
2014,Danny Granger,SF,30,IND,29,2,653,80,223,0.359,31,94,0.33,49,129,0.38,0.428,51,53,0.962,24,81,105,33,9,13,36,41,242
2014,Danny Granger,SF,30,LAC,12,0,194,36,84,0.429,12,34,0.353,24,50,0.48,0.5,12,14,0.857,7,21,28,8,3,4,10,21,96
2014,Aaron Gray,C,29,TOR,4,0,20,2,3,0.667,0,0,NA,2,3,0.667,0.667,1,2,0.5,3,5,8,3,0,0,4,7,5
2014,Aaron Gray,C,29,SAC,33,6,335,25,58,0.431,0,1,0,25,57,0.439,0.431,10,18,0.556,39,64,103,19,10,8,27,57,60
2014,Gerald Green,SG,28,PHO,82,48,2330,448,1006,0.445,204,510,0.4,244,496,0.492,0.547,195,230,0.848,48,227,275,122,70,42,145,220,1295
2014,Jeff Green,SF,27,BOS,82,82,2805,482,1171,0.412,135,396,0.341,347,775,0.448,0.469,283,356,0.795,54,326,380,138,57,47,165,180,1382
2014,Blake Griffin,PF,24,LAC,80,80,2863,718,1359,0.528,12,44,0.273,706,1315,0.537,0.533,482,674,0.715,192,565,757,309,92,51,224,265,1930
2014,Jorge Gutiérrez,PG,25,BRK,15,2,244,25,54,0.463,3,12,0.25,22,42,0.524,0.491,9,12,0.75,3,19,22,30,10,1,14,37,62
2014,Jordan Hamilton,SF,23,DEN,39,11,670,99,254,0.39,45,129,0.349,54,125,0.432,0.478,23,31,0.742,23,110,133,34,31,13,27,31,266
2014,Jordan Hamilton,SF,23,HOU,21,1,349,48,122,0.393,25,69,0.362,23,53,0.434,0.496,17,20,0.85,9,52,61,18,13,7,19,36,138
2014,Justin Hamilton,C,23,CHA,1,0,4,0,0,NA,0,0,NA,0,0,NA,NA,0,0,NA,0,0,0,0,1,0,1,0,0
2014,Justin Hamilton,C,23,MIA,7,0,68,9,20,0.45,3,9,0.333,6,11,0.545,0.525,5,5,1,4,3,7,0,4,0,3,8,26
2014,Tim Hardaway Jr.,SG,21,NYK,81,1,1875,294,687,0.428,130,358,0.363,164,329,0.498,0.523,106,128,0.828,19,102,121,66,44,7,47,144,824
2014,James Harden,SG,24,HOU,73,73,2777,549,1205,0.456,177,483,0.366,372,722,0.515,0.529,576,665,0.866,61,283,344,446,115,29,265,177,1851
2014,Maurice Harkless,SF,20,ORL,80,41,1950,224,483,0.464,59,154,0.383,165,329,0.502,0.525,85,143,0.594,69,195,264,80,97,50,86,140,592
2014,Al Harrington,PF,33,WAS,34,0,511,82,207,0.396,34,100,0.34,48,107,0.449,0.478,27,35,0.771,15,65,80,28,14,0,34,72,225
2014,Devin Harris,PG,30,DAL,40,0,818,96,254,0.378,31,101,0.307,65,153,0.425,0.439,92,115,0.8,8,77,85,178,28,2,59,72,315
2014,Mike Harris,PF,30,UTA,20,0,225,29,61,0.475,0,2,0,29,59,0.492,0.475,26,27,0.963,15,18,33,5,16,7,11,36,84
2014,Tobias Harris,PF,21,ORL,61,36,1850,332,716,0.464,32,126,0.254,300,590,0.508,0.486,197,244,0.807,88,336,424,82,41,24,78,143,893
2014,Spencer Hawes,C,25,PHI,53,53,1666,264,586,0.451,81,203,0.399,183,383,0.478,0.52,79,101,0.782,88,364,452,176,31,67,119,154,688
2014,Spencer Hawes,C,25,CLE,27,25,804,139,297,0.468,47,105,0.448,92,192,0.479,0.547,40,51,0.784,43,165,208,64,13,27,54,83,365
2014,Chuck Hayes,C,30,SAC,16,1,179,14,32,0.438,0,0,NA,14,32,0.438,0.438,5,7,0.714,20,27,47,6,11,2,7,18,33
2014,Chuck Hayes,C,30,TOR,45,0,575,42,98,0.429,0,1,0,42,97,0.433,0.429,15,18,0.833,49,114,163,29,23,10,26,77,99
2014,Gerald Henderson,SG,26,CHA,77,77,2461,403,930,0.433,40,115,0.348,363,815,0.445,0.455,235,309,0.761,31,279,310,199,51,32,113,159,1081
2014,John Henson,PF,23,MIL,70,23,1856,344,639,0.538,0,1,0,344,638,0.539,0.538,91,177,0.514,171,326,497,113,41,116,114,185,779
2014,Roy Hibbert,C,27,IND,81,81,2409,331,754,0.439,2,5,0.4,329,749,0.439,0.44,207,269,0.77,202,336,538,91,29,182,148,269,871
2014,J.J. Hickson,PF,25,DEN,69,52,1859,332,654,0.508,0,8,0,332,646,0.514,0.508,150,290,0.517,206,426,632,96,47,51,128,177,814
2014,Nenê,PF,31,WAS,53,37,1560,299,594,0.503,1,5,0.2,298,589,0.506,0.504,155,266,0.583,65,229,294,153,64,47,117,164,754
2014,George Hill,PG,27,IND,76,76,2434,272,616,0.442,95,260,0.365,177,356,0.497,0.519,142,176,0.807,53,230,283,265,75,23,92,158,781
2014,Jordan Hill,PF,26,LAL,72,32,1500,286,521,0.549,0,1,0,286,520,0.55,0.549,124,181,0.685,194,341,535,54,29,64,75,172,696
2014,Solomon Hill,SF,22,IND,28,0,226,17,40,0.425,7,23,0.304,10,17,0.588,0.513,6,7,0.857,9,32,41,12,5,2,13,19,47
2014,Kirk Hinrich,PG,33,CHI,73,61,2116,243,619,0.393,85,242,0.351,158,377,0.419,0.461,95,125,0.76,31,161,192,286,80,26,120,203,666
2014,Ryan Hollins,PF,29,LAC,61,0,482,53,72,0.736,0,0,NA,53,72,0.736,0.736,35,56,0.625,31,59,90,8,9,31,29,87,141
2014,Kris Humphries,PF,28,BOS,69,30,1376,231,461,0.501,0,2,0,231,459,0.503,0.501,117,144,0.813,127,282,409,67,31,61,64,136,579
2014,Serge Ibaka,PF,24,OKC,81,81,2666,524,978,0.536,23,60,0.383,501,918,0.546,0.548,156,199,0.784,224,485,709,85,39,219,123,233,1227
2014,Ersan İlyasova,PF,26,MIL,55,47,1478,237,579,0.409,37,131,0.282,200,448,0.446,0.441,107,130,0.823,107,235,342,72,46,8,61,135,618
2014,Royal Ivey,SG,32,OKC,2,0,5,0,2,0,0,1,0,0,1,0,0,0,0,NA,0,1,1,0,0,0,0,1,0
2014,Jarrett Jack,PG,30,CLE,80,31,2252,286,698,0.41,63,185,0.341,223,513,0.435,0.455,125,149,0.839,22,201,223,324,56,22,133,133,760
2014,Reggie Jackson,PG,23,OKC,80,36,2277,403,916,0.44,83,245,0.339,320,671,0.477,0.485,158,177,0.893,43,270,313,331,85,9,168,142,1047
2014,Stephen Jackson,SF,35,LAC,9,0,107,6,26,0.231,1,14,0.071,5,12,0.417,0.25,2,4,0.5,2,8,10,5,6,1,6,11,15
2014,Mike James,PG,38,CHI,11,0,77,5,21,0.238,1,5,0.2,4,16,0.25,0.262,0,2,0,0,7,7,17,2,0,5,11,11
2014,Antawn Jamison,PF,37,LAC,22,0,248,29,92,0.315,8,41,0.195,21,51,0.412,0.359,18,25,0.72,9,46,55,7,9,3,7,29,84
2014,Othyus Jeffers,SG,28,SAS,4,1,34,3,5,0.6,0,1,0,3,4,0.75,0.6,1,2,0.5,1,5,6,1,0,0,0,2,7
2014,Othyus Jeffers,SG,28,MIN,2,0,13,0,1,0,0,1,0,0,0,NA,0,2,2,1,0,3,3,0,0,0,1,1,2
2014,Richard Jefferson,SF,33,UTA,82,78,2213,294,654,0.45,123,301,0.409,171,353,0.484,0.544,120,162,0.741,18,201,219,130,56,14,94,168,831
2014,John Jenkins,SG,22,ATL,13,0,158,16,42,0.381,4,18,0.222,12,24,0.5,0.429,4,4,1,3,19,22,11,1,1,11,11,40
2014,Brandon Jennings,PG,24,DET,80,79,2728,423,1135,0.373,154,457,0.337,269,678,0.397,0.441,241,321,0.751,59,185,244,609,101,8,215,157,1241
2014,Jonas Jerebko,PF,26,DET,64,0,741,98,208,0.471,31,74,0.419,67,134,0.5,0.546,43,59,0.729,51,124,175,39,21,6,43,85,270
2014,Chris Johnson,SF,23,BOS,40,0,789,85,214,0.397,43,127,0.339,42,87,0.483,0.498,37,43,0.86,31,66,97,31,27,4,22,63,250
2014,James Johnson,SF,26,MEM,52,4,956,143,308,0.464,22,87,0.253,121,221,0.548,0.5,76,90,0.844,60,106,166,111,42,57,66,102,384
2014,Joe Johnson,SG,32,BRK,79,79,2575,462,1018,0.454,162,404,0.401,300,614,0.489,0.533,159,195,0.815,48,222,270,216,47,10,120,129,1245
2014,Orlando Johnson,SG,24,IND,38,0,342,33,96,0.344,8,41,0.195,25,55,0.455,0.385,17,22,0.773,7,44,51,16,6,1,14,23,91
2014,Orlando Johnson,SG,24,SAC,7,0,50,3,17,0.176,1,6,0.167,2,11,0.182,0.206,2,4,0.5,2,2,4,4,0,1,1,3,9
2014,Wesley Johnson,SF,26,LAL,79,62,2240,277,651,0.425,100,271,0.369,177,380,0.466,0.502,61,77,0.792,70,278,348,124,86,77,90,207,715
2014,Solomon Jones,PF,29,ORL,11,0,85,6,17,0.353,0,0,NA,6,17,0.353,0.353,2,4,0.5,8,8,16,2,2,2,2,12,14
2014,Terrence Jones,PF,22,HOU,76,71,2078,386,712,0.542,31,101,0.307,355,611,0.581,0.564,118,195,0.605,162,366,528,87,53,99,71,139,921
2014,DeAndre Jordan,C,25,LAC,82,82,2870,348,515,0.676,0,0,NA,348,515,0.676,0.676,160,374,0.428,331,783,1114,74,80,203,123,264,856
2014,Cory Joseph,SG,22,SAS,68,19,936,126,265,0.475,12,38,0.316,114,227,0.502,0.498,79,96,0.823,32,75,107,114,35,14,43,84,343
2014,Michael Kidd-Gilchrist,SF,20,CHA,62,62,1502,167,353,0.473,1,9,0.111,166,344,0.483,0.475,113,184,0.614,109,215,324,52,43,39,60,145,448
2014,Brandon Knight,PG,22,MIL,72,69,2400,461,1092,0.422,110,338,0.325,351,754,0.466,0.473,259,323,0.802,46,209,255,352,69,17,188,146,1291
2014,Kyle Korver,SG,32,ATL,71,71,2408,289,609,0.475,185,392,0.472,104,217,0.479,0.626,87,94,0.926,22,260,282,208,70,24,102,147,850
2014,Kosta Koufos,C,24,MEM,80,22,1349,227,459,0.495,0,0,NA,227,459,0.495,0.495,60,93,0.645,160,258,418,39,32,71,67,182,514
2014,Doron Lamb,SG,22,ORL,53,0,695,63,160,0.394,36,90,0.4,27,70,0.386,0.506,29,36,0.806,8,41,49,43,11,1,27,54,191
2014,Carl Landry,PF,30,SAC,18,1,233,31,60,0.517,0,0,NA,31,60,0.517,0.517,14,17,0.824,15,42,57,5,3,1,9,34,76
2014,Ty Lawson,PG,26,DEN,62,61,2222,347,806,0.431,72,202,0.356,275,604,0.455,0.475,324,406,0.798,40,175,215,543,100,10,200,113,1090
2014,Ricky Ledo,SG,21,DAL,11,0,33,6,17,0.353,3,8,0.375,3,9,0.333,0.441,4,4,1,0,2,2,2,1,0,2,2,19
2014,Courtney Lee,SG,28,BOS,30,0,504,90,183,0.492,23,52,0.442,67,131,0.511,0.555,18,22,0.818,8,41,49,32,20,9,25,37,221
2014,Courtney Lee,SG,28,MEM,49,47,1469,205,431,0.476,49,142,0.345,156,289,0.54,0.532,81,90,0.9,21,117,138,83,45,19,48,90,540
2014,David Lee,PF,30,GSW,69,67,2288,513,981,0.523,0,1,0,513,980,0.523,0.523,231,296,0.78,182,461,643,147,48,26,152,206,1257
2014,Alex Len,C,20,PHO,42,3,362,33,78,0.423,0,0,NA,33,78,0.423,0.423,20,31,0.645,39,60,99,4,4,18,26,68,86
2014,Jon Leuer,PF,24,MEM,49,0,642,121,246,0.492,23,49,0.469,98,197,0.497,0.539,37,47,0.787,37,121,158,20,18,13,27,63,302
2014,Rashard Lewis,SF,34,MIA,60,6,971,98,236,0.415,46,134,0.343,52,102,0.51,0.513,26,33,0.788,24,86,110,57,53,8,35,90,268
2014,DeAndre Liggins,SG,25,MIA,1,0,1,1,1,1,0,0,NA,1,1,1,1,0,0,NA,1,0,1,0,0,0,0,0,2
2014,Jeremy Lin,PG,25,HOU,71,33,2054,295,662,0.446,82,229,0.358,213,433,0.492,0.508,218,265,0.823,34,153,187,294,68,27,176,166,890
2014,Shaun Livingston,PG,28,BRK,76,54,1974,235,487,0.483,1,6,0.167,234,481,0.486,0.484,158,191,0.827,67,179,246,245,93,31,105,172,629
2014,Kyle Lowry,PG,27,TOR,79,79,2862,457,1080,0.423,190,500,0.38,267,580,0.46,0.511,313,385,0.813,88,281,369,586,121,15,194,267,1417
2014,Shelvin Mack,PG,23,ATL,73,11,1490,209,501,0.417,62,184,0.337,147,317,0.464,0.479,64,74,0.865,21,139,160,271,50,2,89,100,544
2014,Shawn Marion,SF,35,DAL,76,76,2409,341,708,0.482,58,162,0.358,283,546,0.518,0.523,51,65,0.785,132,365,497,124,90,37,95,125,791
2014,Cartier Martin,SF,29,ATL,53,6,822,106,256,0.414,56,146,0.384,50,110,0.455,0.523,46,61,0.754,12,93,105,31,26,7,33,68,314
2014,Cartier Martin,SF,29,CHI,6,0,48,5,8,0.625,3,5,0.6,2,3,0.667,0.813,2,4,0.5,1,4,5,2,1,0,1,3,15
2014,Kevin Martin,SG,30,MIN,68,68,2177,440,1023,0.43,115,297,0.387,325,726,0.448,0.486,303,340,0.891,34,169,203,121,66,6,106,123,1298
2014,Roger Mason,SG,33,MIA,25,2,260,25,67,0.373,17,48,0.354,8,19,0.421,0.5,7,7,1,1,21,22,19,6,1,9,26,74
2014,Wesley Matthews,SG,27,POR,82,82,2780,445,1009,0.441,201,511,0.393,244,498,0.49,0.541,252,301,0.837,51,238,289,197,76,14,110,176,1343
2014,Eric Maynor,PG,26,WAS,23,0,215,21,72,0.292,8,25,0.32,13,47,0.277,0.347,2,3,0.667,7,17,24,40,5,1,17,13,52
2014,Eric Maynor,PG,26,PHI,8,0,112,11,29,0.379,4,12,0.333,7,17,0.412,0.448,4,8,0.5,2,13,15,12,4,2,12,4,30
2014,Luc Mbah a Moute,SF,27,SAC,9,5,196,15,32,0.469,1,3,0.333,14,29,0.483,0.484,9,13,0.692,9,18,27,15,9,5,4,18,40
2014,Luc Mbah a Moute,PF,27,MIN,55,2,807,72,161,0.447,3,14,0.214,69,147,0.469,0.457,37,54,0.685,47,72,119,21,21,9,36,50,184
2014,Ray McCallum,PG,22,SAC,45,10,897,113,300,0.377,22,59,0.373,91,241,0.378,0.413,32,43,0.744,18,61,79,120,22,9,39,69,280
2014,JaVale McGee,C,26,DEN,5,5,79,17,38,0.447,0,0,NA,17,38,0.447,0.447,1,1,1,10,7,17,2,1,7,8,16,35
2014,Ben McLemore,SG,20,SAC,82,55,2187,255,679,0.376,95,297,0.32,160,382,0.419,0.446,115,143,0.804,53,182,235,82,45,18,96,201,720
2014,Josh McRoberts,PF,26,CHA,78,78,2360,247,566,0.436,105,291,0.361,142,275,0.516,0.529,62,85,0.729,85,288,373,333,58,46,83,189,661
2014,Jodie Meeks,SG,26,LAL,77,70,2556,413,892,0.463,162,404,0.401,251,488,0.514,0.554,221,258,0.857,30,164,194,138,111,4,111,119,1209
2014,C.J. Miles,SG,26,CLE,51,34,984,178,409,0.435,83,211,0.393,95,198,0.48,0.537,64,75,0.853,18,85,103,52,46,15,44,103,503
2014,Andre Miller,SG,37,DEN,30,2,570,66,144,0.458,9,18,0.5,57,126,0.452,0.49,35,47,0.745,16,57,73,100,15,7,33,32,176
2014,Andre Miller,SG,37,WAS,28,0,412,40,87,0.46,2,3,0.667,38,84,0.452,0.471,25,30,0.833,12,45,57,97,19,2,28,43,107
2014,Mike Miller,SF,33,MEM,82,4,1707,213,443,0.481,107,233,0.459,106,210,0.505,0.602,46,56,0.821,30,177,207,130,26,5,77,95,579
2014,Quincy Miller,PF,21,DEN,52,16,789,94,256,0.367,30,94,0.319,64,162,0.395,0.426,39,55,0.709,36,111,147,26,22,32,48,70,257
2014,Nazr Mohammed,C,36,CHI,80,1,562,54,126,0.429,0,0,NA,54,126,0.429,0.429,16,30,0.533,66,109,175,20,14,30,37,77,124
2014,Greg Monroe,PF,23,DET,82,82,2690,504,1015,0.497,0,1,0,504,1014,0.497,0.497,241,367,0.657,256,504,760,171,91,47,166,205,1249
2014,Darius Morris,PG,23,PHI,12,0,193,29,67,0.433,10,24,0.417,19,43,0.442,0.507,15,21,0.714,3,10,13,31,8,0,19,21,83
2014,Darius Morris,PG,23,LAC,10,0,54,4,13,0.308,0,7,0,4,6,0.667,0.308,1,2,0.5,0,5,5,5,2,0,2,9,9
2014,Darius Morris,PG,23,MEM,5,0,66,6,16,0.375,2,7,0.286,4,9,0.444,0.438,1,3,0.333,4,4,8,8,3,0,6,3,15
2014,Marcus Morris,SF,24,PHO,82,1,1800,288,651,0.442,99,260,0.381,189,391,0.483,0.518,121,159,0.761,84,235,319,88,72,18,95,157,796
2014,Markieff Morris,PF,24,PHO,81,0,2153,411,845,0.486,34,108,0.315,377,737,0.512,0.507,259,327,0.792,139,346,485,144,68,51,147,232,1115
2014,Anthony Morrow,SG,28,NOP,76,9,1426,238,520,0.458,88,195,0.451,150,325,0.462,0.542,72,87,0.828,29,111,140,59,38,12,51,102,636
2014,Timofey Mozgov,C,27,DEN,82,30,1770,285,545,0.523,4,24,0.167,281,521,0.539,0.527,196,260,0.754,171,357,528,62,27,100,122,213,770
2014,Shabazz Muhammad,SG,21,MIN,37,0,290,57,124,0.46,3,11,0.273,54,113,0.478,0.472,26,40,0.65,24,29,53,6,8,1,16,24,143
2014,Byron Mullens,C,24,LAC,27,0,167,26,64,0.406,13,39,0.333,13,25,0.52,0.508,2,6,0.333,7,25,32,6,6,3,13,33,67
2014,Byron Mullens,C,24,PHI,18,0,247,47,101,0.465,20,50,0.4,27,51,0.529,0.564,8,14,0.571,17,43,60,8,9,8,14,31,122
2014,Toure' Murry,PG,24,NYK,51,0,373,56,129,0.434,5,12,0.417,51,117,0.436,0.453,23,39,0.59,13,31,44,49,19,1,34,46,140
2014,Mike Muscala,PF,22,ATL,20,0,215,31,73,0.425,0,3,0,31,70,0.443,0.425,14,14,1,17,35,52,7,3,10,12,29,76
2014,Gary Neal,SG,29,MIL,30,2,607,108,277,0.39,40,111,0.36,68,166,0.41,0.462,45,54,0.833,8,42,50,46,7,0,39,26,301
2014,Gary Neal,SG,29,CHA,22,1,507,85,194,0.438,28,69,0.406,57,125,0.456,0.51,49,51,0.961,2,38,40,37,11,0,25,39,247
2014,Jameer Nelson,PG,31,ORL,68,68,2179,294,747,0.394,136,391,0.348,158,356,0.444,0.485,96,112,0.857,29,202,231,476,52,5,166,146,820
2014,Andrew Nicholson,PF,24,ORL,76,5,1174,180,420,0.429,28,89,0.315,152,331,0.459,0.462,47,57,0.825,53,202,255,25,18,23,51,150,435
2014,Steve Novak,PF,30,TOR,54,1,540,60,146,0.411,52,122,0.426,8,24,0.333,0.589,6,6,1,8,50,58,13,12,4,5,44,178
2014,James Nunnally,SF,23,ATL,4,0,54,6,18,0.333,3,10,0.3,3,8,0.375,0.417,3,4,0.75,1,7,8,2,1,1,4,2,18
2014,James Nunnally,SF,23,PHI,9,0,111,9,28,0.321,5,15,0.333,4,13,0.308,0.411,3,5,0.6,0,11,11,6,5,1,3,9,26
2014,Jermaine O'Neal,PF,35,GSW,44,13,883,125,248,0.504,0,0,NA,125,248,0.504,0.504,99,132,0.75,85,157,242,25,14,40,52,102,349
2014,Victor Oladipo,PG,21,ORL,80,44,2487,392,936,0.419,74,226,0.327,318,710,0.448,0.458,248,318,0.78,43,286,329,327,129,37,256,210,1106
2014,Kelly Olynyk,C,22,BOS,70,9,1400,234,502,0.466,40,114,0.351,194,388,0.5,0.506,99,122,0.811,140,225,365,109,35,27,106,227,607
2014,Arinze Onuaku,PF,26,NOP,3,0,25,1,4,0.25,0,0,NA,1,4,0.25,0.25,1,2,0.5,2,5,7,3,0,0,1,3,3
2014,Arinze Onuaku,PF,26,CLE,2,0,5,0,1,0,0,0,NA,0,1,0,0,0,0,NA,0,1,1,0,0,0,0,0,0
2014,Travis Outlaw,SF,29,SAC,63,4,1065,130,326,0.399,41,117,0.35,89,209,0.426,0.462,42,52,0.808,36,132,168,48,20,19,26,94,343
2014,Jannero Pargo,PG,34,CHA,29,0,242,52,118,0.441,24,60,0.4,28,58,0.483,0.542,8,11,0.727,1,19,20,52,14,1,26,17,136
2014,Patrick Patterson,PF,24,SAC,17,6,415,50,122,0.41,9,39,0.231,41,83,0.494,0.447,9,16,0.563,34,65,99,15,13,3,16,39,118
2014,Patrick Patterson,PF,24,TOR,48,7,1118,175,367,0.477,46,112,0.411,129,255,0.506,0.54,41,55,0.745,83,160,243,63,42,34,49,120,437
2014,Kendrick Perkins,C,29,OKC,62,62,1207,87,193,0.451,0,1,0,87,192,0.453,0.451,37,67,0.552,82,223,305,67,26,32,90,177,211
2014,Dexter Pittman,C,25,ATL,2,0,3,0,1,0,0,0,NA,0,1,0,0,0,2,0,3,0,3,0,0,0,0,0,0
2014,Mason Plumlee,C,23,BRK,70,22,1275,199,302,0.659,0,3,0,199,299,0.666,0.659,122,195,0.626,99,209,308,60,49,55,77,171,520
2014,Miles Plumlee,C,25,PHO,80,79,1964,286,553,0.517,0,0,NA,286,553,0.517,0.517,74,132,0.561,198,428,626,43,50,90,111,185,646
2014,Quincy Pondexter,SG,25,MEM,15,2,270,31,79,0.392,11,34,0.324,20,45,0.444,0.462,21,26,0.808,10,16,26,20,5,1,15,18,94
2014,Otto Porter Jr.,SF,20,WAS,37,0,319,33,91,0.363,4,21,0.19,29,70,0.414,0.385,8,12,0.667,21,36,57,10,8,1,14,26,78
2014,Josh Powell,PF,31,HOU,1,0,19,2,6,0.333,0,0,NA,2,6,0.333,0.333,0,0,NA,0,5,5,0,0,1,1,1,4
2014,Phil Pressey,PG,22,BOS,75,11,1132,78,253,0.308,28,106,0.264,50,147,0.34,0.364,29,45,0.644,20,85,105,241,68,5,87,97,213
2014,A.J. Price,SG,27,MIN,28,0,99,19,46,0.413,6,22,0.273,13,24,0.542,0.478,0,2,0,1,9,10,13,1,0,7,5,44
2014,Pablo Prigioni,PG,36,NYK,66,27,1283,88,191,0.461,65,140,0.464,23,51,0.451,0.631,11,12,0.917,36,93,129,228,67,2,60,132,252
2014,Tayshaun Prince,SF,33,MEM,76,76,1948,200,492,0.407,20,69,0.29,180,423,0.426,0.427,34,60,0.567,32,202,234,119,39,19,41,63,454
2014,Anthony Randolph,PF,24,DEN,43,5,527,68,176,0.386,18,61,0.295,50,115,0.435,0.438,52,69,0.754,20,102,122,32,26,19,39,64,206
2014,Shavlik Randolph,PF,30,PHO,14,0,95,7,14,0.5,0,0,NA,7,14,0.5,0.5,6,11,0.545,7,18,25,1,3,1,5,15,20
2014,Zach Randolph,PF,32,MEM,79,79,2705,560,1198,0.467,2,20,0.1,558,1178,0.474,0.468,250,337,0.742,265,530,795,200,54,23,183,210,1372
2014,J.J. Redick,SG,29,LAC,35,34,987,181,398,0.455,73,185,0.395,108,213,0.507,0.546,97,106,0.915,9,65,74,78,28,3,42,65,532
2014,Luke Ridnour,PG,32,MIL,36,12,763,84,219,0.384,25,68,0.368,59,151,0.391,0.441,13,19,0.684,15,47,62,122,23,2,46,55,206
2014,Luke Ridnour,PG,32,CHA,25,2,378,42,108,0.389,12,40,0.3,30,68,0.441,0.444,4,7,0.571,8,27,35,54,9,6,20,37,100
2014,Austin Rivers,PG,21,NOP,69,4,1339,192,474,0.405,36,99,0.364,156,375,0.416,0.443,110,173,0.636,26,103,129,160,45,9,77,134,530
2014,Brian Roberts,PG,28,NOP,72,42,1667,244,581,0.42,64,178,0.36,180,403,0.447,0.475,125,133,0.94,17,119,136,234,43,7,95,132,677
2014,Nate Robinson,PG,29,DEN,44,1,866,164,383,0.428,58,154,0.377,106,229,0.463,0.504,71,85,0.835,21,60,81,112,36,4,58,92,457
2014,Thomas Robinson,PF,22,POR,70,0,873,141,293,0.481,0,1,0,141,292,0.483,0.481,57,101,0.564,105,202,307,34,23,20,57,131,339
2014,Rajon Rondo,PG,27,BOS,30,30,998,141,350,0.403,26,90,0.289,115,260,0.442,0.44,42,67,0.627,22,142,164,294,40,2,99,65,350
2014,Derrick Rose,PG,25,CHI,10,10,311,58,164,0.354,16,47,0.34,42,117,0.359,0.402,27,32,0.844,9,23,32,43,5,1,34,15,159
2014,Terrence Ross,SG,22,TOR,81,62,2159,318,751,0.423,161,408,0.395,157,343,0.458,0.531,82,98,0.837,43,209,252,79,64,27,88,183,879
2014,John Salmons,SF,34,SAC,18,8,445,41,117,0.35,16,42,0.381,25,75,0.333,0.419,7,7,1,8,38,46,44,12,8,14,32,105
2014,John Salmons,SG,34,TOR,60,0,1281,109,296,0.368,47,121,0.388,62,175,0.354,0.448,33,45,0.733,12,105,117,103,35,11,40,92,298
2014,Mike Scott,PF,25,ATL,80,6,1482,301,628,0.479,62,200,0.31,239,428,0.558,0.529,103,132,0.78,62,222,284,75,30,7,79,121,767
2014,Thabo Sefolosha,SG,29,OKC,61,61,1584,141,340,0.415,48,152,0.316,93,188,0.495,0.485,53,69,0.768,50,170,220,94,79,17,55,90,383
2014,Ramon Sessions,PG,27,CHA,55,7,1305,190,465,0.409,15,68,0.221,175,397,0.441,0.425,183,234,0.782,22,95,117,206,33,6,93,50,578
2014,Ramon Sessions,PG,27,MIL,28,12,909,140,304,0.461,20,56,0.357,120,248,0.484,0.493,143,170,0.841,16,70,86,134,16,3,55,40,443
2014,Tornike Shengelia,SF,22,BRK,17,0,137,11,24,0.458,0,6,0,11,18,0.611,0.458,3,8,0.375,4,10,14,12,2,1,11,16,25
2014,Tornike Shengelia,SF,22,CHI,9,0,17,2,4,0.5,0,0,NA,2,4,0.5,0.5,0,0,NA,0,2,2,2,1,0,1,2,4
2014,Iman Shumpert,SG,23,NYK,74,58,1962,183,484,0.378,76,228,0.333,107,256,0.418,0.457,53,71,0.746,81,227,308,129,92,13,79,209,495
2014,Alexey Shved,SG,25,MIN,63,0,664,76,237,0.321,30,102,0.294,46,135,0.341,0.384,68,90,0.756,21,60,81,68,26,16,48,36,250
2014,Henry Sims,C,23,CLE,20,0,168,18,45,0.4,0,0,NA,18,45,0.4,0.4,8,14,0.571,22,34,56,5,5,7,8,32,44
2014,Henry Sims,C,23,PHI,26,25,707,112,229,0.489,0,1,0,112,228,0.491,0.489,82,107,0.766,82,99,181,47,23,13,33,84,306
2014,Kyle Singler,SF,25,DET,82,36,2337,269,602,0.447,94,246,0.382,175,356,0.492,0.525,152,184,0.826,116,187,303,75,61,38,79,211,784
2014,Donald Sloan,SG,26,IND,48,1,392,44,117,0.376,10,42,0.238,34,75,0.453,0.419,12,20,0.6,4,40,44,50,10,1,22,19,110
2014,Ish Smith,PG,25,PHO,70,1,1006,119,281,0.423,1,23,0.043,118,258,0.457,0.425,22,39,0.564,31,98,129,179,49,13,65,66,261
2014,J.R. Smith,SF,28,NYK,74,37,2421,396,955,0.415,189,480,0.394,207,475,0.436,0.514,90,138,0.652,35,261,296,219,65,20,108,196,1071
2014,Jason Smith,PF,27,NOP,31,27,830,131,282,0.465,0,0,NA,131,282,0.465,0.465,39,50,0.78,51,130,181,29,11,29,28,100,301
2014,Josh Smith,SF,28,DET,77,76,2730,517,1233,0.419,70,265,0.264,447,968,0.462,0.448,160,301,0.532,102,418,520,252,105,110,199,197,1264
2014,James Southerland,SF,23,CHA,1,0,3,0,3,0,0,1,0,0,2,0,0,0,0,NA,0,0,0,0,0,0,0,0,0
2014,James Southerland,SF,23,NOP,3,0,27,5,12,0.417,3,5,0.6,2,7,0.286,0.542,1,2,0.5,0,8,8,0,1,2,1,3,14
2014,Marreese Speights,C,26,GSW,79,3,982,195,442,0.441,8,31,0.258,187,411,0.455,0.45,110,134,0.821,101,189,290,32,10,34,66,148,508
2014,Lance Stephenson,SG,23,IND,78,78,2752,427,870,0.491,86,244,0.352,341,626,0.545,0.54,140,197,0.711,95,463,558,359,54,7,210,195,1080
2014,Amar'e Stoudemire,C,31,NYK,65,21,1466,311,558,0.557,0,0,NA,311,558,0.557,0.557,150,203,0.739,112,208,320,34,23,37,91,159,772
2014,Jeff Teague,PG,25,ATL,79,79,2542,456,1040,0.438,74,225,0.329,382,815,0.469,0.474,318,376,0.846,34,174,208,528,89,17,232,158,1304
2014,Marquis Teague,SG,20,CHI,19,2,242,16,66,0.242,2,10,0.2,14,56,0.25,0.258,11,16,0.688,1,18,19,28,2,4,17,25,45
2014,Marquis Teague,SG,20,BRK,21,1,201,22,53,0.415,3,8,0.375,19,45,0.422,0.443,15,19,0.789,0,21,21,30,8,1,22,21,62
2014,Garrett Temple,SG,27,WAS,75,0,638,51,141,0.362,6,29,0.207,45,112,0.402,0.383,30,43,0.698,21,47,68,72,35,11,42,72,138
2014,Hasheem Thabeet,C,26,OKC,23,0,192,13,23,0.565,0,0,NA,13,23,0.565,0.565,1,5,0.2,9,31,40,1,4,9,14,47,27
2014,Adonis Thomas,SF,20,ORL,4,0,24,3,9,0.333,0,3,0,3,6,0.5,0.333,1,1,1,0,3,3,2,0,0,0,2,7
2014,Adonis Thomas,SF,20,PHI,2,1,13,3,5,0.6,1,2,0.5,2,3,0.667,0.7,0,0,NA,0,0,0,1,0,0,1,4,7
2014,Isaiah Thomas,PG,24,SAC,72,54,2497,496,1096,0.453,127,364,0.349,369,732,0.504,0.51,346,407,0.85,47,163,210,454,93,8,213,185,1465
2014,Lance Thomas,SF,25,NOP,5,0,42,2,9,0.222,0,0,NA,2,9,0.222,0.222,2,4,0.5,2,5,7,3,0,0,2,4,6
2014,Malcolm Thomas,PF,25,SAS,1,0,15,1,4,0.25,0,0,NA,1,4,0.25,0.25,0,2,0,1,8,9,0,0,2,1,0,2
2014,Malcolm Thomas,PF,25,UTA,7,0,48,6,12,0.5,1,4,0.25,5,8,0.625,0.542,0,0,NA,4,8,12,2,0,1,8,5,13
2014,Hollis Thompson,SF,22,PHI,77,41,1742,171,372,0.46,67,167,0.401,104,205,0.507,0.55,52,73,0.712,73,174,247,73,53,12,60,144,461
2014,Jason Thompson,PF,27,SAC,82,61,2007,251,496,0.506,0,0,NA,251,496,0.506,0.506,84,145,0.579,153,374,527,53,32,56,95,251,586
2014,Marcus Thornton,SG,26,SAC,46,26,1121,142,373,0.381,57,179,0.318,85,194,0.438,0.457,42,52,0.808,39,85,124,47,31,8,38,74,383
2014,Marcus Thornton,SG,26,BRK,26,1,620,110,266,0.414,52,137,0.38,58,129,0.45,0.511,48,60,0.8,18,56,74,30,27,3,29,36,320
2014,Anthony Tolliver,PF,28,CHA,64,9,1298,129,307,0.42,102,247,0.413,27,60,0.45,0.586,33,41,0.805,33,135,168,42,19,15,23,82,393
2014,P.J. Tucker,SF,28,PHO,81,81,2490,265,615,0.431,74,191,0.387,191,424,0.45,0.491,156,201,0.776,161,368,529,141,110,23,102,204,760
2014,Ronny Turiaf,C,31,MIN,31,10,606,64,107,0.598,0,0,NA,64,107,0.598,0.598,21,50,0.42,55,119,174,24,8,50,24,65,149
2014,Hedo Türkoğlu,SF,34,LAC,38,0,392,42,109,0.385,22,50,0.44,20,59,0.339,0.486,9,18,0.5,11,78,89,33,19,10,16,50,115
2014,Evan Turner,SF,25,PHI,54,54,1886,356,831,0.428,38,132,0.288,318,699,0.455,0.451,189,228,0.829,50,272,322,198,56,5,155,147,939
2014,Evan Turner,SF,25,IND,27,2,571,78,190,0.411,12,24,0.5,66,166,0.398,0.442,24,34,0.706,12,74,86,64,11,2,34,48,192
2014,Jeremy Tyler,C,22,NYK,41,0,398,60,116,0.517,0,0,NA,60,116,0.517,0.517,26,48,0.542,38,71,109,8,6,20,26,70,146
2014,Ekpe Udoh,PF,26,MIL,42,14,804,57,143,0.399,0,0,NA,57,143,0.399,0.399,30,47,0.638,61,87,148,31,15,44,38,96,144
2014,Beno Udrih,SG,31,NYK,31,12,588,68,160,0.425,17,40,0.425,51,120,0.425,0.478,20,24,0.833,10,47,57,110,22,3,42,46,173
2014,Beno Udrih,SG,31,MEM,10,0,55,10,18,0.556,2,2,1,8,16,0.5,0.611,5,6,0.833,0,2,2,6,1,1,5,4,27
2014,Jonas Valančiūnas,C,21,TOR,81,81,2282,359,676,0.531,0,1,0,359,675,0.532,0.531,198,260,0.762,226,488,714,57,24,71,136,249,916
2014,Anderson Varejão,C,31,CLE,65,29,1800,227,459,0.495,0,7,0,227,452,0.502,0.495,92,135,0.681,187,442,629,140,69,39,72,164,546
2014,Jarvis Varnado,PF,25,CHI,1,0,2,0,0,NA,0,0,NA,0,0,NA,NA,0,0,NA,0,0,0,0,0,0,0,1,0
2014,Jarvis Varnado,PF,25,PHI,23,0,337,36,60,0.6,0,0,NA,36,60,0.6,0.6,27,52,0.519,19,44,63,13,10,29,10,61,99
2014,Greivis Vásquez,PG,27,SAC,18,18,465,65,150,0.433,16,50,0.32,49,100,0.49,0.487,30,32,0.938,5,29,34,95,6,1,27,38,176
2014,Greivis Vásquez,PG,27,TOR,61,5,1314,212,508,0.417,93,239,0.389,119,269,0.442,0.509,65,76,0.855,15,124,139,228,25,4,101,105,582
2014,Jan Veselý,PF,23,WAS,33,1,470,48,92,0.522,0,0,NA,48,92,0.522,0.522,8,30,0.267,53,60,113,10,26,19,22,64,104
2014,Jan Veselý,PF,23,DEN,21,0,306,41,81,0.506,0,0,NA,41,81,0.506,0.506,11,26,0.423,28,50,78,11,27,16,14,57,93
2014,Nikola Vučević,C,23,ORL,57,57,1812,353,696,0.507,0,0,NA,353,696,0.507,0.507,105,137,0.766,185,441,626,104,60,47,112,169,811
2014,Sasha Vujačić,SG,29,LAC,2,0,10,2,5,0.4,1,2,0.5,1,3,0.333,0.5,0,0,NA,0,3,3,0,1,0,3,1,5
2014,Dwyane Wade,SG,32,MIA,54,53,1775,415,761,0.545,9,32,0.281,406,729,0.557,0.551,189,258,0.733,60,181,241,252,79,29,161,106,1028
2014,Dion Waiters,SG,22,CLE,70,24,2072,430,993,0.433,92,250,0.368,338,743,0.455,0.479,161,235,0.685,32,163,195,209,63,17,154,153,1113
2014,Gerald Wallace,SF,31,BOS,58,16,1416,116,230,0.504,19,64,0.297,97,166,0.584,0.546,47,101,0.465,36,176,212,143,73,14,97,79,298
2014,Earl Watson,PG,34,POR,24,0,161,3,11,0.273,2,7,0.286,1,4,0.25,0.364,4,4,1,5,10,15,28,5,1,17,33,12
2014,Maalik Wayns,PG,22,LAC,2,0,9,1,2,0.5,0,0,NA,1,2,0.5,0.5,0,0,NA,0,2,2,2,2,0,0,4,2
2014,D.J. White,PF,27,CHA,2,0,10,0,1,0,0,0,NA,0,1,0,0,0,0,NA,0,2,2,0,1,0,0,1,0
2014,Deron Williams,PG,29,BRK,64,58,2059,322,716,0.45,98,268,0.366,224,448,0.5,0.518,173,216,0.801,15,153,168,392,93,13,143,148,915
2014,Derrick Williams,PF,22,MIN,11,0,162,19,54,0.352,2,15,0.133,17,39,0.436,0.37,14,16,0.875,3,23,26,1,4,4,6,9,54
2014,Derrick Williams,SF,22,SAC,67,15,1658,187,428,0.437,24,84,0.286,163,344,0.474,0.465,172,243,0.708,68,229,297,55,44,16,70,105,570
2014,Elliot Williams,SG,24,PHI,67,2,1157,140,337,0.415,37,125,0.296,103,212,0.486,0.47,87,119,0.731,30,100,130,72,35,3,68,126,404
2014,Lou Williams,PG,27,ATL,60,7,1445,197,493,0.4,79,231,0.342,118,262,0.45,0.48,152,179,0.849,10,114,124,210,45,4,92,65,625
2014,Marvin Williams,PF,27,UTA,66,50,1674,231,526,0.439,84,234,0.359,147,292,0.503,0.519,57,73,0.781,82,252,334,78,54,31,53,151,603
2014,Mo Williams,PG,31,POR,74,0,1834,280,672,0.417,83,225,0.369,197,447,0.441,0.478,78,89,0.876,42,111,153,321,55,10,149,197,721
2014,Reggie Williams,SF,27,OKC,3,0,17,5,9,0.556,1,3,0.333,4,6,0.667,0.611,0,0,NA,0,0,0,1,1,0,2,1,11
2014,Shawne Williams,PF,27,LAL,36,13,751,73,192,0.38,42,129,0.326,31,63,0.492,0.49,14,20,0.7,25,142,167,30,19,30,21,93,202
2014,Nate Wolters,PG,22,MIL,58,31,1309,170,389,0.437,18,62,0.29,152,327,0.465,0.46,59,90,0.656,33,116,149,187,35,15,57,67,417
2014,Metta World Peace,SF,34,NYK,29,1,388,56,141,0.397,17,54,0.315,39,87,0.448,0.457,10,16,0.625,18,41,59,17,24,8,19,44,139
2014,Brandan Wright,C,26,DAL,58,0,1077,224,331,0.677,0,0,NA,224,331,0.677,0.677,77,106,0.726,102,142,244,31,32,55,35,94,525
2014,Nick Young,SG,28,LAL,64,9,1810,387,889,0.435,135,350,0.386,252,539,0.468,0.511,235,285,0.825,29,137,166,95,46,12,95,156,1144
2014,Thaddeus Young,PF,25,PHI,79,78,2718,582,1283,0.454,90,292,0.308,492,991,0.496,0.489,163,229,0.712,166,310,476,182,167,36,165,213,1417
2014,Tyler Zeller,C,24,CLE,70,9,1049,156,290,0.538,0,1,0,156,289,0.54,0.538,87,121,0.719,103,179,282,36,18,38,60,137,399
2015,Quincy Acy,PF,24,NYK,68,22,1287,152,331,0.459,18,60,0.3,134,271,0.494,0.486,76,97,0.784,79,222,301,68,27,22,60,147,398
2015,Jeff Adrien,PF,28,MIN,17,0,215,19,44,0.432,0,0,NA,19,44,0.432,0.432,22,38,0.579,23,54,77,15,4,9,9,30,60
2015,Arron Afflalo,SG,29,DEN,53,53,1750,281,657,0.428,82,243,0.337,199,414,0.481,0.49,127,151,0.841,21,159,180,101,32,5,83,108,771
2015,Arron Afflalo,SG,29,POR,25,19,752,94,227,0.414,36,90,0.4,58,137,0.423,0.493,40,47,0.851,6,61,67,28,9,2,33,59,264
2015,Alexis Ajinça,C,26,NOP,68,8,957,181,329,0.55,0,0,NA,181,329,0.55,0.55,81,99,0.818,104,211,315,47,21,51,69,151,443
2015,Cole Aldrich,C,26,NYK,61,16,976,144,301,0.478,0,0,NA,144,301,0.478,0.478,50,64,0.781,101,237,338,75,37,65,59,122,338
2015,LaMarcus Aldridge,PF,29,POR,71,71,2512,659,1415,0.466,37,105,0.352,622,1310,0.475,0.479,306,362,0.845,177,549,726,124,48,68,122,125,1661
2015,Lavoy Allen,C,25,IND,63,0,1070,141,299,0.472,0,0,NA,141,299,0.472,0.472,33,47,0.702,123,200,323,73,15,42,40,102,315
2015,Al-Farouq Aminu,SF,24,DAL,74,3,1366,147,357,0.412,34,124,0.274,113,233,0.485,0.459,84,118,0.712,114,228,342,59,70,62,55,137,412
2015,Lou Amundson,PF,32,CLE,12,0,79,4,12,0.333,0,0,NA,4,12,0.333,0.333,3,5,0.6,5,15,20,5,1,0,5,11,11
2015,Lou Amundson,PF,32,NYK,41,35,858,105,243,0.432,0,1,0,105,242,0.434,0.432,38,82,0.463,89,159,248,65,21,52,57,115,248
2015,Chris Andersen,C,36,MIA,60,20,1132,120,207,0.58,4,13,0.308,116,194,0.598,0.589,76,114,0.667,76,223,299,43,26,61,40,88,320
2015,Ryan Anderson,PF,26,NOP,61,5,1675,291,729,0.399,122,359,0.34,169,370,0.457,0.483,129,151,0.854,108,187,295,55,33,20,62,113,833
2015,Carmelo Anthony,SF,30,NYK,40,40,1428,358,806,0.444,61,179,0.341,297,627,0.474,0.482,189,237,0.797,72,192,264,122,40,17,89,87,966
2015,Joel Anthony,C,32,DET,49,0,406,36,62,0.581,0,0,NA,36,62,0.581,0.581,15,22,0.682,32,61,93,5,12,49,12,55,87
2015,Trevor Ariza,SF,29,HOU,82,82,2930,366,910,0.402,194,555,0.35,172,355,0.485,0.509,122,143,0.853,77,382,459,209,152,17,141,186,1048
2015,Ömer Aşık,C,28,NOP,76,76,1982,213,412,0.517,0,0,NA,213,412,0.517,0.517,131,225,0.582,244,504,748,72,29,54,95,144,557
2015,D.J. Augustin,PG,27,DET,54,13,1287,189,461,0.41,49,150,0.327,140,311,0.45,0.463,147,169,0.87,13,87,100,265,33,2,110,61,574
2015,D.J. Augustin,PG,27,OKC,28,1,677,69,186,0.371,34,96,0.354,35,90,0.389,0.462,31,36,0.861,7,54,61,88,16,1,35,32,203
2015,Luke Babbitt,SF,25,NOP,63,19,830,92,192,0.479,59,115,0.513,33,77,0.429,0.633,13,19,0.684,12,99,111,24,17,11,26,63,256
2015,Leandro Barbosa,SG,32,GSW,66,1,982,183,386,0.474,43,112,0.384,140,274,0.511,0.53,58,74,0.784,23,68,91,99,41,8,44,87,467
2015,Harrison Barnes,SF,22,GSW,82,82,2318,316,656,0.482,87,215,0.405,229,441,0.519,0.548,108,150,0.72,117,336,453,116,61,19,71,146,827
2015,Matt Barnes,SF,34,LAC,76,74,2271,277,624,0.444,136,376,0.362,141,248,0.569,0.553,74,95,0.779,51,251,302,114,67,50,87,240,764
2015,Earl Barron,C,33,PHO,16,1,143,12,39,0.308,2,4,0.5,10,35,0.286,0.333,6,12,0.5,14,14,28,5,4,2,5,26,32
2015,Will Barton,SG,24,POR,30,0,300,38,100,0.38,4,18,0.222,34,82,0.415,0.4,10,15,0.667,3,31,34,27,14,4,17,20,90
2015,Will Barton,SG,24,DEN,28,0,683,112,253,0.443,19,67,0.284,93,186,0.5,0.48,64,79,0.81,23,105,128,54,34,15,44,50,307
2015,Jerryd Bayless,PG,26,MIL,77,4,1717,220,516,0.426,37,120,0.308,183,396,0.462,0.462,121,137,0.883,22,189,211,233,59,12,133,163,598
2015,Kent Bazemore,SG,25,ATL,75,10,1324,141,331,0.426,48,132,0.364,93,199,0.467,0.498,60,100,0.6,21,201,222,78,52,33,73,127,390
2015,Marco Belinelli,SG,28,SAS,62,9,1388,199,470,0.423,86,230,0.374,113,240,0.471,0.515,84,99,0.848,26,131,157,94,31,3,61,85,568
2015,Tarik Black,C,23,HOU,25,12,393,45,83,0.542,0,1,0,45,82,0.549,0.542,15,29,0.517,58,69,127,8,6,2,19,56,105
2015,Tarik Black,C,23,LAL,38,27,803,112,190,0.589,0,0,NA,112,190,0.589,0.589,50,89,0.562,84,157,241,34,13,22,29,102,274
2015,Steve Blake,PG,34,POR,81,0,1529,122,327,0.373,77,219,0.352,45,108,0.417,0.491,29,41,0.707,16,121,137,288,41,5,104,118,350
2015,Eric Bledsoe,PG,25,PHO,81,81,2800,468,1046,0.447,88,272,0.324,380,774,0.491,0.489,353,441,0.8,72,351,423,493,127,45,274,189,1377
2015,Bojan Bogdanović,SF,25,BRK,78,28,1854,261,576,0.453,91,256,0.355,170,320,0.531,0.532,87,106,0.821,50,163,213,68,34,9,78,104,700
2015,Andrew Bogut,C,30,GSW,67,65,1583,200,355,0.563,0,0,NA,200,355,0.563,0.563,22,42,0.524,141,402,543,180,39,113,106,188,422
2015,Trevor Booker,PF,27,UTA,79,5,1564,226,464,0.487,29,84,0.345,197,380,0.518,0.518,86,148,0.581,139,258,397,83,43,41,88,144,567
2015,Avery Bradley,SG,24,BOS,77,77,2428,434,1012,0.429,124,352,0.352,310,660,0.47,0.49,79,100,0.79,46,195,241,135,82,15,109,177,1071
2015,Corey Brewer,SF,28,MIN,24,16,680,94,225,0.418,8,41,0.195,86,184,0.467,0.436,55,78,0.705,32,62,94,78,54,4,50,62,251
2015,Corey Brewer,SF,28,HOU,56,1,1407,249,580,0.429,55,194,0.284,194,386,0.503,0.477,113,148,0.764,48,155,203,95,60,15,81,111,666
2015,Aaron Brooks,PG,30,CHI,82,21,1885,344,817,0.421,121,313,0.387,223,504,0.442,0.495,145,174,0.833,32,134,166,261,54,15,157,189,954
2015,Shannon Brown,SG,29,MIA,5,2,89,7,19,0.368,3,7,0.429,4,12,0.333,0.447,3,4,0.75,0,1,1,3,4,0,4,8,20
2015,Chase Budinger,SF,26,MIN,67,4,1286,169,390,0.433,52,143,0.364,117,247,0.474,0.5,67,81,0.827,33,165,198,64,44,10,49,72,457
2015,Reggie Bullock,SF,23,LAC,25,2,263,23,54,0.426,15,39,0.385,8,15,0.533,0.565,4,5,0.8,0,40,40,6,9,2,6,17,65
2015,Reggie Bullock,SF,23,PHO,11,0,75,1,16,0.063,0,7,0,1,9,0.111,0.063,2,4,0.5,1,9,10,2,1,2,2,2,4
2015,Trey Burke,PG,22,UTA,76,43,2288,370,1005,0.368,124,390,0.318,246,615,0.4,0.43,109,145,0.752,31,173,204,328,65,15,124,119,973
2015,Alec Burks,SG,23,UTA,27,27,899,121,300,0.403,26,68,0.382,95,232,0.409,0.447,106,129,0.822,19,95,114,82,17,5,52,64,374
2015,Caron Butler,SF,34,DET,78,21,1623,161,396,0.407,83,219,0.379,78,177,0.441,0.511,55,61,0.902,21,175,196,79,43,4,49,120,460
2015,Jimmy Butler,SG,25,CHI,65,65,2513,421,912,0.462,73,193,0.378,348,719,0.484,0.502,386,463,0.834,114,265,379,212,114,36,93,108,1301
2015,Rasual Butler,SF,35,WAS,75,1,1505,218,517,0.422,91,235,0.387,127,282,0.45,0.51,53,67,0.791,27,170,197,63,29,22,48,98,580
2015,Bruno Caboclo,SF,19,TOR,8,0,23,4,12,0.333,2,3,0.667,2,9,0.222,0.417,0,0,NA,1,1,2,0,0,1,4,3,10
2015,José Calderón,PG,33,NYK,42,42,1270,147,354,0.415,59,142,0.415,88,212,0.415,0.499,29,32,0.906,19,105,124,198,31,0,75,76,382
2015,Isaiah Canaan,PG,23,HOU,25,9,369,53,131,0.405,32,84,0.381,21,47,0.447,0.527,16,21,0.762,11,22,33,29,14,0,23,28,154
2015,Isaiah Canaan,PG,23,PHI,22,12,569,93,247,0.377,59,162,0.364,34,85,0.4,0.496,33,39,0.846,7,47,54,69,15,3,39,55,278
2015,DeMarre Carroll,SF,28,ATL,70,69,2189,318,653,0.487,120,304,0.395,198,349,0.567,0.579,127,181,0.702,99,273,372,118,94,17,75,154,883
2015,Vince Carter,SG,38,MEM,66,1,1091,135,406,0.333,69,232,0.297,66,174,0.379,0.417,45,57,0.789,27,106,133,79,43,14,43,102,384
2015,Michael Carter-Williams,PG,23,PHI,41,38,1391,232,611,0.38,32,125,0.256,200,486,0.412,0.406,117,182,0.643,43,211,254,302,60,18,174,103,613
2015,Michael Carter-Williams,PG,23,MIL,25,25,758,132,308,0.429,4,28,0.143,128,280,0.457,0.435,85,109,0.78,21,78,99,140,51,12,79,64,353
2015,Omri Casspi,SF,26,SAC,67,19,1416,209,427,0.489,35,87,0.402,174,340,0.512,0.53,140,191,0.733,54,206,260,102,31,9,88,107,593
2015,Mario Chalmers,PG,28,MIA,80,37,2368,267,663,0.403,73,248,0.294,194,415,0.467,0.458,206,266,0.774,24,182,206,307,122,10,173,251,813
2015,Tyson Chandler,C,32,DAL,75,75,2286,293,440,0.666,0,0,NA,293,440,0.666,0.666,185,257,0.72,294,570,864,84,42,91,105,169,771
2015,Wilson Chandler,SF,27,DEN,78,75,2471,418,975,0.429,139,406,0.342,279,569,0.49,0.5,110,142,0.775,96,379,475,134,58,29,110,231,1085
2015,Earl Clark,PF,27,BRK,10,0,93,11,30,0.367,4,14,0.286,7,16,0.438,0.433,1,4,0.25,1,22,23,3,3,4,6,12,27
2015,Ian Clark,SG,23,UTA,23,0,161,15,44,0.341,9,25,0.36,6,19,0.316,0.443,5,5,1,4,9,13,10,6,2,7,12,44
2015,Ian Clark,SG,23,DEN,7,0,31,4,11,0.364,1,5,0.2,3,6,0.5,0.409,4,4,1,0,3,3,2,3,1,2,8,13
2015,Jordan Clarkson,PG,22,LAL,59,38,1476,267,596,0.448,38,121,0.314,229,475,0.482,0.48,131,158,0.829,56,135,191,206,51,12,96,109,703
2015,Norris Cole,PG,26,MIA,47,23,1148,118,306,0.386,27,102,0.265,91,204,0.446,0.43,32,46,0.696,12,96,108,165,42,8,58,75,295
2015,Norris Cole,PG,26,NOP,28,2,683,112,252,0.444,28,74,0.378,84,178,0.472,0.5,26,35,0.743,1,50,51,90,15,7,41,49,278
2015,Bryce Cotton,PG,22,UTA,15,0,159,29,69,0.42,7,20,0.35,22,49,0.449,0.471,15,18,0.833,3,15,18,15,4,0,12,6,80
2015,DeMarcus Cousins,C,24,SAC,59,59,2013,498,1066,0.467,2,8,0.25,496,1058,0.469,0.468,423,541,0.782,185,562,747,210,90,103,254,241,1421
2015,Robert Covington,SF,24,PHI,70,49,1956,299,756,0.396,167,446,0.374,132,310,0.426,0.506,178,217,0.82,65,251,316,105,97,31,128,189,943
2015,Allen Crabbe,SG,22,POR,51,9,683,63,153,0.412,30,85,0.353,33,68,0.485,0.51,12,16,0.75,7,66,73,39,19,15,15,74,168
2015,Jamal Crawford,SG,34,LAC,64,4,1703,332,839,0.396,119,364,0.327,213,475,0.448,0.467,227,252,0.901,18,106,124,158,59,14,92,108,1010
2015,Jae Crowder,SF,24,DAL,25,0,265,33,76,0.434,13,38,0.342,20,38,0.526,0.52,10,11,0.909,12,17,29,12,15,5,10,26,89
2015,Jae Crowder,SF,24,BOS,57,17,1382,196,469,0.418,48,170,0.282,148,299,0.495,0.469,99,130,0.762,60,204,264,82,57,20,39,111,539
2015,Dante Cunningham,PF,27,NOP,66,27,1652,155,339,0.457,1,10,0.1,154,329,0.468,0.459,29,47,0.617,70,186,256,50,46,37,35,101,340
2015,Jared Cunningham,SG,23,LAC,19,0,89,12,33,0.364,4,13,0.308,8,20,0.4,0.424,7,13,0.538,1,8,9,10,3,0,7,12,35
2015,Seth Curry,PG,24,PHO,2,0,8,0,3,0,0,1,0,0,2,0,0,0,0,NA,0,2,2,1,0,0,0,2,0
2015,Troy Daniels,SG,23,HOU,17,0,108,15,47,0.319,13,43,0.302,2,4,0.5,0.457,3,4,0.75,0,6,6,4,0,0,5,14,46
2015,Troy Daniels,SG,23,MIN,19,0,154,19,59,0.322,13,39,0.333,6,20,0.3,0.432,2,2,1,6,13,19,13,3,0,8,14,53
2015,Troy Daniels,SG,23,CHO,11,0,135,27,59,0.458,17,36,0.472,10,23,0.435,0.602,6,7,0.857,2,6,8,5,3,1,7,12,77
2015,Gigi Datome,SF,27,DET,3,0,17,5,12,0.417,1,4,0.25,4,8,0.5,0.458,0,0,NA,1,3,4,2,1,0,2,1,11
2015,Gigi Datome,SF,27,BOS,18,1,192,38,77,0.494,17,36,0.472,21,41,0.512,0.604,1,1,1,2,23,25,7,1,7,7,14,94
2015,Brandon Davies,PF,23,PHI,20,6,379,49,119,0.412,7,30,0.233,42,89,0.472,0.441,21,33,0.636,35,38,73,28,17,4,25,54,126
2015,Brandon Davies,PF,23,BRK,7,0,44,6,18,0.333,1,4,0.25,5,14,0.357,0.361,3,4,0.75,3,7,10,2,1,3,4,5,16
2015,Ed Davis,PF,25,LAL,79,24,1840,282,469,0.601,0,0,NA,282,469,0.601,0.601,92,189,0.487,230,370,600,94,49,98,58,202,656
2015,Glen Davis,PF,29,LAC,74,0,904,117,255,0.459,0,4,0,117,251,0.466,0.459,60,95,0.632,43,126,169,39,41,21,39,132,294
2015,Austin Daye,SF,26,SAS,26,4,268,40,115,0.348,19,57,0.333,21,58,0.362,0.43,4,4,1,6,55,61,9,8,3,18,30,103
2015,Austin Daye,SF,26,ATL,8,0,76,10,26,0.385,5,14,0.357,5,12,0.417,0.481,1,2,0.5,4,10,14,8,4,2,5,9,26
2015,Dewayne Dedmon,C,25,ORL,59,15,845,91,162,0.562,0,1,0,91,161,0.565,0.562,34,64,0.531,118,177,295,9,16,50,51,141,216
2015,Matthew Dellavedova,SG,24,CLE,67,13,1380,111,307,0.362,68,167,0.407,43,140,0.307,0.472,29,38,0.763,37,89,126,204,24,2,61,152,319
2015,Luol Deng,SF,29,MIA,72,72,2421,369,787,0.469,78,220,0.355,291,567,0.513,0.518,191,251,0.761,103,273,376,139,65,22,108,109,1007
2015,Boris Diaw,PF,32,SAS,81,15,1984,291,632,0.46,54,169,0.32,237,463,0.512,0.503,72,93,0.774,78,270,348,233,36,23,126,148,708
2015,Gorgui Dieng,C,25,MIN,73,49,2193,259,512,0.506,1,6,0.167,258,506,0.51,0.507,191,244,0.783,223,386,609,146,71,126,126,188,710
2015,Joey Dorsey,PF,31,HOU,69,17,854,80,145,0.552,0,1,0,80,144,0.556,0.552,24,83,0.289,103,176,279,25,40,25,41,157,184
2015,Toney Douglas,SG,28,NOP,12,0,177,19,51,0.373,5,18,0.278,14,33,0.424,0.422,8,13,0.615,2,20,22,24,11,4,10,20,51
2015,Goran Dragić,SG,28,PHO,52,52,1735,340,679,0.501,66,186,0.355,274,493,0.556,0.549,97,130,0.746,51,134,185,211,50,9,114,120,843
2015,Goran Dragić,PG,28,MIA,26,26,905,162,323,0.502,24,73,0.329,138,250,0.552,0.539,84,104,0.808,30,59,89,139,28,6,59,75,432
2015,Zoran Dragić,SG,25,PHO,6,0,13,2,8,0.25,0,5,0,2,3,0.667,0.25,2,3,0.667,2,1,3,1,0,0,0,1,6
2015,Zoran Dragić,SG,25,MIA,10,1,62,9,22,0.409,3,9,0.333,6,13,0.462,0.477,1,2,0.5,3,2,5,4,2,0,5,5,22
2015,Larry Drew II,PG,24,PHI,12,1,219,20,58,0.345,4,26,0.154,16,32,0.5,0.379,2,3,0.667,1,14,15,45,6,0,25,13,46
2015,Andre Drummond,C,21,DET,82,82,2502,494,961,0.514,0,2,0,494,959,0.515,0.514,142,365,0.389,437,667,1104,55,73,153,120,285,1130
2015,Jared Dudley,SG,29,MIL,72,22,1717,198,423,0.468,74,192,0.385,124,231,0.537,0.556,48,67,0.716,45,175,220,130,72,11,62,113,518
2015,Mike Dunleavy,SF,34,CHI,63,63,1838,209,481,0.435,107,263,0.407,102,218,0.468,0.546,70,87,0.805,28,220,248,114,39,21,60,123,595
2015,Wayne Ellington,SG,27,LAL,65,36,1675,254,617,0.412,90,243,0.37,164,374,0.439,0.485,52,64,0.813,31,179,210,105,33,2,50,77,650
2015,Monta Ellis,SG,29,DAL,80,80,2699,602,1354,0.445,81,284,0.285,521,1070,0.487,0.475,228,303,0.752,34,156,190,329,148,25,198,197,1513
2015,James Ennis III,SF,24,MIA,62,3,1051,101,247,0.409,31,95,0.326,70,152,0.461,0.472,79,94,0.84,51,125,176,48,25,17,39,89,312
2015,Tyler Ennis,PG,20,PHO,8,0,58,9,21,0.429,2,6,0.333,7,15,0.467,0.476,2,2,1,1,6,7,14,0,2,8,3,22
2015,Tyler Ennis,PG,20,MIL,25,1,353,43,123,0.35,10,37,0.27,33,86,0.384,0.39,3,5,0.6,6,22,28,59,18,3,34,33,99
2015,Reggie Evans,PF,34,SAC,47,7,764,58,137,0.423,0,2,0,58,135,0.43,0.423,60,97,0.619,97,202,299,32,22,5,45,91,176
2015,Tyreke Evans,SG,25,NOP,79,76,2690,521,1165,0.447,69,227,0.304,452,938,0.482,0.477,202,291,0.694,82,334,416,521,100,37,246,198,1313
2015,Dante Exum,PG,19,UTA,82,41,1817,145,416,0.349,83,264,0.314,62,152,0.408,0.448,20,32,0.625,27,104,131,198,41,14,118,147,393
2015,Kenneth Faried,PF,25,DEN,75,71,2086,373,736,0.507,1,8,0.125,372,728,0.511,0.507,199,288,0.691,242,426,668,89,62,57,118,211,946
2015,Derrick Favors,PF,23,UTA,74,74,2280,482,918,0.525,1,6,0.167,481,912,0.527,0.526,222,332,0.669,196,411,607,112,60,123,121,210,1187
2015,Raymond Felton,PG,30,DAL,29,3,281,43,106,0.406,10,34,0.294,33,72,0.458,0.453,12,15,0.8,2,24,26,41,11,4,18,17,108
2015,Evan Fournier,SG,22,ORL,58,32,1661,253,575,0.44,85,225,0.378,168,350,0.48,0.514,107,147,0.728,28,125,153,120,40,2,82,116,698
2015,Randy Foye,SG,31,DEN,50,21,1087,148,402,0.368,94,263,0.357,54,139,0.388,0.485,45,55,0.818,9,76,85,119,34,11,60,97,435
2015,Tim Frazier,PG,24,PHI,6,3,171,13,43,0.302,3,11,0.273,10,32,0.313,0.337,5,15,0.333,4,15,19,43,6,0,18,16,34
2015,Tim Frazier,PG,24,POR,5,0,68,8,18,0.444,2,6,0.333,6,12,0.5,0.5,5,6,0.833,2,7,9,17,2,0,7,10,23
2015,Jimmer Fredette,PG,25,NOP,50,0,509,63,166,0.38,9,48,0.188,54,118,0.458,0.407,43,45,0.956,8,32,40,58,15,2,33,43,178
2015,Enes Freedom,C,22,UTA,49,48,1326,286,582,0.491,13,41,0.317,273,541,0.505,0.503,93,118,0.788,147,237,384,26,23,16,93,114,678
2015,Enes Freedom,C,22,OKC,26,26,809,196,346,0.566,3,4,0.75,193,342,0.564,0.571,90,116,0.776,130,157,287,29,13,13,52,75,485
2015,Channing Frye,PF,31,ORL,75,51,1870,191,487,0.392,136,346,0.393,55,141,0.39,0.532,31,35,0.886,27,266,293,94,47,39,78,191,549
2015,Danilo Gallinari,SF,26,DEN,59,27,1426,228,568,0.401,107,301,0.355,121,267,0.453,0.496,171,191,0.895,31,187,218,83,47,20,57,94,734
2015,Langston Galloway,PG,23,NYK,45,41,1457,204,511,0.399,62,176,0.352,142,335,0.424,0.46,63,78,0.808,37,153,190,150,52,12,61,129,533
2015,Francisco García,SF,33,HOU,14,0,200,17,63,0.27,10,45,0.222,7,18,0.389,0.349,1,4,0.25,3,14,17,15,9,5,10,20,45
2015,Kevin Garnett,PF,38,BRK,42,42,854,125,275,0.455,1,6,0.167,124,269,0.461,0.456,34,41,0.829,46,239,285,69,41,13,45,96,285
2015,Kevin Garnett,PF,38,MIN,5,5,98,18,31,0.581,0,1,0,18,30,0.6,0.581,2,4,0.5,2,24,26,8,5,4,1,13,38
2015,Marc Gasol,C,30,MEM,81,81,2687,530,1072,0.494,3,17,0.176,527,1055,0.5,0.496,350,440,0.795,115,515,630,307,70,131,176,208,1413
2015,Pau Gasol,PF,34,CHI,78,78,2681,570,1153,0.494,12,26,0.462,558,1127,0.495,0.5,294,366,0.803,220,699,919,210,25,147,158,147,1446
2015,Rudy Gay,SF,28,SAC,68,67,2408,508,1116,0.455,79,220,0.359,429,896,0.479,0.491,337,393,0.858,98,301,399,250,71,41,183,157,1432
2015,Alonzo Gee,SF,27,DEN,39,0,511,66,137,0.482,10,24,0.417,56,113,0.496,0.518,48,65,0.738,29,41,70,19,28,6,25,42,190
2015,Alonzo Gee,SF,27,POR,15,2,151,21,49,0.429,3,11,0.273,18,38,0.474,0.459,6,12,0.5,8,16,24,6,7,1,8,16,51
2015,Taj Gibson,PF,29,CHI,62,17,1692,254,506,0.502,0,0,NA,254,506,0.502,0.502,132,184,0.717,162,234,396,71,36,75,77,162,640
2015,Drew Gooden,PF,33,WAS,51,7,864,110,276,0.399,23,59,0.39,87,217,0.401,0.44,34,44,0.773,72,151,223,49,21,9,28,91,277
2015,Archie Goodwin,SG,20,PHO,41,2,535,79,201,0.393,12,41,0.293,67,160,0.419,0.423,61,83,0.735,27,47,74,44,18,9,48,55,231
2015,Aaron Gordon,PF,19,ORL,47,8,797,93,208,0.447,13,48,0.271,80,160,0.5,0.478,44,61,0.721,46,123,169,33,21,22,38,83,243
2015,Marcin Gortat,C,30,WAS,82,82,2453,439,775,0.566,0,3,0,439,772,0.569,0.566,123,175,0.703,180,537,717,97,49,110,100,191,1001
2015,Danny Granger,SF,31,MIA,30,6,613,65,162,0.401,30,84,0.357,35,78,0.449,0.494,28,37,0.757,20,60,80,17,13,6,24,67,188
2015,Jerami Grant,SF,20,PHI,65,11,1377,124,352,0.352,49,156,0.314,75,196,0.383,0.422,114,193,0.591,49,149,198,79,40,68,85,144,411
2015,Erick Green,PG,23,DEN,43,1,410,61,162,0.377,14,47,0.298,47,115,0.409,0.42,10,12,0.833,7,24,31,39,12,0,14,26,146
2015,Gerald Green,SG,29,PHO,74,4,1446,324,778,0.416,137,387,0.354,187,391,0.478,0.504,99,120,0.825,33,153,186,91,42,12,104,145,884
2015,JaMychal Green,PF,24,SAS,4,0,25,4,7,0.571,0,2,0,4,5,0.8,0.571,0,0,NA,3,3,6,0,0,2,2,6,8
2015,JaMychal Green,PF,24,MEM,20,1,139,23,40,0.575,0,4,0,23,36,0.639,0.575,8,10,0.8,16,23,39,4,5,3,12,19,54
2015,Jeff Green,SF,28,BOS,33,33,1093,206,475,0.434,47,154,0.305,159,321,0.495,0.483,121,144,0.84,21,120,141,53,27,13,56,66,580
2015,Jeff Green,SF,28,MEM,45,37,1361,210,492,0.427,50,138,0.362,160,354,0.452,0.478,118,143,0.825,43,144,187,81,26,21,52,81,588
2015,Blake Griffin,PF,25,LAC,67,67,2356,574,1144,0.502,10,25,0.4,564,1119,0.504,0.506,311,427,0.728,126,382,508,354,63,35,152,196,1469
2015,Jorge Gutiérrez,PG,26,BRK,10,0,44,7,14,0.5,0,1,0,7,13,0.538,0.5,2,3,0.667,0,7,7,7,1,0,3,9,16
2015,Jorge Gutiérrez,PG,26,MIL,10,1,131,15,27,0.556,0,2,0,15,25,0.6,0.556,7,10,0.7,5,13,18,15,5,0,9,16,37
2015,P.J. Hairston,SG,22,CHO,45,2,687,87,269,0.323,49,163,0.301,38,106,0.358,0.414,31,36,0.861,22,70,92,21,21,13,22,61,254
2015,Jordan Hamilton,SF,24,LAC,14,2,122,14,35,0.4,10,21,0.476,4,14,0.286,0.543,0,0,NA,2,14,16,7,2,0,4,14,38
2015,Justin Hamilton,C,24,MIA,24,5,289,27,65,0.415,6,19,0.316,21,46,0.457,0.462,6,7,0.857,24,24,48,12,8,5,8,33,66
2015,Justin Hamilton,C,24,MIN,17,9,423,58,113,0.513,4,12,0.333,54,101,0.535,0.531,33,40,0.825,33,53,86,24,19,25,18,37,153
2015,Tim Hardaway Jr.,SG,22,NYK,70,30,1681,279,717,0.389,121,354,0.342,158,363,0.435,0.474,125,156,0.801,12,144,156,127,20,14,82,119,804
2015,James Harden,SG,25,HOU,81,81,2981,647,1470,0.44,208,555,0.375,439,915,0.48,0.511,715,824,0.868,75,384,459,565,154,60,321,208,2217
2015,Maurice Harkless,SF,21,ORL,45,4,674,63,158,0.399,10,56,0.179,53,102,0.52,0.43,22,41,0.537,38,68,106,25,32,9,27,66,158
2015,Devin Harris,PG,31,DAL,76,3,1685,219,524,0.418,95,266,0.357,124,258,0.481,0.509,132,162,0.815,13,122,135,237,78,14,85,147,665
2015,Gary Harris,SG,20,DEN,55,6,719,66,217,0.304,21,103,0.204,45,114,0.395,0.353,35,47,0.745,21,43,64,29,39,7,38,71,188
2015,Tobias Harris,SF,22,ORL,68,63,2369,442,949,0.466,87,239,0.364,355,710,0.5,0.512,193,245,0.788,73,357,430,124,69,36,115,134,1164
2015,Spencer Hawes,PF,26,LAC,73,15,1274,163,415,0.393,55,176,0.313,108,239,0.452,0.459,44,68,0.647,30,228,258,88,24,53,61,173,425
2015,Chuck Hayes,C,31,TOR,29,0,255,22,46,0.478,0,0,NA,22,46,0.478,0.478,6,11,0.545,18,33,51,20,10,4,8,37,50
2015,Brendan Haywood,C,35,CLE,22,1,119,14,30,0.467,0,0,NA,14,30,0.467,0.467,7,13,0.538,6,23,29,2,2,10,10,17,35
2015,Gerald Henderson,SG,27,CHO,80,72,2315,370,847,0.437,45,136,0.331,325,711,0.457,0.463,184,217,0.848,36,237,273,206,51,22,110,135,969
2015,John Henson,C,24,MIL,67,11,1228,196,346,0.566,0,0,NA,196,346,0.566,0.566,78,137,0.569,124,188,312,59,28,135,87,152,470
2015,Roy Hibbert,C,28,IND,76,76,1926,317,710,0.446,0,2,0,317,708,0.448,0.446,168,204,0.824,156,384,540,84,18,125,107,216,802
2015,J.J. Hickson,C,26,DEN,73,8,1411,218,459,0.475,0,2,0,218,457,0.477,0.475,116,201,0.577,150,302,452,57,36,35,96,136,552
2015,Nenê,PF,32,WAS,67,58,1693,307,601,0.511,1,5,0.2,306,596,0.513,0.512,122,202,0.604,84,261,345,123,66,22,124,180,737
2015,George Hill,PG,28,IND,43,36,1267,255,535,0.477,69,193,0.358,186,342,0.544,0.541,113,143,0.79,25,154,179,220,44,14,69,111,692
2015,Jordan Hill,C,27,LAL,70,57,1874,357,777,0.459,3,11,0.273,354,766,0.462,0.461,124,168,0.738,174,382,556,103,34,52,106,164,841
2015,Solomon Hill,SF,23,IND,82,78,2381,251,634,0.396,68,208,0.327,183,426,0.43,0.45,159,193,0.824,70,244,314,184,66,18,115,177,729
2015,Kirk Hinrich,SG,34,CHI,66,22,1610,142,381,0.373,58,168,0.345,84,213,0.394,0.449,35,50,0.7,20,101,121,148,46,14,73,144,377
2015,Justin Holiday,SG,25,GSW,59,4,657,91,235,0.387,35,109,0.321,56,126,0.444,0.462,37,45,0.822,12,61,73,48,40,12,29,54,254
2015,Ryan Hollins,C,30,SAC,46,9,441,53,82,0.646,0,0,NA,53,82,0.646,0.646,31,54,0.574,36,67,103,14,6,19,25,65,137
2015,Rodney Hood,SG,22,UTA,50,21,1064,155,374,0.414,62,170,0.365,93,204,0.456,0.497,61,80,0.763,9,108,117,83,30,12,45,119,433
2015,Lester Hudson,SG,30,LAC,5,0,56,6,14,0.429,3,6,0.5,3,8,0.375,0.536,3,4,0.75,1,7,8,5,6,1,3,4,18
2015,Kris Humphries,PF,29,WAS,64,17,1345,211,446,0.473,0,7,0,211,439,0.481,0.473,87,117,0.744,118,298,416,57,34,25,46,130,509
2015,Serge Ibaka,PF,25,OKC,64,64,2116,374,786,0.476,77,205,0.376,297,581,0.511,0.525,92,110,0.836,135,364,499,55,30,155,97,194,917
2015,Ersan İlyasova,PF,27,MIL,58,36,1319,263,557,0.472,74,190,0.389,189,367,0.515,0.539,69,107,0.645,80,197,277,56,36,19,45,149,669
2015,Jarrett Jack,PG,31,BRK,80,27,2241,359,817,0.439,39,146,0.267,320,671,0.477,0.463,200,227,0.881,19,226,245,373,75,13,191,143,957
2015,Reggie Jackson,PG,24,OKC,50,13,1398,249,576,0.432,44,158,0.278,205,418,0.49,0.47,99,115,0.861,28,173,201,214,42,5,91,94,641
2015,Reggie Jackson,PG,24,DET,27,27,870,183,420,0.436,28,83,0.337,155,337,0.46,0.469,82,103,0.796,28,98,126,248,20,4,95,73,476
2015,Richard Jefferson,SF,34,DAL,74,18,1244,144,324,0.444,66,155,0.426,78,169,0.462,0.546,78,114,0.684,25,158,183,61,32,11,52,115,432
2015,John Jenkins,SG,23,ATL,24,3,297,49,99,0.495,21,52,0.404,28,47,0.596,0.601,16,19,0.842,2,37,39,13,10,0,8,15,135
2015,Brandon Jennings,PG,25,DET,41,41,1173,218,543,0.401,76,211,0.36,142,332,0.428,0.471,120,143,0.839,21,83,104,272,44,4,90,64,632
2015,Jonas Jerebko,PF,27,DET,46,0,703,91,198,0.46,28,76,0.368,63,122,0.516,0.53,31,36,0.861,47,95,142,41,27,11,26,77,241
2015,Jonas Jerebko,PF,27,BOS,29,0,527,78,181,0.431,26,64,0.406,52,117,0.444,0.503,25,30,0.833,46,94,140,30,19,7,18,58,207
2015,Grant Jerrett,PF,21,OKC,5,0,25,3,17,0.176,1,13,0.077,2,4,0.5,0.206,0,0,NA,1,3,4,1,0,2,2,7,7
2015,Grant Jerrett,PF,21,UTA,3,0,26,4,9,0.444,0,2,0,4,7,0.571,0.444,1,1,1,1,4,5,2,2,0,1,4,9
2015,Chris Johnson,SF,24,PHI,9,2,187,19,60,0.317,10,39,0.256,9,21,0.429,0.4,6,8,0.75,3,23,26,3,9,5,9,19,54
2015,Chris Johnson,SF,24,UTA,12,0,211,31,64,0.484,13,38,0.342,18,26,0.692,0.586,6,6,1,3,15,18,7,12,0,6,18,81
2015,Chris Johnson,SF,24,MIL,8,0,128,12,30,0.4,5,18,0.278,7,12,0.583,0.483,2,2,1,2,9,11,5,5,2,0,7,31
2015,James Johnson,PF,27,TOR,70,17,1370,238,404,0.589,11,51,0.216,227,353,0.643,0.603,67,102,0.657,61,196,257,95,54,70,79,155,554
2015,Joe Johnson,SG,33,BRK,80,80,2791,446,1025,0.435,121,337,0.359,325,688,0.472,0.494,141,176,0.801,53,331,384,292,59,14,137,120,1154
2015,Tyler Johnson,SG,22,MIA,32,2,603,70,167,0.419,18,48,0.375,52,119,0.437,0.473,32,47,0.681,14,67,81,42,33,9,30,42,190
2015,Wesley Johnson,SF,27,LAL,76,59,2245,286,691,0.414,91,259,0.351,195,432,0.451,0.48,90,112,0.804,67,252,319,124,59,45,87,162,753
2015,Dahntay Jones,SF,34,LAC,33,0,123,6,21,0.286,0,4,0,6,17,0.353,0.286,9,11,0.818,1,10,11,2,3,0,1,23,21
2015,Terrence Jones,PF,23,HOU,33,24,889,158,299,0.528,13,37,0.351,145,262,0.553,0.55,57,94,0.606,78,142,220,36,18,59,37,78,386
2015,DeAndre Jordan,C,26,LAC,82,82,2820,379,534,0.71,1,4,0.25,378,530,0.713,0.711,187,471,0.397,397,829,1226,61,81,183,109,245,946
2015,Cory Joseph,PG,23,SAS,79,14,1444,207,411,0.504,16,44,0.364,191,367,0.52,0.523,105,143,0.734,44,148,192,188,46,17,67,105,535
2015,Michael Kidd-Gilchrist,SF,21,CHO,55,52,1587,224,482,0.465,0,0,NA,224,482,0.465,0.465,150,214,0.701,109,307,416,77,30,38,63,115,598
2015,Sean Kilpatrick,SG,25,MIN,4,0,72,7,20,0.35,4,13,0.308,3,7,0.429,0.45,4,4,1,1,5,6,4,3,0,2,3,22
2015,Brandon Knight,PG,23,MIL,52,52,1688,324,745,0.435,104,254,0.409,220,491,0.448,0.505,171,194,0.881,26,195,221,281,84,9,166,93,923
2015,Brandon Knight,SG,23,PHO,11,9,347,51,143,0.357,21,67,0.313,30,76,0.395,0.43,24,29,0.828,2,21,23,49,6,1,23,21,147
2015,Kyle Korver,SG,33,ATL,75,75,2418,292,600,0.487,221,449,0.492,71,151,0.47,0.671,106,118,0.898,15,289,304,196,52,42,107,140,911
2015,Kosta Koufos,C,25,MEM,81,3,1348,182,358,0.508,0,0,NA,182,358,0.508,0.508,55,85,0.647,121,305,426,37,29,63,69,148,419
2015,Carl Landry,PF,31,SAC,70,15,1192,190,369,0.515,0,0,NA,190,369,0.515,0.515,123,150,0.82,99,169,268,26,15,17,54,132,503
2015,Joffrey Lauvergne,C,23,DEN,24,1,268,36,89,0.404,3,16,0.188,33,73,0.452,0.421,18,28,0.643,27,50,77,13,8,10,22,43,93
2015,Ty Lawson,PG,27,DEN,75,75,2665,404,926,0.436,70,205,0.341,334,721,0.463,0.474,265,363,0.73,42,192,234,720,92,9,185,128,1143
2015,Ricky Ledo,SG,22,DAL,5,0,11,0,6,0,0,3,0,0,3,0,0,1,2,0.5,1,1,2,1,0,0,2,1,1
2015,Ricky Ledo,SG,22,NYK,12,0,233,32,90,0.356,10,24,0.417,22,66,0.333,0.411,15,20,0.75,15,19,34,18,6,1,24,20,89
2015,Courtney Lee,SG,29,MEM,77,74,2354,288,643,0.448,90,224,0.402,198,419,0.473,0.518,111,129,0.86,21,157,178,151,75,12,78,129,777
2015,David Lee,PF,31,GSW,49,4,904,160,313,0.511,0,2,0,160,311,0.514,0.511,68,104,0.654,81,176,257,85,31,26,49,83,388
2015,Alex Len,C,21,PHO,69,44,1518,179,353,0.507,1,3,0.333,178,350,0.509,0.508,73,104,0.702,142,312,454,32,34,105,74,213,432
2015,Jon Leuer,PF,25,MEM,63,6,824,121,273,0.443,7,29,0.241,114,244,0.467,0.456,37,59,0.627,50,157,207,46,17,9,35,86,286
2015,Jeremy Lin,PG,26,LAL,74,30,1907,277,654,0.424,65,176,0.369,212,478,0.444,0.473,213,268,0.795,26,170,196,339,82,32,166,189,832
2015,Shaun Livingston,PG,29,GSW,78,2,1468,198,396,0.5,0,2,0,198,394,0.503,0.5,65,91,0.714,43,140,183,259,49,20,102,110,461
2015,Kyle Lowry,PG,28,TOR,70,70,2414,430,1043,0.412,132,391,0.338,298,652,0.457,0.476,252,312,0.808,54,274,328,473,109,13,173,212,1244
2015,Shelvin Mack,PG,24,ATL,55,0,833,117,292,0.401,40,127,0.315,77,165,0.467,0.469,25,31,0.806,8,71,79,155,30,2,49,32,299
2015,Shawn Marion,SF,36,CLE,57,24,1101,119,267,0.446,12,46,0.261,107,221,0.484,0.468,26,34,0.765,64,138,202,51,27,27,33,58,276
2015,Cartier Martin,SF,30,DET,23,0,198,15,53,0.283,6,33,0.182,9,20,0.45,0.34,0,0,NA,0,20,20,11,3,1,5,20,36
2015,Kevin Martin,SG,31,MIN,39,36,1302,267,625,0.427,75,191,0.393,192,434,0.442,0.487,170,193,0.881,19,123,142,89,33,1,76,76,779
2015,Wesley Matthews,SG,28,POR,60,60,2024,337,752,0.448,173,445,0.389,164,307,0.534,0.563,109,145,0.752,38,184,222,139,77,10,81,132,956
2015,Luc Mbah a Moute,PF,28,PHI,67,61,1916,251,636,0.395,62,202,0.307,189,434,0.435,0.443,96,163,0.589,82,246,328,106,81,21,99,104,660
2015,Ray McCallum,PG,23,SAC,68,30,1436,206,470,0.438,34,111,0.306,172,359,0.479,0.474,57,84,0.679,52,128,180,188,45,11,85,92,503
2015,K.J. McDaniels,SG,21,PHI,52,15,1319,167,419,0.399,43,147,0.293,124,272,0.456,0.45,99,131,0.756,64,131,195,70,44,68,104,121,476
2015,K.J. McDaniels,SG,21,HOU,10,0,33,5,15,0.333,0,3,0,5,12,0.417,0.333,1,2,0.5,1,4,5,2,0,2,1,5,11
2015,Doug McDermott,SF,23,CHI,36,0,321,43,107,0.402,13,41,0.317,30,66,0.455,0.463,10,15,0.667,6,37,43,6,4,1,17,29,109
2015,JaVale McGee,C,27,DEN,17,0,195,34,61,0.557,0,0,NA,34,61,0.557,0.557,20,29,0.69,14,34,48,1,2,19,13,28,88
2015,JaVale McGee,C,27,PHI,6,0,61,8,18,0.444,0,0,NA,8,18,0.444,0.444,2,4,0.5,4,9,13,2,0,1,5,2,18
2015,Ben McLemore,SG,21,SAC,82,82,2670,363,831,0.437,140,391,0.358,223,440,0.507,0.521,130,160,0.813,31,210,241,140,77,19,138,219,996
2015,Josh McRoberts,PF,27,MIA,17,4,296,28,53,0.528,8,19,0.421,20,34,0.588,0.604,8,13,0.615,7,38,45,33,12,3,22,41,72
2015,Jodie Meeks,SG,27,DET,60,0,1462,222,534,0.416,74,212,0.349,148,322,0.46,0.485,145,160,0.906,12,92,104,79,59,6,57,76,663
2015,C.J. Miles,SG,27,IND,70,40,1841,329,827,0.398,154,446,0.345,175,381,0.459,0.491,130,161,0.807,18,196,214,75,60,26,73,132,942
2015,Andre Miller,PG,38,WAS,51,0,631,77,142,0.542,1,8,0.125,76,134,0.567,0.546,28,39,0.718,21,56,77,143,14,2,46,56,183
2015,Andre Miller,PG,38,SAC,30,0,622,68,148,0.459,6,26,0.231,62,122,0.508,0.48,30,38,0.789,16,60,76,141,18,4,58,47,172
2015,Mike Miller,SF,34,CLE,52,15,701,37,114,0.325,32,98,0.327,5,16,0.313,0.465,3,4,0.75,4,87,91,46,14,4,23,74,109
2015,Quincy Miller,PF,22,SAC,6,0,61,4,18,0.222,1,7,0.143,3,11,0.273,0.25,8,11,0.727,2,10,12,3,6,3,3,4,17
2015,Quincy Miller,PF,22,DET,4,0,58,5,20,0.25,2,11,0.182,3,9,0.333,0.3,0,0,NA,2,6,8,5,1,2,2,5,12
2015,Nikola Mirotić,PF,23,CHI,82,3,1654,253,624,0.405,99,313,0.316,154,311,0.495,0.485,228,284,0.803,63,341,404,97,54,54,89,172,833
2015,Nazr Mohammed,C,37,CHI,23,0,128,13,30,0.433,0,0,NA,13,30,0.433,0.433,1,3,0.333,11,27,38,3,4,5,7,16,27
2015,Greg Monroe,PF,24,DET,69,57,2137,423,853,0.496,0,0,NA,423,853,0.496,0.496,252,336,0.75,229,475,704,142,78,34,149,148,1098
2015,Eric Moreland,PF,23,SAC,3,0,2,1,1,1,0,0,NA,1,1,1,1,0,0,NA,0,1,1,0,0,0,0,1,2
2015,Darius Morris,PG,24,BRK,38,0,299,36,106,0.34,7,33,0.212,29,73,0.397,0.373,4,9,0.444,7,20,27,48,9,0,21,20,83
2015,Marcus Morris,PF,25,PHO,81,35,2045,331,763,0.434,112,313,0.358,219,450,0.487,0.507,71,113,0.628,73,312,385,133,63,16,73,188,845
2015,Markieff Morris,PF,25,PHO,82,82,2581,512,1100,0.465,57,179,0.318,455,921,0.494,0.491,177,232,0.763,110,396,506,192,101,39,170,245,1258
2015,Anthony Morrow,SG,29,OKC,74,0,1806,285,615,0.463,141,325,0.434,144,290,0.497,0.578,79,89,0.888,40,155,195,60,54,11,38,135,790
2015,Timofey Mozgov,C,28,DEN,35,35,897,117,232,0.504,2,6,0.333,115,226,0.509,0.509,63,86,0.733,91,181,272,16,15,41,47,114,299
2015,Timofey Mozgov,C,28,CLE,46,45,1148,197,334,0.59,0,0,NA,197,334,0.59,0.59,92,130,0.708,112,207,319,39,18,56,69,113,486
2015,Shabazz Muhammad,SG,22,MIN,38,13,866,194,397,0.489,20,51,0.392,174,346,0.503,0.514,104,145,0.717,63,91,154,44,18,7,35,49,512
2015,Toure' Murry,PG,25,UTA,1,0,1,0,1,0,0,0,NA,0,1,0,0,0,0,NA,0,0,0,0,0,0,0,0,0
2015,Toure' Murry,SG,25,WAS,4,0,17,2,4,0.5,0,0,NA,2,4,0.5,0.5,2,2,1,1,0,1,1,1,0,4,2,6
2015,Mike Muscala,PF,23,ATL,40,8,502,83,151,0.55,9,22,0.409,74,129,0.574,0.579,22,25,0.88,52,67,119,25,16,19,21,52,197
2015,Shabazz Napier,PG,23,MIA,51,10,1012,87,228,0.382,43,118,0.364,44,110,0.4,0.476,44,56,0.786,17,96,113,130,40,4,81,76,261
2015,Gary Neal,SG,30,CHO,43,0,931,143,398,0.359,39,133,0.293,104,265,0.392,0.408,88,102,0.863,14,80,94,80,16,1,55,70,413
2015,Gary Neal,SG,30,MIN,11,1,262,45,105,0.429,11,31,0.355,34,74,0.459,0.481,29,33,0.879,0,35,35,20,7,0,10,18,130
2015,Jameer Nelson,PG,32,DAL,23,23,584,61,163,0.374,38,103,0.369,23,60,0.383,0.491,7,8,0.875,14,49,63,95,15,2,39,53,167
2015,Jameer Nelson,PG,32,BOS,6,1,121,9,41,0.22,5,25,0.2,4,16,0.25,0.28,6,9,0.667,3,14,17,33,7,0,9,13,29
2015,Jameer Nelson,PG,32,DEN,34,5,702,135,300,0.45,46,130,0.354,89,170,0.524,0.527,11,19,0.579,16,50,66,125,25,4,61,70,327
2015,Andrew Nicholson,PF,25,ORL,40,3,492,83,190,0.437,13,41,0.317,70,149,0.47,0.471,15,25,0.6,17,65,82,22,6,12,24,51,194
2015,Nerlens Noel,C,20,PHI,75,71,2311,302,653,0.462,0,0,NA,302,653,0.462,0.462,140,230,0.609,185,426,611,128,133,142,146,208,744
2015,Steve Novak,SF,31,UTA,22,0,109,16,35,0.457,16,33,0.485,0,2,0,0.686,0,2,0,1,15,16,6,0,1,3,13,48
2015,Steve Novak,PF,31,OKC,13,0,88,6,21,0.286,3,15,0.2,3,6,0.5,0.357,0,0,NA,1,5,6,5,0,1,2,10,15
2015,Jusuf Nurkić,C,20,DEN,62,27,1103,171,383,0.446,0,2,0,171,381,0.449,0.446,84,132,0.636,125,257,382,50,52,68,86,207,426
2015,Johnny O'Bryant,PF,21,MIL,34,15,368,44,120,0.367,0,0,NA,44,120,0.367,0.367,12,27,0.444,26,38,64,17,5,4,25,44,100
2015,Victor Oladipo,SG,22,ORL,72,71,2573,473,1086,0.436,84,248,0.339,389,838,0.464,0.474,262,320,0.819,51,251,302,295,120,19,204,187,1292
2015,Kelly Olynyk,C,23,BOS,64,13,1423,251,528,0.475,61,175,0.349,190,353,0.538,0.533,93,136,0.684,92,211,303,109,64,39,98,213,656
2015,Arinze Onuaku,C,27,MIN,6,1,68,12,14,0.857,0,0,NA,12,14,0.857,0.857,3,8,0.375,7,14,21,4,1,3,2,6,27
2015,Jannero Pargo,PG,35,CHO,9,0,73,15,35,0.429,9,22,0.409,6,13,0.462,0.557,2,2,1,0,3,3,8,0,0,3,8,41
2015,Jabari Parker,PF,19,MIL,25,25,738,129,263,0.49,4,16,0.25,125,247,0.506,0.498,46,66,0.697,50,88,138,42,31,5,47,42,308
2015,Patrick Patterson,PF,25,TOR,81,4,2156,240,535,0.449,105,283,0.371,135,252,0.536,0.547,63,80,0.788,127,306,433,155,60,44,54,149,648
2015,Adreian Payne,PF,23,ATL,3,0,19,2,7,0.286,0,1,0,2,6,0.333,0.286,1,2,0.5,1,3,4,0,1,0,0,4,5
2015,Adreian Payne,PF,23,MIN,29,22,720,89,213,0.418,1,8,0.125,88,205,0.429,0.42,29,44,0.659,47,111,158,30,18,9,44,84,208
2015,Elfrid Payton,PG,20,ORL,82,63,2489,301,708,0.425,11,42,0.262,290,666,0.435,0.433,118,214,0.551,107,242,349,533,142,20,203,193,731
2015,Kendrick Perkins,C,30,OKC,51,3,981,82,186,0.441,0,1,0,82,185,0.443,0.441,38,75,0.507,80,199,279,43,14,38,74,135,202
2015,Kendrick Perkins,C,30,CLE,17,0,167,20,41,0.488,0,0,NA,20,41,0.488,0.488,4,8,0.5,11,30,41,8,2,4,21,27,44
2015,Mason Plumlee,C,24,BRK,82,45,1743,280,489,0.573,0,3,0,280,486,0.576,0.573,157,317,0.495,175,337,512,74,65,63,106,207,717
2015,Miles Plumlee,C,26,PHO,54,28,1005,107,195,0.549,0,0,NA,107,195,0.549,0.549,19,38,0.5,95,179,274,27,35,55,45,99,233
2015,Miles Plumlee,C,26,MIL,19,0,189,29,59,0.492,0,0,NA,29,59,0.492,0.492,3,8,0.375,17,29,46,7,6,11,6,12,61
2015,Quincy Pondexter,SG,26,MEM,30,2,540,48,135,0.356,17,73,0.233,31,62,0.5,0.419,21,30,0.7,20,37,57,28,5,5,10,47,134
2015,Quincy Pondexter,SF,26,NOP,45,28,1253,140,312,0.449,74,171,0.433,66,141,0.468,0.567,50,66,0.758,33,105,138,66,14,19,41,103,404
2015,Otto Porter Jr.,SF,21,WAS,74,13,1432,176,391,0.45,35,104,0.337,141,287,0.491,0.495,58,79,0.734,70,151,221,65,44,30,52,97,445
2015,Dwight Powell,PF,23,BOS,5,0,9,4,5,0.8,0,0,NA,4,5,0.8,0.8,1,2,0.5,0,1,1,0,2,0,2,1,9
2015,Dwight Powell,PF,23,DAL,24,0,227,27,62,0.435,3,11,0.273,24,51,0.471,0.46,24,31,0.774,18,31,49,9,7,6,9,39,81
2015,Phil Pressey,PG,23,BOS,50,0,600,64,174,0.368,16,65,0.246,48,109,0.44,0.414,33,49,0.673,13,67,80,117,30,6,41,54,177
2015,A.J. Price,PG,28,IND,10,0,193,39,89,0.438,15,39,0.385,24,50,0.48,0.522,12,18,0.667,2,12,14,27,4,0,10,9,105
2015,A.J. Price,PG,28,CLE,11,0,87,9,34,0.265,0,11,0,9,23,0.391,0.265,4,6,0.667,4,11,15,13,3,0,3,1,22
2015,A.J. Price,PG,28,PHO,5,0,44,3,14,0.214,0,7,0,3,7,0.429,0.214,0,0,NA,0,3,3,6,0,0,1,5,6
2015,Pablo Prigioni,PG,37,NYK,43,3,795,68,161,0.422,43,115,0.374,25,46,0.543,0.556,22,26,0.846,18,62,80,104,52,1,47,53,201
2015,Pablo Prigioni,PG,37,HOU,24,0,402,23,67,0.343,14,51,0.275,9,16,0.563,0.448,13,15,0.867,12,27,39,67,27,0,15,35,73
2015,Tayshaun Prince,SF,34,MEM,26,9,628,75,183,0.41,15,33,0.455,60,150,0.4,0.451,25,30,0.833,21,62,83,37,9,6,15,22,190
2015,Tayshaun Prince,SF,34,BOS,9,0,198,33,59,0.559,5,8,0.625,28,51,0.549,0.602,5,6,0.833,6,24,30,18,5,2,4,7,76
2015,Tayshaun Prince,SF,34,DET,23,7,571,69,160,0.431,11,26,0.423,58,134,0.433,0.466,19,29,0.655,25,72,97,38,15,8,16,26,168
2015,Shavlik Randolph,PF,31,PHO,16,0,101,6,25,0.24,0,4,0,6,21,0.286,0.24,5,10,0.5,12,14,26,3,4,2,2,13,17
2015,Shavlik Randolph,PF,31,BOS,5,0,25,3,10,0.3,0,1,0,3,9,0.333,0.3,1,2,0.5,4,8,12,1,1,1,1,3,7
2015,Zach Randolph,PF,33,MEM,71,71,2304,454,932,0.487,7,20,0.35,447,912,0.49,0.491,228,298,0.765,225,522,747,153,69,14,156,175,1143
2015,J.J. Redick,SG,30,LAC,78,78,2409,447,938,0.477,200,458,0.437,247,480,0.515,0.583,183,203,0.901,22,145,167,137,39,8,95,134,1277
2015,Jason Richardson,SG,34,PHI,19,15,416,62,178,0.348,31,96,0.323,31,82,0.378,0.435,17,22,0.773,13,53,66,38,13,3,16,28,172
2015,Luke Ridnour,PG,33,ORL,47,0,683,75,176,0.426,20,63,0.317,55,113,0.487,0.483,18,21,0.857,8,60,68,96,20,4,38,67,188
2015,Austin Rivers,SG,22,NOP,35,3,772,86,222,0.387,14,50,0.28,72,172,0.419,0.419,53,71,0.746,12,56,68,87,18,7,30,65,239
2015,Austin Rivers,PG,22,LAC,41,2,791,117,274,0.427,25,81,0.309,92,193,0.477,0.473,32,55,0.582,15,69,84,68,30,7,35,81,291
2015,Brian Roberts,PG,29,CHO,72,10,1330,176,452,0.389,62,193,0.321,114,259,0.44,0.458,66,74,0.892,13,96,109,162,33,6,57,75,480
2015,Glenn Robinson III,SG,21,MIN,25,0,108,8,24,0.333,1,6,0.167,7,18,0.389,0.354,12,16,0.75,4,10,14,3,3,0,3,5,29
2015,Glenn Robinson III,SF,21,PHI,10,1,153,18,43,0.419,4,13,0.308,14,30,0.467,0.465,4,8,0.5,11,14,25,8,3,1,8,10,44
2015,Nate Robinson,PG,30,DEN,33,1,465,71,204,0.348,24,92,0.261,47,112,0.42,0.407,26,40,0.65,14,25,39,77,14,3,22,68,192
2015,Nate Robinson,PG,30,LAC,9,0,126,17,51,0.333,7,20,0.35,10,31,0.323,0.402,5,6,0.833,3,8,11,20,6,0,8,8,46
2015,Thomas Robinson,PF,23,POR,32,4,391,47,91,0.516,0,0,NA,47,91,0.516,0.516,21,48,0.438,33,100,133,9,16,11,33,54,115
2015,Thomas Robinson,PF,23,PHI,22,0,407,79,169,0.467,0,2,0,79,167,0.473,0.467,35,58,0.603,62,108,170,24,16,9,26,50,193
2015,Rajon Rondo,PG,28,BOS,22,22,699,81,200,0.405,8,32,0.25,73,168,0.435,0.425,12,36,0.333,25,140,165,237,37,3,75,42,182
2015,Rajon Rondo,PG,28,DAL,46,46,1319,194,445,0.436,19,54,0.352,175,391,0.448,0.457,19,42,0.452,48,160,208,301,54,4,135,111,426
2015,Derrick Rose,PG,26,CHI,51,51,1530,338,835,0.405,76,271,0.28,262,564,0.465,0.45,152,187,0.813,35,126,161,251,36,16,161,63,904
2015,Terrence Ross,SF,23,TOR,82,61,2092,309,753,0.41,145,390,0.372,164,363,0.452,0.507,44,56,0.786,32,194,226,86,53,25,69,136,807
2015,John Salmons,SF,35,NOP,21,0,270,16,48,0.333,8,26,0.308,8,22,0.364,0.417,2,4,0.5,4,17,21,13,9,4,5,25,42
2015,JaKarr Sampson,SF,21,PHI,74,32,1131,146,346,0.422,31,127,0.244,115,219,0.525,0.467,63,94,0.67,35,128,163,77,38,26,76,135,386
2015,Mike Scott,PF,26,ATL,68,0,1123,201,453,0.444,66,192,0.344,135,261,0.517,0.517,61,77,0.792,45,154,199,75,25,3,39,83,529
2015,Thabo Sefolosha,SF,30,ATL,52,7,976,104,249,0.418,25,78,0.321,79,171,0.462,0.468,45,58,0.776,53,170,223,75,53,21,38,67,278
2015,Ramon Sessions,PG,28,SAC,36,7,642,63,183,0.344,6,28,0.214,57,155,0.368,0.361,64,88,0.727,13,56,69,96,13,0,51,45,196
2015,Ramon Sessions,PG,28,WAS,28,3,546,62,151,0.411,13,32,0.406,49,119,0.412,0.454,69,85,0.812,10,65,75,86,16,0,35,28,206
2015,Iman Shumpert,SG,24,NYK,24,24,625,88,215,0.409,23,66,0.348,65,149,0.436,0.463,25,37,0.676,22,59,81,78,30,3,42,67,224
2015,Iman Shumpert,SG,24,CLE,38,1,920,105,256,0.41,44,130,0.338,61,126,0.484,0.496,18,27,0.667,33,110,143,57,51,13,49,71,272
2015,Alexey Shved,SG,26,PHI,17,0,285,52,130,0.4,17,57,0.298,35,73,0.479,0.465,48,57,0.842,8,14,22,46,14,1,18,21,169
2015,Alexey Shved,SG,26,HOU,9,0,59,8,24,0.333,4,12,0.333,4,12,0.333,0.417,9,11,0.818,1,3,4,3,1,0,5,2,29
2015,Alexey Shved,SG,26,NYK,16,9,423,73,181,0.403,26,70,0.371,47,111,0.423,0.475,64,82,0.78,14,59,73,57,15,5,25,25,236
2015,Henry Sims,C,24,PHI,73,32,1399,238,502,0.474,4,22,0.182,234,480,0.488,0.478,106,137,0.774,121,238,359,79,39,30,99,135,586
2015,Kyle Singler,SF,26,DET,54,40,1287,140,350,0.4,76,187,0.406,64,163,0.393,0.509,29,36,0.806,23,116,139,67,33,14,42,98,385
2015,Kyle Singler,SF,26,OKC,26,18,456,32,96,0.333,20,54,0.37,12,42,0.286,0.438,11,16,0.688,10,45,55,18,14,7,13,55,95
2015,Donald Sloan,PG,27,IND,53,21,1107,145,355,0.408,41,131,0.313,104,224,0.464,0.466,60,77,0.779,12,131,143,190,23,0,65,47,391
2015,Ish Smith,PG,26,OKC,30,0,155,15,45,0.333,1,5,0.2,14,40,0.35,0.344,6,9,0.667,5,22,27,28,4,1,9,12,37
2015,Ish Smith,PG,26,PHI,25,14,677,128,322,0.398,17,55,0.309,111,267,0.416,0.424,28,48,0.583,10,63,73,152,32,5,69,38,301
2015,J.R. Smith,SG,29,NYK,24,6,619,101,251,0.402,32,90,0.356,69,161,0.429,0.466,27,39,0.692,4,54,58,81,18,4,45,44,261
2015,J.R. Smith,SG,29,CLE,46,45,1461,214,504,0.425,131,336,0.39,83,168,0.494,0.555,27,33,0.818,26,134,160,114,64,18,52,119,586
2015,Jason Smith,C,28,NYK,82,31,1785,257,592,0.434,15,42,0.357,242,550,0.44,0.447,127,153,0.83,98,226,324,140,32,44,104,205,656
2015,Josh Smith,PF,29,DET,28,28,896,153,391,0.391,9,37,0.243,144,354,0.407,0.403,52,111,0.468,52,150,202,132,37,48,72,82,367
2015,Josh Smith,PF,29,HOU,55,7,1404,261,596,0.438,63,191,0.33,198,405,0.489,0.491,75,144,0.521,100,228,328,145,50,68,134,146,660
2015,Russ Smith,PG,23,NOP,6,0,29,2,10,0.2,1,6,0.167,1,4,0.25,0.25,0,0,NA,0,3,3,2,0,0,7,6,5
2015,Russ Smith,PG,23,MEM,6,0,36,6,15,0.4,1,5,0.2,5,10,0.5,0.433,12,13,0.923,1,2,3,6,3,0,5,7,25
2015,Marreese Speights,C,27,GSW,76,9,1207,318,646,0.492,5,18,0.278,313,628,0.498,0.496,150,178,0.843,109,216,325,72,20,34,82,189,791
2015,Nik Stauskas,SG,21,SAC,73,1,1127,108,296,0.365,48,149,0.322,60,147,0.408,0.446,55,64,0.859,11,77,88,67,20,17,40,92,319
2015,Lance Stephenson,SG,24,CHO,61,25,1573,207,550,0.376,18,105,0.171,189,445,0.425,0.393,69,110,0.627,39,238,277,240,38,8,128,134,501
2015,Jarnell Stokes,PF,21,MEM,19,2,126,21,37,0.568,0,0,NA,21,37,0.568,0.568,15,28,0.536,16,18,34,4,5,5,7,25,57
2015,Amar'e Stoudemire,PF,32,NYK,36,14,865,169,311,0.543,0,3,0,169,308,0.549,0.543,94,127,0.74,83,162,245,37,20,34,63,111,432
2015,Amar'e Stoudemire,PF,32,DAL,23,1,380,104,179,0.581,0,1,0,104,178,0.584,0.581,40,59,0.678,27,57,84,8,9,4,15,50,248
2015,Jeff Teague,PG,26,ATL,73,72,2228,408,887,0.46,71,207,0.343,337,680,0.496,0.5,275,319,0.862,30,154,184,513,125,31,205,139,1162
2015,Sebastian Telfair,PG,29,OKC,16,1,327,46,125,0.368,18,60,0.3,28,65,0.431,0.44,24,34,0.706,2,28,30,45,10,0,18,29,134
2015,Garrett Temple,SG,28,WAS,52,18,735,68,170,0.4,33,88,0.375,35,82,0.427,0.497,35,48,0.729,24,66,90,56,42,9,34,76,204
2015,Isaiah Thomas,PG,25,PHO,46,1,1181,218,512,0.426,81,207,0.391,137,305,0.449,0.505,184,211,0.872,26,83,109,171,45,5,89,105,701
2015,Isaiah Thomas,PG,25,BOS,21,0,545,117,285,0.411,48,139,0.345,69,146,0.473,0.495,118,137,0.861,7,37,44,113,12,0,54,45,400
2015,Lance Thomas,SF,26,OKC,22,13,450,45,126,0.357,0,1,0,45,125,0.36,0.357,23,33,0.697,28,47,75,20,11,0,17,38,113
2015,Lance Thomas,PF,26,NYK,40,24,1040,137,316,0.434,7,21,0.333,130,295,0.441,0.445,49,66,0.742,37,83,120,49,26,8,57,63,330
2015,Malcolm Thomas,PF,26,PHI,17,0,194,18,40,0.45,0,7,0,18,33,0.545,0.45,9,13,0.692,16,40,56,7,3,1,13,17,45
2015,Tyrus Thomas,PF,28,MEM,2,0,7,1,1,1,0,0,NA,1,1,1,1,2,2,1,0,0,0,1,0,0,0,0,4
2015,Hollis Thompson,SG,23,PHI,71,23,1776,224,543,0.413,115,287,0.401,109,256,0.426,0.518,63,89,0.708,53,145,198,85,57,26,66,141,626
2015,Jason Thompson,PF,28,SAC,81,63,1991,201,428,0.47,0,1,0,201,427,0.471,0.47,89,143,0.622,139,391,530,85,33,57,84,239,491
2015,Marcus Thornton,SG,27,BOS,39,0,640,127,305,0.416,52,124,0.419,75,181,0.414,0.502,42,51,0.824,19,54,73,34,21,7,22,35,348
2015,Marcus Thornton,SG,27,PHO,9,0,81,13,40,0.325,2,19,0.105,11,21,0.524,0.35,4,5,0.8,4,9,13,2,6,0,5,3,32
2015,Anthony Tolliver,PF,29,PHO,24,0,272,26,74,0.351,24,62,0.387,2,12,0.167,0.514,4,6,0.667,6,38,44,10,4,1,11,20,80
2015,Anthony Tolliver,PF,29,DET,52,11,1160,135,319,0.423,82,228,0.36,53,91,0.582,0.552,50,63,0.794,45,147,192,49,20,15,40,117,402
2015,P.J. Tucker,SF,29,PHO,78,63,2383,261,596,0.438,87,252,0.345,174,344,0.506,0.511,104,143,0.727,114,388,502,122,107,23,96,179,713
2015,Ronny Turiaf,C,32,MIN,2,0,19,0,0,NA,0,0,NA,0,0,NA,NA,0,0,NA,0,1,1,2,0,0,0,0,0
2015,Hedo Türkoğlu,SF,35,LAC,62,2,705,83,188,0.441,60,139,0.432,23,49,0.469,0.601,6,11,0.545,5,94,99,37,19,7,29,66,232
2015,Evan Turner,SG,26,BOS,82,57,2260,320,746,0.429,33,119,0.277,287,627,0.458,0.451,106,141,0.752,40,377,417,449,83,19,198,180,779
2015,Ekpe Udoh,PF,27,LAC,33,0,128,11,24,0.458,0,0,NA,11,24,0.458,0.458,7,9,0.778,7,19,26,8,8,7,7,20,29
2015,Beno Udrih,PG,32,MEM,79,12,1494,246,505,0.487,26,97,0.268,220,408,0.539,0.513,87,102,0.853,20,123,143,220,46,8,89,88,605
2015,Jonas Valančiūnas,C,22,TOR,80,80,2096,373,652,0.572,0,1,0,373,651,0.573,0.572,217,276,0.786,215,478,693,39,33,95,109,222,963
2015,Anderson Varejão,C,32,CLE,26,26,636,111,200,0.555,0,2,0,111,198,0.561,0.555,33,45,0.733,57,113,170,35,19,16,35,58,255
2015,Greivis Vásquez,PG,28,TOR,82,29,1991,296,725,0.408,133,351,0.379,163,374,0.436,0.5,50,66,0.758,22,194,216,302,46,10,119,177,775
2015,Noah Vonleh,PF,19,CHO,25,0,259,30,76,0.395,5,13,0.385,25,63,0.397,0.428,18,26,0.692,28,58,86,4,4,9,11,20,83
2015,Nikola Vučević,C,24,ORL,74,74,2529,631,1206,0.523,2,6,0.333,629,1200,0.524,0.524,164,218,0.752,238,572,810,147,54,54,148,220,1428
2015,Dwyane Wade,SG,33,MIA,62,62,1971,509,1084,0.47,29,102,0.284,480,982,0.489,0.483,284,370,0.768,58,161,219,299,73,21,209,105,1331
2015,Dion Waiters,SG,23,CLE,33,3,786,138,342,0.404,22,86,0.256,116,256,0.453,0.436,47,60,0.783,12,45,57,74,44,10,50,59,345
2015,Dion Waiters,SG,23,OKC,47,20,1422,237,604,0.392,51,160,0.319,186,444,0.419,0.435,70,112,0.625,29,106,135,89,46,11,63,96,595
2015,Henry Walker,SF,27,MIA,24,13,628,58,168,0.345,45,132,0.341,13,36,0.361,0.479,14,18,0.778,7,75,82,29,24,9,24,76,175
2015,Gerald Wallace,SF,32,BOS,32,0,286,14,34,0.412,1,3,0.333,13,31,0.419,0.426,6,15,0.4,17,40,57,11,15,4,18,19,35
2015,Andrew Wiggins,SF,19,MIN,82,82,2969,497,1137,0.437,39,126,0.31,458,1011,0.453,0.454,354,466,0.76,134,240,374,170,86,50,177,190,1387
2015,Deron Williams,PG,30,BRK,68,55,2114,298,771,0.387,87,237,0.367,211,534,0.395,0.443,201,241,0.834,29,208,237,448,64,17,154,157,884
2015,Derrick Williams,PF,23,SAC,74,6,1462,217,485,0.447,49,156,0.314,168,329,0.511,0.498,134,196,0.684,41,161,202,50,34,4,56,67,617
2015,Elliot Williams,SG,25,UTA,5,0,42,6,13,0.462,5,7,0.714,1,6,0.167,0.654,1,2,0.5,0,3,3,4,2,0,4,1,18
2015,Elliot Williams,SG,25,NOP,8,0,77,8,24,0.333,3,11,0.273,5,13,0.385,0.396,0,2,0,0,5,5,8,2,0,0,11,19
2015,Lou Williams,SG,28,TOR,80,0,2016,375,928,0.404,152,447,0.34,223,481,0.464,0.486,340,395,0.861,24,127,151,164,88,10,101,103,1242
2015,Marvin Williams,PF,28,CHO,78,37,2035,210,495,0.424,95,265,0.358,115,230,0.5,0.52,62,87,0.713,58,328,386,100,69,36,60,146,577
2015,Mo Williams,PG,32,MIN,41,19,1149,180,447,0.403,59,170,0.347,121,277,0.437,0.469,80,94,0.851,13,85,98,261,30,8,102,103,499
2015,Mo Williams,PG,32,CHO,27,14,831,161,413,0.39,60,178,0.337,101,235,0.43,0.462,83,93,0.892,9,67,76,163,16,6,70,59,465
2015,Reggie Williams,SF,28,SAS,20,0,105,15,39,0.385,3,19,0.158,12,20,0.6,0.423,4,4,1,5,12,17,10,1,0,2,12,37
2015,Shawne Williams,SF,28,MIA,44,22,924,102,240,0.425,60,152,0.395,42,88,0.477,0.55,28,33,0.848,27,112,139,36,21,17,23,116,292
2015,Shawne Williams,SF,28,DET,19,0,163,19,60,0.317,4,26,0.154,15,34,0.441,0.35,7,7,1,9,18,27,8,4,4,7,19,49
2015,Nate Wolters,PG,23,MIL,11,0,142,12,31,0.387,0,5,0,12,26,0.462,0.387,1,4,0.25,2,14,16,10,5,0,3,11,25
2015,Nate Wolters,PG,23,NOP,10,0,105,8,26,0.308,0,2,0,8,24,0.333,0.308,1,2,0.5,6,12,18,11,3,2,10,7,17
2015,Brandan Wright,PF,27,DAL,27,0,505,101,135,0.748,0,0,NA,101,135,0.748,0.748,36,48,0.75,51,59,110,10,17,42,13,44,238
2015,Brandan Wright,PF,27,BOS,8,0,86,12,21,0.571,0,0,NA,12,21,0.571,0.571,2,4,0.5,7,10,17,8,1,5,5,4,26
2015,Brandan Wright,PF,27,PHO,40,7,858,120,207,0.58,0,3,0,120,204,0.588,0.58,40,60,0.667,70,124,194,23,32,47,16,54,280
2015,Nick Young,SG,29,LAL,42,0,1000,174,476,0.366,83,225,0.369,91,251,0.363,0.453,132,148,0.892,17,79,96,41,23,11,44,83,563
2015,Thaddeus Young,PF,26,MIN,48,48,1605,289,641,0.451,19,65,0.292,270,576,0.469,0.466,88,129,0.682,75,170,245,135,86,17,75,115,685
2015,Thaddeus Young,PF,26,BRK,28,20,829,162,327,0.495,19,50,0.38,143,277,0.516,0.524,43,71,0.606,52,114,166,38,38,8,42,56,386
2015,Tyler Zeller,C,25,BOS,82,59,1731,340,619,0.549,0,0,NA,340,619,0.549,0.549,153,186,0.823,146,319,465,113,18,52,76,205,833
2016,Quincy Acy,PF,25,SAC,59,29,876,119,214,0.556,19,49,0.388,100,165,0.606,0.6,50,68,0.735,65,123,188,27,29,24,27,103,307
2016,Arron Afflalo,SG,30,NYK,71,57,2371,354,799,0.443,91,238,0.382,263,561,0.469,0.5,110,131,0.84,23,243,266,144,25,10,82,142,909
2016,Alexis Ajinça,C,27,NOP,59,17,861,150,315,0.476,0,1,0,150,314,0.478,0.476,52,62,0.839,75,194,269,31,19,36,54,134,352
2016,Cole Aldrich,C,27,LAC,60,5,800,134,225,0.596,0,0,NA,134,225,0.596,0.596,60,84,0.714,86,202,288,50,47,68,64,139,328
2016,LaMarcus Aldridge,PF,30,SAS,74,74,2261,536,1045,0.513,0,16,0,536,1029,0.521,0.513,259,302,0.858,176,456,632,110,38,81,99,151,1331
2016,Lavoy Allen,PF,26,IND,79,28,1599,191,370,0.516,0,0,NA,191,370,0.516,0.516,46,73,0.63,162,262,424,76,26,42,69,147,428
2016,Al-Farouq Aminu,SF,25,POR,82,82,2341,299,719,0.416,126,349,0.361,173,370,0.468,0.503,115,156,0.737,98,401,499,138,72,53,120,171,839
2016,Lou Amundson,PF,33,NYK,29,0,204,19,53,0.358,0,0,NA,19,53,0.358,0.358,14,27,0.519,23,26,49,12,6,7,15,44,52
2016,Chris Andersen,C,37,MIA,7,1,36,4,10,0.4,2,5,0.4,2,5,0.4,0.5,3,4,0.75,3,6,9,3,1,3,2,4,13
2016,Chris Andersen,C,37,MEM,20,14,366,34,62,0.548,2,9,0.222,32,53,0.604,0.565,22,32,0.688,33,56,89,9,14,10,7,25,92
2016,James Anderson,SG,26,SAC,51,15,721,67,178,0.376,23,86,0.267,44,92,0.478,0.441,22,29,0.759,13,73,86,41,21,14,42,54,179
2016,Justin Anderson,SF,22,DAL,55,9,647,71,175,0.406,22,83,0.265,49,92,0.533,0.469,44,55,0.8,18,114,132,29,19,25,24,45,208
2016,Ryan Anderson,PF,27,NOP,66,7,2008,397,929,0.427,131,358,0.366,266,571,0.466,0.498,199,228,0.873,131,265,396,73,38,25,90,109,1124
2016,Carmelo Anthony,SF,31,NYK,72,72,2530,567,1307,0.434,105,310,0.339,462,997,0.463,0.474,334,403,0.829,98,458,556,299,62,38,176,180,1573
2016,Joel Anthony,C,33,DET,19,0,96,6,10,0.6,0,0,NA,6,10,0.6,0.6,6,8,0.75,8,13,21,1,2,12,2,15,18
2016,Trevor Ariza,SF,30,HOU,81,81,2859,357,859,0.416,185,499,0.371,172,360,0.478,0.523,126,161,0.783,67,299,366,188,160,26,113,177,1025
2016,Ömer Aşık,C,29,NOP,68,64,1178,104,195,0.533,0,0,NA,104,195,0.533,0.533,61,112,0.545,120,294,414,26,21,23,60,124,269
2016,D.J. Augustin,PG,28,OKC,34,0,519,46,121,0.38,24,61,0.393,22,60,0.367,0.479,26,34,0.765,5,38,43,66,13,2,30,41,142
2016,D.J. Augustin,PG,28,DEN,28,0,659,102,229,0.445,44,107,0.411,58,122,0.475,0.541,77,94,0.819,3,49,52,132,25,2,54,44,325
2016,Luke Babbitt,SF,26,NOP,47,13,845,122,289,0.422,44,109,0.404,78,180,0.433,0.498,39,50,0.78,25,123,148,53,11,7,23,90,327
2016,Leandro Barbosa,SG,33,GSW,68,0,1079,171,370,0.462,39,110,0.355,132,260,0.508,0.515,52,62,0.839,28,89,117,82,44,10,53,107,433
2016,Harrison Barnes,SF,23,GSW,66,59,2042,295,633,0.466,82,214,0.383,213,419,0.508,0.531,102,134,0.761,77,248,325,117,41,10,57,136,774
2016,Matt Barnes,SF,35,MEM,76,45,2190,264,693,0.381,119,370,0.322,145,323,0.449,0.467,111,138,0.804,84,336,420,163,78,57,121,234,758
2016,Will Barton,SG,25,DEN,82,1,2353,425,983,0.432,112,325,0.345,313,658,0.476,0.489,216,268,0.806,59,417,476,203,71,39,139,147,1178
2016,Jerryd Bayless,SG,27,MIL,52,18,1505,185,437,0.423,101,231,0.437,84,206,0.408,0.539,70,90,0.778,21,120,141,163,47,11,73,111,541
2016,Kent Bazemore,SF,26,ATL,75,68,2083,320,725,0.441,109,305,0.357,211,420,0.502,0.517,123,151,0.815,28,351,379,171,98,38,138,176,872
2016,Marco Belinelli,SG,29,SAC,68,7,1672,245,635,0.386,91,297,0.306,154,338,0.456,0.457,115,138,0.833,10,107,117,127,37,2,80,91,696
2016,Nemanja Bjelica,PF,27,MIN,60,0,1075,110,235,0.468,48,125,0.384,62,110,0.564,0.57,40,55,0.727,49,161,210,83,26,21,47,154,308
2016,Tarik Black,C,24,LAL,39,0,496,57,104,0.548,0,0,NA,57,104,0.548,0.548,19,45,0.422,44,113,157,16,14,18,22,78,133
2016,Steve Blake,PG,35,DET,58,2,986,93,240,0.388,52,151,0.344,41,89,0.461,0.496,16,20,0.8,9,80,89,200,24,5,81,70,254
2016,Eric Bledsoe,PG,26,PHO,31,31,1059,223,492,0.453,48,129,0.372,175,363,0.482,0.502,138,172,0.802,18,107,125,190,63,19,110,75,632
2016,Bojan Bogdanović,SF,26,BRK,79,39,2115,324,749,0.433,129,338,0.382,195,411,0.474,0.519,110,132,0.833,36,219,255,99,29,5,115,119,887
2016,Andrew Bogut,C,31,GSW,70,66,1451,175,279,0.627,1,1,1,174,278,0.626,0.629,24,50,0.48,121,371,492,162,33,114,83,221,375
2016,Trevor Booker,PF,28,UTA,79,2,1632,190,388,0.49,12,41,0.293,178,347,0.513,0.505,71,106,0.67,166,286,452,84,59,41,81,169,463
2016,Avery Bradley,SG,25,BOS,76,72,2536,456,1019,0.447,147,407,0.361,309,612,0.505,0.52,96,123,0.78,48,172,220,158,117,19,109,164,1155
2016,Corey Brewer,SF,29,HOU,82,12,1669,212,552,0.384,61,224,0.272,151,328,0.46,0.439,105,140,0.75,42,157,199,109,84,19,78,168,590
2016,Aaron Brooks,PG,31,CHI,69,0,1108,188,469,0.401,66,185,0.357,122,284,0.43,0.471,49,64,0.766,21,80,101,180,30,10,82,132,491
2016,Anthony Brown,SF,23,LAL,29,11,599,39,126,0.31,20,70,0.286,19,56,0.339,0.389,17,20,0.85,9,61,70,19,14,5,15,34,115
2016,Chase Budinger,SF,27,IND,49,2,729,81,194,0.418,20,69,0.29,61,125,0.488,0.469,34,48,0.708,31,90,121,49,29,9,31,46,216
2016,Chase Budinger,SF,27,PHO,17,0,200,23,45,0.511,4,17,0.235,19,28,0.679,0.556,5,8,0.625,12,17,29,15,3,1,13,16,55
2016,Reggie Bullock,SF,24,DET,37,0,429,43,98,0.439,22,53,0.415,21,45,0.467,0.551,14,15,0.933,14,54,68,27,10,2,8,29,122
2016,Trey Burke,PG,23,UTA,64,0,1366,262,634,0.413,88,256,0.344,174,378,0.46,0.483,67,82,0.817,18,94,112,148,35,6,80,86,679
2016,Alec Burks,SG,24,UTA,31,3,797,137,334,0.41,32,79,0.405,105,255,0.412,0.458,106,141,0.752,16,93,109,63,18,4,51,71,412
2016,Caron Butler,SF,35,SAC,17,1,176,25,59,0.424,3,18,0.167,22,41,0.537,0.449,10,12,0.833,5,17,22,10,9,1,3,19,63
2016,Jimmy Butler,SG,26,CHI,67,67,2474,470,1035,0.454,64,205,0.312,406,830,0.489,0.485,395,475,0.832,79,279,358,321,110,43,132,124,1399
2016,Rasual Butler,SF,36,SAS,46,0,432,49,104,0.471,15,49,0.306,34,55,0.618,0.543,11,16,0.688,3,53,56,24,13,23,8,11,124
2016,Bruno Caboclo,SF,20,TOR,6,1,43,1,12,0.083,1,7,0.143,0,5,0,0.125,0,0,NA,1,1,2,1,2,1,4,2,3
2016,José Calderón,PG,34,NYK,72,72,2024,209,455,0.459,84,203,0.414,125,252,0.496,0.552,42,48,0.875,22,207,229,298,63,7,87,135,544
2016,Isaiah Canaan,SG,24,PHI,77,39,1966,260,722,0.36,176,485,0.363,84,237,0.354,0.482,150,180,0.833,20,154,174,137,56,12,91,133,846
2016,DeMarre Carroll,SF,29,TOR,26,22,786,105,270,0.389,46,118,0.39,59,152,0.388,0.474,30,50,0.6,31,91,122,27,44,6,28,63,286
2016,Vince Carter,SG,39,MEM,60,3,1005,133,343,0.388,59,169,0.349,74,174,0.425,0.474,70,84,0.833,31,115,146,56,38,16,35,101,395
2016,Michael Carter-Williams,PG,24,MIL,54,37,1649,251,555,0.452,15,55,0.273,236,500,0.472,0.466,106,162,0.654,48,228,276,281,80,41,153,162,623
2016,Omri Casspi,PF,27,SAC,69,21,1880,299,622,0.481,112,274,0.409,187,348,0.537,0.571,103,159,0.648,58,352,410,95,56,17,94,154,813
2016,Willie Cauley-Stein,C,22,SAC,66,39,1412,191,339,0.563,0,2,0,191,337,0.567,0.563,81,125,0.648,134,218,352,37,48,66,46,146,463
2016,Mario Chalmers,PG,29,MIA,6,0,120,10,32,0.313,1,11,0.091,9,21,0.429,0.328,12,13,0.923,1,13,14,19,8,1,9,16,33
2016,Mario Chalmers,PG,29,MEM,55,7,1253,172,412,0.417,45,138,0.326,127,274,0.464,0.472,206,249,0.827,23,120,143,211,80,12,101,165,595
2016,Tyson Chandler,C,33,PHO,66,60,1618,183,314,0.583,0,1,0,183,313,0.585,0.583,106,171,0.62,175,401,576,64,36,44,93,145,472
2016,Ian Clark,SG,24,GSW,66,1,578,89,202,0.441,30,84,0.357,59,118,0.5,0.515,28,34,0.824,13,55,68,64,17,13,43,58,236
2016,Jordan Clarkson,SG,23,LAL,79,79,2552,475,1098,0.433,111,320,0.347,364,778,0.468,0.483,164,204,0.804,93,220,313,192,88,7,135,168,1225
2016,Norris Cole,PG,27,NOP,45,23,1198,196,484,0.405,33,102,0.324,163,382,0.427,0.439,52,65,0.8,10,141,151,167,37,5,75,102,477
2016,Bryce Cotton,PG,23,PHO,3,0,33,2,8,0.25,0,3,0,2,5,0.4,0.25,0,0,NA,0,0,0,3,3,0,5,2,4
2016,Bryce Cotton,PG,23,MEM,5,0,6,2,2,1,0,0,NA,2,2,1,1,0,0,NA,0,0,0,0,0,0,0,0,4
2016,DeMarcus Cousins,C,25,SAC,65,65,2246,601,1332,0.451,70,210,0.333,531,1122,0.473,0.477,476,663,0.718,158,589,747,214,101,92,249,236,1748
2016,Robert Covington,SF,25,PHI,67,49,1903,274,712,0.385,170,482,0.353,104,230,0.452,0.504,140,177,0.791,65,354,419,97,105,40,143,232,858
2016,Allen Crabbe,SG,23,POR,81,8,2105,311,678,0.459,112,285,0.393,199,393,0.506,0.541,98,113,0.867,27,189,216,99,63,16,64,192,832
2016,Jamal Crawford,SG,35,LAC,79,5,2126,379,939,0.404,117,344,0.34,262,595,0.44,0.466,245,271,0.904,20,125,145,183,52,12,113,122,1120
2016,Jae Crowder,SF,25,BOS,73,73,2308,360,813,0.443,122,363,0.336,238,450,0.529,0.518,196,239,0.82,70,303,373,135,126,35,83,198,1038
2016,Dante Cunningham,SF,28,NOP,80,46,1971,186,412,0.451,55,174,0.316,131,238,0.55,0.518,57,82,0.695,57,179,236,77,42,33,41,173,484
2016,Jared Cunningham,SG,24,CLE,40,3,355,32,91,0.352,10,32,0.313,22,59,0.373,0.407,30,48,0.625,3,26,29,19,12,2,18,37,104
2016,Jared Cunningham,SG,24,MIL,4,0,55,4,14,0.286,2,7,0.286,2,7,0.286,0.357,6,7,0.857,0,9,9,1,2,0,3,4,16
2016,Seth Curry,PG,25,SAC,44,9,692,102,224,0.455,50,111,0.45,52,113,0.46,0.567,45,54,0.833,9,51,60,67,22,3,36,41,299
2016,Troy Daniels,SG,24,CHO,43,0,476,89,187,0.476,59,122,0.484,30,65,0.462,0.634,5,9,0.556,7,50,57,21,11,3,24,40,242
2016,Ed Davis,PF,26,POR,81,0,1684,206,337,0.611,0,0,NA,206,337,0.611,0.611,114,204,0.559,224,375,599,88,57,72,64,202,526
2016,Dewayne Dedmon,C,26,ORL,58,20,705,99,177,0.559,0,0,NA,99,177,0.559,0.559,57,76,0.75,67,161,228,13,22,46,32,109,255
2016,Sam Dekker,PF,21,HOU,3,0,6,0,0,NA,0,0,NA,0,0,NA,NA,0,0,NA,0,1,1,0,1,0,0,0,0
2016,Matthew Dellavedova,PG,25,CLE,76,14,1867,207,511,0.405,98,239,0.41,109,272,0.401,0.501,57,66,0.864,33,129,162,337,44,9,116,178,569
2016,Luol Deng,PF,30,MIA,74,73,2394,339,745,0.455,88,256,0.344,251,489,0.513,0.514,145,192,0.755,108,335,443,140,74,29,81,122,911
2016,Boris Diaw,PF,33,SAS,76,4,1386,202,383,0.527,25,69,0.362,177,314,0.564,0.56,56,76,0.737,58,175,233,176,26,21,97,102,485
2016,Gorgui Dieng,C,26,MIN,82,39,2220,308,579,0.532,6,20,0.3,302,559,0.54,0.537,205,248,0.827,157,428,585,143,94,96,140,219,827
2016,Toney Douglas,PG,29,NOP,61,18,1262,183,445,0.411,81,203,0.399,102,242,0.421,0.502,84,99,0.848,25,118,143,157,70,5,64,131,531
2016,Goran Dragić,PG,29,MIA,72,72,2363,417,875,0.477,64,205,0.312,353,670,0.527,0.513,120,165,0.727,54,223,277,419,71,17,185,188,1018
2016,Andre Drummond,C,22,DET,81,81,2666,552,1060,0.521,2,6,0.333,550,1054,0.522,0.522,208,586,0.355,395,803,1198,67,119,112,155,245,1314
2016,Jared Dudley,PF,30,WAS,81,41,2098,233,487,0.478,100,238,0.42,133,249,0.534,0.581,72,98,0.735,54,232,286,170,75,18,80,190,638
2016,Mike Dunleavy,SF,35,CHI,31,30,703,77,188,0.41,39,99,0.394,38,89,0.427,0.513,29,37,0.784,8,75,83,39,14,10,26,66,222
2016,Jarell Eddie,SF,24,WAS,26,0,147,20,65,0.308,15,47,0.319,5,18,0.278,0.423,8,8,1,2,21,23,5,5,1,1,5,63
2016,Wayne Ellington,SG,28,BRK,76,41,1615,218,561,0.389,96,268,0.358,122,293,0.416,0.474,54,63,0.857,20,154,174,83,48,5,45,82,586
2016,Monta Ellis,SG,30,IND,81,81,2734,436,1021,0.427,87,282,0.309,349,739,0.472,0.47,162,206,0.786,42,229,271,383,150,37,203,174,1121
2016,James Ennis III,SF,25,MIA,3,0,7,0,0,NA,0,0,NA,0,0,NA,NA,0,0,NA,0,0,0,1,0,0,0,1,0
2016,James Ennis III,SF,25,MEM,10,0,40,4,13,0.308,2,8,0.25,2,5,0.4,0.385,6,10,0.6,4,3,7,2,4,2,2,1,16
2016,James Ennis III,SF,25,NOP,9,5,282,50,100,0.5,24,50,0.48,26,50,0.52,0.62,19,24,0.792,17,18,35,18,12,3,17,26,143
2016,Tyler Ennis,PG,21,MIL,46,7,654,84,187,0.449,13,39,0.333,71,148,0.48,0.484,25,34,0.735,13,62,75,95,25,1,46,64,206
2016,Tyreke Evans,SG,26,NOP,25,25,765,136,314,0.433,33,85,0.388,103,229,0.45,0.486,74,93,0.796,20,109,129,164,32,8,73,66,379
2016,Kenneth Faried,PF,26,DEN,67,64,1694,349,626,0.558,1,2,0.5,348,624,0.558,0.558,136,222,0.613,235,346,581,79,32,60,91,169,835
2016,Derrick Favors,PF,24,UTA,62,59,1983,418,811,0.515,0,4,0,418,807,0.518,0.515,180,254,0.709,169,334,503,94,74,91,104,150,1016
2016,Raymond Felton,PG,31,DAL,80,31,2192,277,682,0.406,60,213,0.282,217,469,0.463,0.45,149,176,0.847,36,222,258,284,68,15,121,141,763
2016,Evan Fournier,SF,23,ORL,79,71,2566,429,929,0.462,156,390,0.4,273,539,0.506,0.546,199,238,0.836,33,192,225,213,96,2,133,214,1213
2016,Randy Foye,SG,32,DEN,54,7,1070,117,333,0.351,50,169,0.296,67,164,0.409,0.426,39,47,0.83,16,89,105,112,26,16,58,83,323
2016,Randy Foye,SG,32,OKC,27,1,572,52,149,0.349,25,81,0.309,27,68,0.397,0.433,22,27,0.815,8,43,51,49,13,13,28,48,151
2016,Tim Frazier,PG,25,POR,35,1,272,20,60,0.333,3,17,0.176,17,43,0.395,0.358,8,15,0.533,11,28,39,42,10,1,27,31,51
2016,Tim Frazier,PG,25,NOP,16,1,469,76,169,0.45,13,31,0.419,63,138,0.457,0.488,45,59,0.763,15,56,71,120,23,1,38,42,210
2016,Jimmer Fredette,SG,26,NOP,4,0,13,1,4,0.25,0,1,0,1,3,0.333,0.25,0,0,NA,0,0,0,1,1,0,1,1,2
2016,Jimmer Fredette,SG,26,NYK,2,0,5,1,1,1,1,1,1,0,0,NA,1.5,4,5,0.8,0,0,0,0,0,0,1,1,7
2016,Enes Freedom,C,23,OKC,82,1,1721,414,719,0.576,10,21,0.476,404,698,0.579,0.583,200,251,0.797,249,415,664,33,26,33,115,166,1038
2016,Channing Frye,PF,32,ORL,44,29,754,81,186,0.435,48,121,0.397,33,65,0.508,0.565,19,21,0.905,23,118,141,45,21,20,30,71,229
2016,Channing Frye,C,32,CLE,26,3,446,71,161,0.441,43,114,0.377,28,47,0.596,0.575,11,14,0.786,12,81,93,26,8,8,13,56,196
2016,Danilo Gallinari,SF,27,DEN,53,53,1839,287,700,0.41,87,239,0.364,200,461,0.434,0.472,375,432,0.868,52,229,281,135,42,19,77,87,1036
2016,Langston Galloway,PG,24,NYK,82,7,2033,231,588,0.393,77,224,0.344,154,364,0.423,0.458,86,114,0.754,43,245,288,207,77,22,61,177,625
2016,Kevin Garnett,PF,39,MIN,38,38,556,54,115,0.47,0,1,0,54,114,0.474,0.47,14,21,0.667,15,135,150,62,28,10,16,70,122
2016,Marc Gasol,C,31,MEM,52,52,1791,328,707,0.464,2,3,0.667,326,704,0.463,0.465,203,245,0.829,58,304,362,196,50,70,118,141,861
2016,Pau Gasol,C,35,CHI,72,72,2291,467,995,0.469,24,69,0.348,443,926,0.478,0.481,229,289,0.792,155,638,793,294,42,146,164,148,1187
2016,Rudy Gay,SF,29,SAC,70,70,2379,466,1007,0.463,74,215,0.344,392,792,0.495,0.5,198,254,0.78,103,353,456,120,100,51,139,184,1204
2016,Alonzo Gee,SF,28,NOP,73,38,1632,132,255,0.518,17,60,0.283,115,195,0.59,0.551,44,66,0.667,60,185,245,72,63,13,55,169,325
2016,Taj Gibson,PF,30,CHI,73,55,1936,263,500,0.526,0,3,0,263,497,0.529,0.526,101,146,0.692,206,298,504,106,47,77,78,180,627
2016,Drew Gooden,PF,34,WAS,30,0,305,33,103,0.32,7,41,0.171,26,62,0.419,0.354,9,14,0.643,28,57,85,13,8,11,13,40,82
2016,Archie Goodwin,PG,21,PHO,57,13,1114,176,422,0.417,23,99,0.232,153,323,0.474,0.444,130,193,0.674,27,115,142,118,27,13,100,84,505
2016,Aaron Gordon,PF,20,ORL,78,37,1863,274,579,0.473,42,142,0.296,232,437,0.531,0.509,129,193,0.668,154,353,507,128,59,55,66,153,719
2016,Marcin Gortat,C,31,WAS,75,74,2256,433,764,0.567,0,1,0,433,763,0.567,0.567,146,207,0.705,222,519,741,106,47,96,121,193,1012
2016,Jerami Grant,PF,21,PHI,77,52,2066,251,599,0.419,35,146,0.24,216,453,0.477,0.448,212,322,0.658,99,262,361,135,54,127,110,215,749
2016,Erick Green,PG,24,DEN,3,0,7,0,1,0,0,1,0,0,0,NA,0,0,0,NA,0,1,1,1,0,0,0,0,0
2016,Erick Green,PG,24,UTA,6,0,35,5,12,0.417,1,4,0.25,4,8,0.5,0.458,2,2,1,3,2,5,2,1,0,0,4,13
2016,Gerald Green,SG,30,MIA,69,14,1557,230,587,0.392,84,260,0.323,146,327,0.446,0.463,72,92,0.783,25,138,163,56,38,19,46,123,616
2016,JaMychal Green,PF,25,MEM,78,15,1446,230,495,0.465,15,45,0.333,215,450,0.478,0.48,103,137,0.752,139,234,373,67,46,33,83,189,578
2016,Jeff Green,SF,29,MEM,53,31,1544,240,557,0.431,42,136,0.309,198,421,0.47,0.469,124,155,0.8,55,186,241,98,40,19,69,102,646
2016,Jeff Green,SF,29,LAC,27,10,709,114,267,0.427,25,77,0.325,89,190,0.468,0.474,40,65,0.615,19,72,91,40,18,21,24,62,293
2016,Blake Griffin,PF,26,LAC,35,35,1170,301,603,0.499,6,18,0.333,295,585,0.504,0.504,141,194,0.727,51,243,294,170,28,17,83,95,749
2016,Jorge Gutiérrez,PG,27,CHO,12,0,63,6,11,0.545,0,2,0,6,9,0.667,0.545,10,11,0.909,0,7,7,17,3,0,6,3,22
2016,P.J. Hairston,SF,23,CHO,48,43,938,99,276,0.359,54,172,0.314,45,104,0.433,0.457,34,42,0.81,18,110,128,29,24,7,24,106,286
2016,P.J. Hairston,SF,23,MEM,18,9,375,46,132,0.348,16,69,0.232,30,63,0.476,0.409,16,22,0.727,7,39,46,9,8,4,17,31,124
2016,Jordan Hamilton,SF,25,NOP,11,4,304,49,116,0.422,13,45,0.289,36,71,0.507,0.478,14,21,0.667,12,50,62,25,8,3,17,24,125
2016,Tim Hardaway Jr.,SG,23,ATL,51,1,864,114,265,0.43,48,142,0.338,66,123,0.537,0.521,50,56,0.893,7,79,86,51,21,7,23,48,326
2016,James Harden,SG,26,HOU,82,82,3125,710,1617,0.439,236,657,0.359,474,960,0.494,0.512,720,837,0.86,63,438,501,612,139,51,374,229,2376
2016,Maurice Harkless,SF,22,POR,78,14,1457,195,411,0.474,39,140,0.279,156,271,0.576,0.522,69,111,0.622,101,179,280,67,49,35,62,124,498
2016,Devin Harris,PG,32,DAL,64,0,1280,167,374,0.447,52,158,0.329,115,216,0.532,0.516,101,140,0.721,18,120,138,118,60,13,66,124,487
2016,Gary Harris,SG,21,DEN,76,76,2439,359,765,0.469,105,297,0.354,254,468,0.543,0.538,109,133,0.82,54,166,220,147,97,18,98,143,932
2016,Tobias Harris,PF,23,ORL,49,49,1610,251,541,0.464,47,151,0.311,204,390,0.523,0.507,120,153,0.784,71,271,342,99,47,28,78,91,669
2016,Tobias Harris,PF,23,DET,27,25,903,166,348,0.477,33,88,0.375,133,260,0.512,0.524,82,90,0.911,25,143,168,70,18,12,30,62,447
2016,Spencer Hawes,PF,27,CHO,57,6,1035,124,306,0.405,38,102,0.373,86,204,0.422,0.467,54,65,0.831,51,193,244,109,22,27,58,111,340
2016,Chuck Hayes,C,32,HOU,2,0,24,1,2,0.5,0,0,NA,1,2,0.5,0.5,2,2,1,0,8,8,2,0,0,3,6,4
2016,Gerald Henderson,SG,28,POR,72,0,1431,232,529,0.439,48,136,0.353,184,393,0.468,0.484,112,146,0.767,30,181,211,75,39,19,68,87,624
2016,John Henson,C,25,MIL,57,1,960,164,291,0.564,0,1,0,164,290,0.566,0.564,69,117,0.59,87,134,221,54,18,109,64,131,397
2016,Roy Hibbert,C,29,LAL,81,81,1878,182,411,0.443,0,2,0,182,409,0.445,0.443,117,145,0.807,132,266,398,95,32,110,76,252,481
2016,J.J. Hickson,C,27,DEN,20,9,305,55,109,0.505,0,0,NA,55,109,0.505,0.505,27,59,0.458,22,65,87,16,10,12,16,35,137
2016,J.J. Hickson,C,27,WAS,15,0,131,25,46,0.543,0,1,0,25,45,0.556,0.543,19,44,0.432,17,28,45,7,5,2,9,12,69
2016,Nenê,PF,33,WAS,57,11,1094,209,384,0.544,0,3,0,209,381,0.549,0.544,107,185,0.578,52,207,259,97,54,26,76,156,525
2016,George Hill,PG,29,IND,74,73,2524,326,739,0.441,128,314,0.408,198,425,0.466,0.528,114,150,0.76,58,240,298,259,83,17,101,149,894
2016,Jordan Hill,C,28,IND,73,11,1513,278,549,0.506,0,1,0,278,548,0.507,0.506,89,125,0.712,156,295,451,87,36,37,92,155,645
2016,Solomon Hill,SF,24,IND,59,3,866,93,208,0.447,24,74,0.324,69,134,0.515,0.505,36,42,0.857,39,127,166,57,37,11,33,68,246
2016,Kirk Hinrich,PG,35,CHI,35,7,555,47,118,0.398,23,56,0.411,24,62,0.387,0.496,15,16,0.938,7,51,58,59,13,1,27,63,132
2016,Kirk Hinrich,PG,35,ATL,11,0,76,2,11,0.182,1,6,0.167,1,5,0.2,0.227,0,0,NA,1,11,12,14,2,1,3,1,5
2016,Justin Holiday,SG,26,ATL,26,1,263,24,73,0.329,10,45,0.222,14,28,0.5,0.397,5,10,0.5,4,23,27,11,13,4,13,21,63
2016,Justin Holiday,SG,26,CHI,27,4,510,64,155,0.413,26,60,0.433,38,95,0.4,0.497,22,27,0.815,8,55,63,45,19,15,26,40,176
2016,Ryan Hollins,C,31,WAS,5,3,48,4,7,0.571,0,0,NA,4,7,0.571,0.571,0,0,NA,7,4,11,0,0,1,3,4,8
2016,Ryan Hollins,C,31,MEM,32,9,412,45,72,0.625,0,0,NA,45,72,0.625,0.625,26,42,0.619,40,47,87,10,6,20,21,58,116
2016,Rodney Hood,SG,23,UTA,79,79,2541,408,972,0.42,161,449,0.359,247,523,0.472,0.503,172,200,0.86,38,229,267,213,73,16,125,202,1149
2016,Kris Humphries,PF,30,WAS,28,14,466,64,158,0.405,23,67,0.343,41,91,0.451,0.478,29,31,0.935,26,89,115,16,3,14,20,42,180
2016,Kris Humphries,PF,30,PHO,4,3,74,10,36,0.278,3,10,0.3,7,26,0.269,0.319,6,8,0.75,11,21,32,7,3,2,4,8,29
2016,Kris Humphries,PF,30,ATL,21,0,295,47,101,0.465,8,31,0.258,39,70,0.557,0.505,32,45,0.711,20,51,71,13,10,7,14,44,134
2016,Serge Ibaka,PF,26,OKC,78,78,2500,416,869,0.479,60,184,0.326,356,685,0.52,0.513,91,121,0.752,141,392,533,66,38,148,108,211,983
2016,Ersan İlyasova,PF,28,DET,52,52,1434,216,508,0.425,78,215,0.363,138,293,0.471,0.502,79,109,0.725,99,183,282,55,38,27,59,120,589
2016,Ersan İlyasova,PF,28,ORL,22,4,447,64,153,0.418,18,44,0.409,46,109,0.422,0.477,32,45,0.711,45,76,121,12,14,6,12,51,178
2016,Jarrett Jack,PG,32,BRK,32,32,1027,140,358,0.391,31,102,0.304,109,256,0.426,0.434,100,112,0.893,9,127,136,236,34,7,94,77,411
2016,Reggie Jackson,PG,25,DET,79,79,2424,540,1244,0.434,118,334,0.353,422,910,0.464,0.482,291,337,0.864,58,195,253,492,59,11,223,187,1489
2016,Richard Jefferson,SF,35,CLE,74,5,1326,143,312,0.458,66,173,0.382,77,139,0.554,0.564,58,87,0.667,15,113,128,59,33,14,43,129,410
2016,John Jenkins,SG,24,DAL,21,1,193,29,70,0.414,3,19,0.158,26,51,0.51,0.436,8,9,0.889,4,18,22,9,3,0,11,11,69
2016,John Jenkins,SG,24,PHO,22,2,287,42,90,0.467,13,32,0.406,29,58,0.5,0.539,12,15,0.8,4,31,35,26,5,1,16,11,109
2016,Brandon Jennings,PG,26,DET,23,1,416,53,143,0.371,24,77,0.312,29,66,0.439,0.455,27,38,0.711,5,41,46,70,11,2,22,24,157
2016,Brandon Jennings,PG,26,ORL,25,6,452,59,161,0.366,27,78,0.346,32,83,0.386,0.45,30,40,0.75,11,39,50,100,18,5,35,33,175
2016,Jonas Jerebko,PF,28,BOS,78,0,1176,118,286,0.413,43,108,0.398,75,178,0.421,0.488,61,78,0.782,77,211,288,62,20,24,52,137,340
2016,Chris Johnson,SF,25,UTA,70,2,857,72,194,0.371,27,99,0.273,45,95,0.474,0.441,34,42,0.81,27,105,132,45,32,20,40,100,205
2016,James Johnson,PF,28,TOR,57,32,926,114,240,0.475,20,66,0.303,94,174,0.54,0.517,39,68,0.574,28,98,126,67,29,33,54,84,287
2016,Joe Johnson,SF,34,BRK,57,57,1934,247,608,0.406,85,229,0.371,162,379,0.427,0.476,92,108,0.852,34,190,224,232,40,2,116,100,671
2016,Joe Johnson,SF,34,MIA,24,24,769,130,251,0.518,35,84,0.417,95,167,0.569,0.588,26,34,0.765,15,53,68,86,21,2,43,46,321
2016,Orlando Johnson,SG,26,PHO,2,0,47,5,17,0.294,1,5,0.2,4,12,0.333,0.324,5,6,0.833,3,6,9,0,2,3,1,5,16
2016,Orlando Johnson,SG,26,NOP,5,1,54,4,17,0.235,1,5,0.2,3,12,0.25,0.265,1,2,0.5,1,5,6,2,1,0,3,4,10
2016,Stanley Johnson,SF,19,DET,73,6,1687,225,600,0.375,63,205,0.307,162,395,0.41,0.428,80,102,0.784,58,248,306,118,55,12,114,178,593
2016,Tyler Johnson,SG,23,MIA,36,5,863,118,243,0.486,27,71,0.38,91,172,0.529,0.541,51,64,0.797,28,81,109,79,24,14,47,66,314
2016,Wesley Johnson,SF,28,LAC,80,9,1666,208,515,0.404,103,309,0.333,105,206,0.51,0.504,30,46,0.652,37,211,248,49,89,56,54,173,549
2016,Dahntay Jones,SF,35,CLE,1,0,42,6,14,0.429,1,2,0.5,5,12,0.417,0.464,0,0,NA,1,4,5,2,1,2,0,6,13
2016,Terrence Jones,PF,24,HOU,50,11,1044,166,367,0.452,25,79,0.316,141,288,0.49,0.486,77,116,0.664,62,149,211,41,23,39,49,86,434
2016,DeAndre Jordan,C,27,LAC,77,77,2598,357,508,0.703,0,1,0,357,507,0.704,0.703,266,619,0.43,267,792,1059,90,51,177,107,207,980
2016,Cory Joseph,SG,24,TOR,80,4,2046,257,585,0.439,30,110,0.273,227,475,0.478,0.465,133,174,0.764,39,171,210,250,63,20,102,131,677
2016,Michael Kidd-Gilchrist,SF,22,CHO,7,7,205,33,61,0.541,3,7,0.429,30,54,0.556,0.566,20,29,0.69,12,33,45,9,3,3,8,9,89
2016,Sean Kilpatrick,SG,26,DEN,8,0,82,8,21,0.381,4,17,0.235,4,4,1,0.476,7,8,0.875,2,4,6,3,2,0,4,7,27
2016,Sean Kilpatrick,SG,26,BRK,23,0,534,115,249,0.462,35,97,0.361,80,152,0.526,0.532,53,59,0.898,10,40,50,26,10,2,27,30,318
2016,Brandon Knight,SG,24,PHO,52,50,1870,371,895,0.415,120,351,0.342,251,544,0.461,0.482,156,183,0.852,36,166,202,263,61,20,177,124,1018
2016,Kyle Korver,SG,34,ATL,80,80,2401,268,616,0.435,158,397,0.398,110,219,0.502,0.563,45,54,0.833,14,246,260,164,60,35,98,161,739
2016,Kosta Koufos,C,26,SAC,78,14,1482,236,444,0.532,0,0,NA,236,444,0.532,0.532,57,104,0.548,169,254,423,33,40,70,48,185,529
2016,Carl Landry,PF,32,PHI,36,12,569,139,250,0.556,6,13,0.462,133,237,0.561,0.568,67,91,0.736,49,97,146,32,12,9,22,69,351
2016,Joffrey Lauvergne,C,24,DEN,59,15,1041,195,380,0.513,13,53,0.245,182,327,0.557,0.53,62,69,0.899,77,213,290,56,13,15,54,115,465
2016,Ty Lawson,PG,28,HOU,53,12,1176,111,287,0.387,31,94,0.33,80,193,0.415,0.441,56,80,0.7,20,69,89,180,43,6,82,71,309
2016,Ty Lawson,PG,28,IND,13,1,235,28,67,0.418,5,14,0.357,23,53,0.434,0.455,3,6,0.5,6,25,31,57,10,1,13,16,64
2016,Courtney Lee,SG,30,MEM,51,37,1489,192,419,0.458,51,138,0.37,141,281,0.502,0.519,76,92,0.826,19,99,118,76,52,16,49,79,511
2016,Courtney Lee,SG,30,CHO,28,28,845,98,220,0.445,31,79,0.392,67,141,0.475,0.516,23,26,0.885,10,77,87,60,33,12,23,55,250
2016,David Lee,PF,32,BOS,30,4,470,87,192,0.453,0,1,0,87,191,0.455,0.453,40,51,0.784,41,89,130,54,12,13,38,51,214
2016,David Lee,PF,32,DAL,25,1,433,91,143,0.636,0,0,NA,91,143,0.636,0.636,31,42,0.738,60,115,175,30,10,15,28,63,213
2016,Alex Len,C,22,PHO,78,46,1821,264,624,0.423,1,7,0.143,263,617,0.426,0.424,174,239,0.728,178,416,594,97,38,62,145,230,703
2016,Jon Leuer,PF,26,PHO,67,27,1255,224,466,0.481,42,110,0.382,182,356,0.511,0.526,77,101,0.762,76,297,373,72,38,30,75,125,567
2016,Jeremy Lin,SG,27,CHO,78,13,2048,300,728,0.412,76,226,0.336,224,502,0.446,0.464,238,292,0.815,42,211,253,235,58,42,150,165,914
2016,Shaun Livingston,PG,30,GSW,78,3,1520,203,379,0.536,2,12,0.167,201,367,0.548,0.538,80,93,0.86,42,127,169,237,57,27,78,140,488
2016,Kyle Lowry,PG,29,TOR,77,77,2851,512,1198,0.427,212,547,0.388,300,651,0.461,0.516,398,491,0.811,55,310,365,494,158,34,225,211,1634
2016,Shelvin Mack,PG,25,ATL,24,0,179,40,95,0.421,4,27,0.148,36,68,0.529,0.442,9,12,0.75,2,20,22,38,8,0,14,7,93
2016,Shelvin Mack,PG,25,UTA,28,27,879,142,320,0.444,35,98,0.357,107,222,0.482,0.498,36,49,0.735,11,95,106,149,26,3,81,65,355
2016,Boban Marjanović,C,27,SAS,54,4,508,105,174,0.603,0,0,NA,105,174,0.603,0.603,87,114,0.763,73,121,194,21,12,23,29,54,297
2016,Kevin Martin,SG,32,MIN,39,12,834,126,334,0.377,38,103,0.369,88,231,0.381,0.434,125,142,0.88,10,71,81,46,17,1,41,68,415
2016,Kevin Martin,SG,32,SAS,16,1,261,30,85,0.353,11,33,0.333,19,52,0.365,0.418,28,30,0.933,4,25,29,12,9,2,13,15,99
2016,Wesley Matthews,SF,29,DAL,78,78,2644,331,854,0.388,189,525,0.36,142,329,0.432,0.498,126,146,0.863,27,211,238,151,78,17,78,179,977
2016,Luc Mbah a Moute,PF,29,LAC,75,61,1274,94,207,0.454,13,40,0.325,81,167,0.485,0.486,30,57,0.526,60,111,171,30,44,19,34,100,231
2016,Ray McCallum,PG,24,SAS,31,3,256,27,67,0.403,5,16,0.313,22,51,0.431,0.44,9,10,0.9,6,25,31,33,5,4,11,14,68
2016,Ray McCallum,PG,24,MEM,10,3,219,28,79,0.354,10,26,0.385,18,53,0.34,0.418,3,5,0.6,2,14,16,27,7,3,13,15,69
2016,Chris McCullough,PF,20,BRK,24,4,362,44,109,0.404,13,34,0.382,31,75,0.413,0.463,11,23,0.478,25,43,68,9,28,12,15,39,112
2016,K.J. McDaniels,SF,22,HOU,37,1,235,29,72,0.403,7,25,0.28,22,47,0.468,0.451,24,30,0.8,16,26,42,10,7,6,17,30,89
2016,Doug McDermott,SF,24,CHI,81,4,1861,291,644,0.452,110,259,0.425,181,385,0.47,0.537,72,84,0.857,37,158,195,59,14,6,53,127,764
2016,JaVale McGee,C,28,DAL,34,2,370,77,134,0.575,0,1,0,77,133,0.579,0.575,18,36,0.5,53,80,133,3,5,26,21,49,172
2016,Ben McLemore,SG,22,SAC,68,53,1443,195,455,0.429,67,185,0.362,128,270,0.474,0.502,74,103,0.718,34,114,148,79,52,10,99,140,531
2016,Jordan McRae,PG,24,PHO,7,0,82,11,26,0.423,3,11,0.273,8,15,0.533,0.481,12,15,0.8,2,6,8,10,3,0,6,7,37
2016,Jordan McRae,PG,24,CLE,15,1,113,23,52,0.442,7,11,0.636,16,41,0.39,0.51,9,13,0.692,2,10,12,15,0,1,9,10,62
2016,Josh McRoberts,PF,28,MIA,42,1,595,55,148,0.372,12,49,0.245,43,99,0.434,0.412,28,40,0.7,22,83,105,81,18,7,30,68,150
2016,Jodie Meeks,SG,28,DET,3,0,43,7,20,0.35,4,9,0.444,3,11,0.273,0.45,4,4,1,1,4,5,3,0,0,1,2,22
2016,C.J. Miles,SF,28,IND,64,24,1464,259,634,0.409,142,387,0.367,117,247,0.474,0.521,93,124,0.75,25,150,175,63,53,29,70,142,753
2016,Andre Miller,PG,39,MIN,26,0,280,36,58,0.621,1,4,0.25,35,54,0.648,0.629,15,19,0.789,6,18,24,58,9,0,25,32,88
2016,Andre Miller,PG,39,SAS,13,4,181,23,48,0.479,1,4,0.25,22,44,0.5,0.49,9,13,0.692,6,21,27,29,7,0,12,14,56
2016,Mike Miller,SF,35,DEN,47,2,373,22,62,0.355,19,52,0.365,3,10,0.3,0.508,0,0,NA,6,47,53,40,13,4,17,53,63
2016,Nikola Mirotić,PF,24,CHI,66,38,1646,248,609,0.407,135,346,0.39,113,263,0.43,0.518,146,181,0.807,58,304,362,100,58,46,102,151,777
2016,Nazr Mohammed,C,38,OKC,5,0,19,3,5,0.6,0,0,NA,3,5,0.6,0.6,2,2,1,1,3,4,0,0,0,3,4,8
2016,Greg Monroe,C,25,MIL,79,67,2314,491,941,0.522,0,1,0,491,940,0.522,0.522,228,308,0.74,218,478,696,178,72,67,129,163,1210
2016,Eric Moreland,PF,24,SAC,8,0,48,3,6,0.5,0,0,NA,3,6,0.5,0.5,2,4,0.5,3,8,11,1,0,4,3,4,8
2016,Marcus Morris,SF,26,DET,80,80,2856,410,945,0.434,108,298,0.362,302,647,0.467,0.491,203,271,0.749,91,313,404,201,67,23,140,170,1131
2016,Markieff Morris,PF,26,PHO,37,24,917,171,431,0.397,22,76,0.289,149,355,0.42,0.422,66,92,0.717,43,151,194,87,33,17,90,104,430
2016,Markieff Morris,PF,26,WAS,27,21,712,134,287,0.467,25,79,0.316,109,208,0.524,0.51,42,55,0.764,30,128,158,37,25,17,45,80,335
2016,Anthony Morrow,SG,30,OKC,68,6,926,136,333,0.408,79,204,0.387,57,129,0.442,0.527,29,39,0.744,10,52,62,24,22,5,17,64,380
2016,Timofey Mozgov,C,29,CLE,76,48,1326,203,359,0.565,1,7,0.143,202,352,0.574,0.567,68,95,0.716,110,227,337,33,22,57,71,159,475
2016,Emmanuel Mudiay,PG,19,DEN,68,66,2068,329,905,0.364,74,232,0.319,255,673,0.379,0.404,140,209,0.67,32,200,232,372,65,35,217,141,872
2016,Shabazz Muhammad,SF,23,MIN,82,0,1682,317,681,0.465,44,152,0.289,273,529,0.516,0.498,185,242,0.764,100,167,267,52,24,7,70,94,863
2016,Mike Muscala,C,24,ATL,60,0,565,76,152,0.5,12,39,0.308,64,113,0.566,0.539,31,39,0.795,38,79,117,34,13,27,27,72,195
2016,Larry Nance Jr.,PF,23,LAL,63,22,1266,158,300,0.527,1,10,0.1,157,290,0.541,0.528,32,47,0.681,101,211,312,44,54,23,41,124,349
2016,Shabazz Napier,PG,24,ORL,55,0,600,68,201,0.338,34,104,0.327,34,97,0.351,0.423,33,45,0.733,9,46,55,97,23,1,46,38,203
2016,Gary Neal,SG,31,WAS,40,2,807,151,325,0.465,41,100,0.41,110,225,0.489,0.528,47,55,0.855,11,72,83,47,20,1,29,55,390
2016,Jameer Nelson,PG,33,DEN,39,15,1036,113,307,0.368,43,144,0.299,70,163,0.429,0.438,30,35,0.857,19,96,115,190,25,5,66,100,299
2016,Andrew Nicholson,PF,26,ORL,56,0,823,146,310,0.471,41,114,0.36,105,196,0.536,0.537,51,65,0.785,34,167,201,25,10,22,41,69,384
2016,Nerlens Noel,C,21,PHI,67,62,1965,306,587,0.521,1,2,0.5,305,585,0.521,0.522,134,227,0.59,154,388,542,122,118,100,158,192,747
2016,Steve Novak,PF,32,OKC,7,0,24,6,12,0.5,5,9,0.556,1,3,0.333,0.708,0,0,NA,0,4,4,0,0,0,1,1,17
2016,Steve Novak,PF,32,MIL,3,0,20,2,6,0.333,2,6,0.333,0,0,NA,0.5,1,1,1,0,1,1,0,0,0,0,2,7
2016,Jusuf Nurkić,C,21,DEN,32,3,547,101,242,0.417,0,3,0,101,239,0.423,0.417,61,99,0.616,65,110,175,40,24,44,55,91,263
2016,Johnny O'Bryant,PF,22,MIL,66,4,857,86,209,0.411,1,1,1,85,208,0.409,0.414,27,40,0.675,65,111,176,32,18,8,31,100,200
2016,Jahlil Okafor,C,20,PHI,53,48,1591,397,781,0.508,1,6,0.167,396,775,0.511,0.509,133,194,0.686,122,251,373,65,22,61,124,140,928
2016,Victor Oladipo,SG,23,ORL,72,52,2379,425,970,0.438,98,282,0.348,327,688,0.475,0.489,205,247,0.83,48,297,345,282,116,54,153,174,1153
2016,Kelly Olynyk,C,24,BOS,69,8,1395,253,556,0.455,85,210,0.405,168,346,0.486,0.531,96,128,0.75,72,209,281,105,52,33,74,163,687
2016,Kelly Oubre Jr.,SF,20,WAS,63,9,671,90,211,0.427,25,79,0.316,65,132,0.492,0.486,31,49,0.633,25,108,133,13,22,7,34,100,236
2016,Jabari Parker,PF,20,MIL,76,72,2408,443,899,0.493,9,35,0.257,434,864,0.502,0.498,175,228,0.768,123,272,395,130,69,29,116,154,1070
2016,Patrick Patterson,PF,26,TOR,79,0,2020,204,493,0.414,106,293,0.362,98,200,0.49,0.521,29,34,0.853,77,265,342,94,53,32,65,128,543
2016,Adreian Payne,PF,24,MIN,52,2,486,53,145,0.366,9,32,0.281,44,113,0.389,0.397,17,26,0.654,20,91,111,29,16,11,36,77,132
2016,Cameron Payne,PG,21,OKC,57,1,698,114,278,0.41,36,111,0.324,78,167,0.467,0.475,19,24,0.792,9,76,85,108,36,6,44,80,283
2016,Elfrid Payton,PG,21,ORL,73,69,2145,318,730,0.436,30,92,0.326,288,638,0.451,0.456,112,190,0.589,77,184,261,468,89,20,177,159,778
2016,Kendrick Perkins,C,31,NOP,37,5,542,40,75,0.533,0,0,NA,40,75,0.533,0.533,11,25,0.44,25,103,128,31,11,11,41,64,91
2016,Mason Plumlee,C,25,POR,82,82,2084,267,517,0.516,0,4,0,267,513,0.52,0.516,215,335,0.642,201,427,628,226,68,85,154,253,749
2016,Miles Plumlee,C,27,MIL,61,14,870,140,233,0.601,0,0,NA,140,233,0.601,0.601,34,59,0.576,94,138,232,16,21,50,40,73,314
2016,Otto Porter Jr.,SF,22,WAS,75,73,2276,339,717,0.473,98,267,0.367,241,450,0.536,0.541,95,126,0.754,97,294,391,120,105,32,70,163,871
2016,Bobby Portis,PF,20,CHI,62,4,1102,186,436,0.427,16,52,0.308,170,384,0.443,0.445,48,66,0.727,123,214,337,52,25,22,54,100,436
2016,Dwight Powell,PF,24,DAL,69,2,992,146,296,0.493,2,16,0.125,144,280,0.514,0.497,105,142,0.739,84,189,273,44,36,24,40,118,399
2016,Norman Powell,SG,22,TOR,49,24,725,97,229,0.424,36,89,0.404,61,140,0.436,0.502,43,53,0.811,16,95,111,47,29,10,32,59,273
2016,Phil Pressey,PG,24,PHI,14,0,170,21,55,0.382,4,13,0.308,17,42,0.405,0.418,9,18,0.5,0,23,23,46,11,1,19,14,55
2016,Phil Pressey,PG,24,PHO,9,0,113,9,23,0.391,0,5,0,9,18,0.5,0.391,4,7,0.571,3,5,8,29,7,3,14,14,22
2016,Pablo Prigioni,PG,38,LAC,59,3,823,55,147,0.374,28,95,0.295,27,52,0.519,0.469,7,8,0.875,38,76,114,130,53,1,49,82,145
2016,Tayshaun Prince,SF,35,MIN,77,44,1462,102,229,0.445,4,23,0.174,98,206,0.476,0.454,13,19,0.684,32,115,147,73,36,13,27,62,221
2016,Zach Randolph,PF,34,MEM,68,53,2016,431,907,0.475,6,26,0.231,425,881,0.482,0.479,172,216,0.796,179,350,529,142,43,13,105,146,1040
2016,J.J. Redick,SG,31,LAC,75,75,2097,422,880,0.48,200,421,0.475,222,459,0.484,0.593,182,205,0.888,10,129,139,106,42,5,78,135,1226
2016,Willie Reed,C,25,BRK,39,2,426,76,133,0.571,0,0,NA,76,133,0.571,0.571,30,55,0.545,49,73,122,10,6,30,16,47,182
2016,Austin Rivers,SG,23,LAC,67,7,1464,226,516,0.438,62,185,0.335,164,331,0.495,0.498,79,116,0.681,22,108,130,99,48,9,61,137,593
2016,Brian Roberts,PG,30,CHO,30,0,333,51,115,0.443,9,27,0.333,42,88,0.477,0.483,34,37,0.919,4,25,29,38,7,1,16,23,145
2016,Brian Roberts,PG,30,POR,21,0,137,23,50,0.46,6,15,0.4,17,35,0.486,0.52,8,10,0.8,2,10,12,16,3,1,7,12,60
2016,Glenn Robinson III,SF,22,IND,45,4,508,65,151,0.43,14,37,0.378,51,114,0.447,0.477,27,39,0.692,12,56,68,26,17,9,18,21,171
2016,Nate Robinson,PG,31,NOP,2,1,23,0,1,0,0,1,0,0,0,NA,0,0,0,NA,0,0,0,4,1,0,0,5,0
2016,Thomas Robinson,PF,24,BRK,71,7,917,130,291,0.447,0,1,0,130,290,0.448,0.447,47,109,0.431,136,223,359,46,39,36,69,111,307
2016,Rajon Rondo,PG,29,SAC,72,72,2537,355,782,0.454,62,170,0.365,293,612,0.479,0.494,87,150,0.58,77,358,435,839,141,10,278,175,859
2016,Derrick Rose,PG,27,CHI,66,66,2097,447,1048,0.427,44,150,0.293,403,898,0.449,0.448,142,179,0.793,46,179,225,311,44,14,175,84,1080
2016,Terrence Ross,SF,24,TOR,73,7,1747,270,626,0.431,131,339,0.386,139,287,0.484,0.536,49,62,0.79,21,164,185,56,54,25,46,120,720
2016,D'Angelo Russell,PG,19,LAL,80,48,2259,392,956,0.41,130,370,0.351,262,586,0.447,0.478,140,190,0.737,47,227,274,266,93,13,196,142,1054
2016,JaKarr Sampson,SF,22,PHI,47,18,691,86,202,0.426,6,34,0.176,80,168,0.476,0.441,62,97,0.639,30,99,129,30,11,16,51,91,240
2016,JaKarr Sampson,SF,22,DEN,26,22,469,54,115,0.47,8,29,0.276,46,86,0.535,0.504,18,25,0.72,16,45,61,16,12,17,19,51,134
2016,Mike Scott,PF,27,ATL,75,0,1146,176,376,0.468,62,158,0.392,114,218,0.523,0.551,50,63,0.794,53,153,206,78,25,17,42,102,464
2016,Thabo Sefolosha,SF,31,ATL,75,11,1758,188,372,0.505,42,124,0.339,146,248,0.589,0.562,62,99,0.626,52,282,334,107,85,37,68,109,480
2016,Ramon Sessions,PG,29,WAS,82,5,1667,280,592,0.473,36,111,0.324,244,481,0.507,0.503,214,283,0.756,25,178,203,239,46,5,115,102,810
2016,Iman Shumpert,SG,25,CLE,54,5,1316,114,305,0.374,43,146,0.295,71,159,0.447,0.444,40,51,0.784,32,171,203,92,54,19,57,119,311
2016,Jonathon Simmons,SG,26,SAS,55,2,813,122,242,0.504,18,47,0.383,104,195,0.533,0.541,69,92,0.75,16,80,96,58,24,5,53,103,331
2016,Henry Sims,C,25,BRK,14,4,263,33,77,0.429,0,0,NA,33,77,0.429,0.429,25,30,0.833,21,51,72,9,9,14,12,37,91
2016,Kyle Singler,SF,27,OKC,68,2,977,86,221,0.389,30,97,0.309,56,124,0.452,0.457,29,44,0.659,50,91,141,24,30,9,32,120,231
2016,Donald Sloan,PG,28,BRK,61,33,1318,154,350,0.44,38,99,0.384,116,251,0.462,0.494,78,104,0.75,17,156,173,268,32,4,80,73,424
2016,Ish Smith,PG,27,NOP,27,3,617,98,228,0.43,10,33,0.303,88,195,0.451,0.452,33,43,0.767,14,78,92,154,24,6,45,38,239
2016,Ish Smith,PG,27,PHI,50,50,1622,299,739,0.405,46,137,0.336,253,602,0.42,0.436,89,133,0.669,29,184,213,348,64,18,130,95,733
2016,J.R. Smith,SG,30,CLE,77,77,2362,353,850,0.415,204,510,0.4,149,340,0.438,0.535,45,71,0.634,43,174,217,130,81,21,59,204,955
2016,Jason Smith,C,29,ORL,76,2,1181,244,503,0.485,4,16,0.25,240,487,0.493,0.489,54,67,0.806,53,166,219,62,33,65,57,163,546
2016,Josh Smith,PF,30,LAC,32,1,459,69,180,0.383,18,58,0.31,51,122,0.418,0.433,25,42,0.595,33,92,125,42,18,34,41,62,181
2016,Josh Smith,PF,30,HOU,23,6,421,58,169,0.343,23,85,0.271,35,84,0.417,0.411,12,25,0.48,18,49,67,48,16,13,36,56,151
2016,Russ Smith,PG,24,MEM,15,0,66,7,22,0.318,1,5,0.2,6,17,0.353,0.341,8,13,0.615,1,8,9,11,5,1,7,5,23
2016,Marreese Speights,C,28,GSW,72,0,832,197,456,0.432,24,62,0.387,173,394,0.439,0.458,94,114,0.825,77,162,239,61,19,34,66,117,512
2016,Nik Stauskas,SG,22,PHI,73,35,1809,210,545,0.385,106,325,0.326,104,220,0.473,0.483,91,118,0.771,23,160,183,138,44,20,94,115,617
2016,Lance Stephenson,SF,25,LAC,43,10,680,82,166,0.494,19,47,0.404,63,119,0.529,0.551,21,30,0.7,19,89,108,60,24,3,48,79,204
2016,Lance Stephenson,SF,25,MEM,26,3,692,146,308,0.474,11,31,0.355,135,277,0.487,0.492,66,81,0.815,21,94,115,73,19,6,46,56,369
2016,Alex Stepheson,PF,28,LAC,4,0,12,1,1,1,0,0,NA,1,1,1,1,0,2,0,1,1,2,0,0,2,0,4,2
2016,Alex Stepheson,PF,28,MEM,4,0,61,8,26,0.308,0,0,NA,8,26,0.308,0.308,4,10,0.4,18,8,26,2,1,3,0,8,20
2016,Jarnell Stokes,C,22,MEM,2,0,4,0,0,NA,0,0,NA,0,0,NA,NA,0,0,NA,1,1,2,0,0,0,0,0,0
2016,Jarnell Stokes,C,22,MIA,5,0,14,3,5,0.6,0,0,NA,3,5,0.6,0.6,1,2,0.5,0,2,2,1,1,0,0,1,7
2016,Amar'e Stoudemire,C,33,MIA,52,36,762,125,221,0.566,0,0,NA,125,221,0.566,0.566,50,67,0.746,65,157,222,27,18,41,47,92,300
2016,Edy Tavares,C,23,ATL,11,0,73,11,19,0.579,0,0,NA,11,19,0.579,0.579,3,8,0.375,7,14,21,3,1,6,5,8,25
2016,Jeff Teague,PG,27,ATL,79,78,2255,434,988,0.439,110,275,0.4,324,713,0.454,0.495,261,312,0.837,33,181,214,470,97,24,218,167,1239
2016,Garrett Temple,SF,29,WAS,80,43,1951,201,505,0.398,89,258,0.345,112,247,0.453,0.486,91,125,0.728,36,176,212,140,69,18,64,195,582
2016,Isaiah Thomas,PG,26,BOS,82,79,2644,591,1382,0.428,167,465,0.359,424,917,0.462,0.488,474,544,0.871,46,197,243,509,91,9,220,167,1823
2016,Lance Thomas,PF,27,NYK,59,5,1313,169,382,0.442,44,109,0.404,125,273,0.458,0.5,102,119,0.857,34,97,131,53,22,7,57,109,484
2016,Hollis Thompson,SG,24,PHI,77,17,2154,270,680,0.397,149,392,0.38,121,288,0.42,0.507,69,96,0.719,54,218,272,99,36,24,76,187,758
2016,Jason Thompson,C,29,GSW,28,1,179,20,42,0.476,0,0,NA,20,42,0.476,0.476,20,32,0.625,10,44,54,19,4,8,7,40,60
2016,Jason Thompson,C,29,TOR,19,6,292,32,66,0.485,5,15,0.333,27,51,0.529,0.523,18,22,0.818,22,58,80,10,8,12,8,40,87
2016,Marcus Thornton,SG,28,HOU,47,6,885,174,435,0.4,73,216,0.338,101,219,0.461,0.484,51,58,0.879,31,84,115,66,34,3,40,73,472
2016,Marcus Thornton,SG,28,WAS,14,2,224,42,107,0.393,18,54,0.333,24,53,0.453,0.477,16,21,0.762,7,28,35,19,13,1,11,17,118
2016,Anthony Tolliver,PF,30,DET,72,5,1341,128,332,0.386,98,272,0.36,30,60,0.5,0.533,29,47,0.617,39,190,229,52,26,16,28,86,383
2016,Axel Toupane,SF,23,DEN,21,0,305,25,70,0.357,13,40,0.325,12,30,0.4,0.45,13,17,0.765,8,23,31,15,7,6,6,40,76
2016,P.J. Tucker,SF,30,PHO,82,80,2540,239,582,0.411,68,206,0.33,171,376,0.455,0.469,106,142,0.746,165,347,512,177,106,20,111,202,652
2016,Evan Turner,SG,27,BOS,81,12,2271,343,753,0.456,20,83,0.241,323,670,0.482,0.469,148,179,0.827,50,347,397,359,80,28,169,139,854
2016,Beno Udrih,PG,33,MEM,8,0,120,20,46,0.435,4,11,0.364,16,35,0.457,0.478,3,3,1,2,7,9,26,3,1,11,11,47
2016,Beno Udrih,PG,33,MIA,36,5,587,66,152,0.434,11,33,0.333,55,119,0.462,0.47,15,17,0.882,6,57,63,90,11,0,42,40,158
2016,Jonas Valančiūnas,C,23,TOR,60,59,1557,303,536,0.565,0,0,NA,303,536,0.565,0.565,162,213,0.761,184,363,547,42,25,80,85,158,768
2016,Anderson Varejão,C,33,CLE,31,0,310,32,76,0.421,0,1,0,32,75,0.427,0.421,16,21,0.762,24,67,91,20,11,5,16,35,80
2016,Anderson Varejão,C,33,GSW,22,0,186,21,48,0.438,0,0,NA,21,48,0.438,0.438,16,29,0.552,13,37,50,15,5,5,6,35,58
2016,Greivis Vásquez,PG,29,MIL,23,0,460,45,138,0.326,18,73,0.247,27,65,0.415,0.391,22,26,0.846,5,42,47,91,10,0,40,42,130
2016,Rashad Vaughn,SG,19,MIL,70,6,1001,81,266,0.305,43,147,0.293,38,119,0.319,0.385,12,15,0.8,11,77,88,39,29,16,28,73,217
2016,Noah Vonleh,PF,20,POR,78,56,1174,117,278,0.421,11,46,0.239,106,232,0.457,0.441,38,51,0.745,91,214,305,30,27,26,50,152,283
2016,Nikola Vučević,C,25,ORL,65,60,2037,533,1046,0.51,2,9,0.222,531,1037,0.512,0.511,113,150,0.753,174,402,576,179,53,70,123,173,1181
2016,Sasha Vujačić,SG,31,NYK,61,25,908,106,277,0.383,52,143,0.364,54,134,0.403,0.477,32,39,0.821,26,123,149,84,34,5,44,83,296
2016,Dwyane Wade,SG,34,MIA,74,73,2258,540,1183,0.456,7,44,0.159,533,1139,0.468,0.459,322,406,0.793,82,220,302,344,79,42,203,116,1409
2016,Dion Waiters,SG,24,OKC,78,15,2152,282,706,0.399,86,240,0.358,196,466,0.421,0.46,112,157,0.713,36,166,202,154,81,15,120,143,762
2016,Briante Weber,PG,23,MEM,6,4,166,13,38,0.342,0,5,0,13,33,0.394,0.342,3,4,0.75,8,16,24,20,9,3,9,11,29
2016,Briante Weber,PG,23,MIA,1,0,3,1,1,1,0,0,NA,1,1,1,1,0,0,NA,0,1,1,1,0,0,0,1,2
2016,Sonny Weems,SG,29,PHO,36,0,421,35,89,0.393,13,32,0.406,22,57,0.386,0.466,7,13,0.538,6,35,41,47,10,1,37,40,90
2016,Sonny Weems,SF,29,PHI,7,0,78,7,21,0.333,2,9,0.222,5,12,0.417,0.381,1,2,0.5,1,11,12,2,0,0,4,7,17
2016,Andrew Wiggins,SF,20,MIN,81,81,2845,594,1294,0.459,57,190,0.3,537,1104,0.486,0.481,430,565,0.761,105,186,291,164,78,46,182,165,1675
2016,Deron Williams,PG,31,DAL,65,63,2106,321,775,0.414,97,282,0.344,224,493,0.454,0.477,179,206,0.869,19,171,190,378,61,14,150,155,918
2016,Derrick Williams,SF,24,NYK,80,9,1435,254,565,0.45,44,150,0.293,210,415,0.506,0.488,194,256,0.758,47,249,296,75,29,9,61,69,746
2016,Elliot Williams,PG,26,MEM,5,0,45,2,10,0.2,1,4,0.25,1,6,0.167,0.25,3,4,0.75,1,3,4,4,0,0,1,2,8
2016,Lou Williams,SG,29,LAL,67,35,1907,283,693,0.408,110,320,0.344,173,373,0.464,0.488,352,424,0.83,31,138,169,167,62,19,107,107,1028
2016,Marvin Williams,PF,29,CHO,81,81,2338,338,747,0.452,152,378,0.402,186,369,0.504,0.554,120,144,0.833,127,394,521,110,58,77,62,133,948
2016,Mo Williams,PG,33,CLE,41,14,748,132,302,0.437,36,102,0.353,96,200,0.48,0.497,38,42,0.905,6,66,72,98,14,5,57,60,338
2016,Christian Wood,PF,20,PHI,17,0,145,22,53,0.415,4,11,0.364,18,42,0.429,0.453,13,21,0.619,13,25,38,3,5,7,2,11,61
2016,Metta World Peace,SF,36,LAL,35,5,590,55,177,0.311,26,84,0.31,29,93,0.312,0.384,40,57,0.702,19,70,89,27,22,11,15,67,176
2016,Brandan Wright,PF,28,MEM,12,2,212,35,52,0.673,0,0,NA,35,52,0.673,0.673,13,24,0.542,14,29,43,6,5,15,10,21,83
2016,Delon Wright,PG,23,TOR,27,1,229,36,80,0.45,5,13,0.385,31,67,0.463,0.481,26,35,0.743,8,29,37,31,8,3,16,7,103
2016,Nick Young,SG,30,LAL,54,2,1033,126,372,0.339,77,237,0.325,49,135,0.363,0.442,63,76,0.829,14,83,97,34,23,7,30,50,392
2016,Thaddeus Young,PF,27,BRK,73,73,2407,495,963,0.514,7,30,0.233,488,933,0.523,0.518,105,163,0.644,176,484,660,136,112,37,136,182,1102
2016,Tyler Zeller,C,26,BOS,60,3,710,138,290,0.476,0,0,NA,138,290,0.476,0.476,88,108,0.815,62,116,178,29,10,22,46,97,364
2017,Quincy Acy,PF,26,DAL,6,0,48,5,17,0.294,1,7,0.143,4,10,0.4,0.324,2,3,0.667,2,6,8,0,0,0,2,9,13
2017,Quincy Acy,PF,26,BRK,32,1,510,65,153,0.425,36,83,0.434,29,70,0.414,0.542,43,57,0.754,18,89,107,18,14,15,19,58,209
2017,Arron Afflalo,SG,31,SAC,61,45,1580,185,420,0.44,62,151,0.411,123,269,0.457,0.514,83,93,0.892,9,116,125,78,21,6,42,104,515
2017,Alexis Ajinça,C,28,NOP,39,15,584,89,178,0.5,0,4,0,89,174,0.511,0.5,29,40,0.725,46,131,177,12,20,22,31,77,207
2017,Cole Aldrich,C,28,MIN,62,0,531,45,86,0.523,0,0,NA,45,86,0.523,0.523,15,22,0.682,51,107,158,25,25,23,17,85,105
2017,LaMarcus Aldridge,PF,31,SAS,72,72,2335,500,1049,0.477,23,56,0.411,477,993,0.48,0.488,220,271,0.812,172,351,523,139,46,88,98,158,1243
2017,Lavoy Allen,PF,27,IND,61,5,871,77,168,0.458,0,1,0,77,167,0.461,0.458,23,33,0.697,105,114,219,57,18,24,29,78,177
2017,Al-Farouq Aminu,PF,26,POR,61,25,1773,183,466,0.393,70,212,0.33,113,254,0.445,0.468,96,136,0.706,77,374,451,99,60,44,94,102,532
2017,Chris Andersen,C,38,CLE,12,0,114,9,22,0.409,0,3,0,9,19,0.474,0.409,10,14,0.714,9,22,31,5,5,7,5,20,28
2017,Justin Anderson,SF,23,DAL,51,2,710,111,277,0.401,37,122,0.303,74,155,0.477,0.468,70,88,0.795,39,110,149,32,28,16,40,64,329
2017,Justin Anderson,SF,23,PHI,24,8,518,75,162,0.463,21,72,0.292,54,90,0.6,0.528,32,41,0.78,30,66,96,34,13,7,26,45,203
2017,Ryan Anderson,PF,28,HOU,72,72,2116,323,773,0.418,204,506,0.403,119,267,0.446,0.55,129,150,0.86,112,218,330,68,31,14,55,142,979
2017,Carmelo Anthony,SF,32,NYK,74,74,2538,602,1389,0.433,151,421,0.359,451,968,0.466,0.488,304,365,0.833,62,376,438,213,60,34,153,198,1659
2017,Joel Anthony,C,34,SAS,19,0,122,10,16,0.625,0,0,NA,10,16,0.625,0.625,5,8,0.625,8,23,31,3,2,6,4,11,25
2017,Trevor Ariza,SF,31,HOU,80,80,2773,326,798,0.409,191,555,0.344,135,243,0.556,0.528,93,126,0.738,54,404,458,175,147,20,73,133,936
2017,Ömer Aşık,C,30,NOP,31,19,482,31,65,0.477,0,0,NA,31,65,0.477,0.477,23,39,0.59,48,115,163,15,5,10,14,51,85
2017,D.J. Augustin,PG,29,ORL,78,20,1538,195,517,0.377,95,274,0.347,100,243,0.412,0.469,131,161,0.814,15,102,117,209,31,1,90,101,616
2017,Luke Babbitt,SF,27,MIA,68,55,1065,113,281,0.402,87,210,0.414,26,71,0.366,0.557,11,15,0.733,12,129,141,36,20,11,25,118,324
2017,Ron Baker,SG,23,NYK,52,13,857,82,217,0.378,23,86,0.267,59,131,0.45,0.431,28,43,0.651,12,86,98,107,34,8,56,74,215
2017,Leandro Barbosa,SG,34,PHO,67,0,963,172,392,0.439,35,98,0.357,137,294,0.466,0.483,40,45,0.889,15,89,104,81,31,8,48,82,419
2017,Harrison Barnes,PF,24,DAL,79,79,2803,599,1280,0.468,78,222,0.351,521,1058,0.492,0.498,242,281,0.861,93,301,394,116,65,15,102,128,1518
2017,Matt Barnes,SF,36,SAC,54,13,1367,147,383,0.384,69,211,0.327,78,172,0.453,0.474,50,66,0.758,55,238,293,150,36,17,83,138,413
2017,Matt Barnes,SF,36,GSW,20,5,410,38,90,0.422,18,52,0.346,20,38,0.526,0.522,20,23,0.87,15,76,91,45,12,9,24,47,114
2017,Will Barton,SG,26,DEN,60,19,1705,295,666,0.443,87,235,0.37,208,431,0.483,0.508,143,190,0.753,58,201,259,206,48,28,97,110,820
2017,Jerryd Bayless,PG,28,PHI,3,1,71,11,32,0.344,2,5,0.4,9,27,0.333,0.375,9,10,0.9,3,9,12,13,0,0,9,4,33
2017,Kent Bazemore,SF,27,ATL,73,64,1963,295,721,0.409,92,266,0.346,203,455,0.446,0.473,119,168,0.708,45,186,231,177,91,52,125,165,801
2017,Malik Beasley,SG,20,DEN,22,1,165,33,73,0.452,9,28,0.321,24,45,0.533,0.514,8,10,0.8,5,12,17,11,7,0,8,10,83
2017,Marco Belinelli,SG,30,CHO,74,0,1778,264,615,0.429,102,283,0.36,162,332,0.488,0.512,150,168,0.893,14,164,178,147,44,9,70,90,780
2017,Dragan Bender,PF,19,PHO,43,0,574,57,161,0.354,28,101,0.277,29,60,0.483,0.441,4,11,0.364,23,80,103,23,10,22,32,74,146
2017,Nemanja Bjelica,PF,28,MIN,65,1,1190,151,356,0.424,56,177,0.316,95,179,0.531,0.503,45,61,0.738,57,187,244,79,40,20,59,154,403
2017,Tarik Black,C,25,LAL,67,16,1091,150,294,0.51,1,2,0.5,149,292,0.51,0.512,82,109,0.752,144,199,343,39,29,44,58,173,383
2017,Eric Bledsoe,PG,27,PHO,66,66,2176,449,1034,0.434,104,310,0.335,345,724,0.477,0.485,388,458,0.847,52,268,320,418,91,31,224,164,1390
2017,Bojan Bogdanović,SF,27,BRK,55,54,1482,269,611,0.44,99,277,0.357,170,334,0.509,0.521,146,167,0.874,23,174,197,90,24,3,93,99,783
2017,Bojan Bogdanović,SF,27,WAS,26,0,601,107,234,0.457,45,115,0.391,62,119,0.521,0.553,71,76,0.934,14,66,80,21,10,4,38,47,330
2017,Andrew Bogut,C,32,DAL,26,21,582,38,81,0.469,0,1,0,38,80,0.475,0.469,3,11,0.273,56,162,218,49,13,25,43,84,79
2017,Andrew Bogut,C,32,CLE,1,0,1,0,0,NA,0,0,NA,0,0,NA,NA,0,0,NA,0,0,0,0,0,0,0,2,0
2017,Trevor Booker,PF,29,BRK,71,43,1754,305,591,0.516,25,78,0.321,280,513,0.546,0.537,74,110,0.673,143,428,571,138,75,28,127,152,709
2017,Avery Bradley,SG,26,BOS,55,55,1835,359,775,0.463,108,277,0.39,251,498,0.504,0.533,68,93,0.731,65,269,334,122,68,11,88,141,894
2017,Corey Brewer,SF,30,HOU,58,8,923,94,227,0.414,22,94,0.234,72,133,0.541,0.463,32,44,0.727,21,93,114,61,37,12,36,104,242
2017,Corey Brewer,SF,30,LAL,24,3,358,53,121,0.438,5,24,0.208,48,97,0.495,0.459,18,24,0.75,11,41,52,36,24,8,19,29,129
2017,Aaron Brooks,PG,32,IND,65,0,894,121,300,0.403,48,128,0.375,73,172,0.424,0.483,32,40,0.8,18,51,69,125,25,9,66,93,322
2017,Anthony Brown,SF,24,NOP,9,0,143,14,41,0.341,6,24,0.25,8,17,0.471,0.415,0,0,NA,6,20,26,6,5,1,5,13,34
2017,Anthony Brown,SF,24,ORL,2,0,16,4,9,0.444,1,3,0.333,3,6,0.5,0.5,0,0,NA,2,5,7,2,0,0,1,2,9
2017,Bobby Brown,PG,32,HOU,25,0,123,23,60,0.383,14,35,0.4,9,25,0.36,0.5,2,2,1,0,6,6,14,1,0,5,5,62
2017,Reggie Bullock,SF,25,DET,31,5,467,54,128,0.422,28,73,0.384,26,55,0.473,0.531,5,7,0.714,13,51,64,29,18,3,10,22,141
2017,Trey Burke,PG,24,WAS,57,0,703,116,255,0.455,31,70,0.443,85,185,0.459,0.516,22,29,0.759,7,40,47,100,11,5,48,54,285
2017,Alec Burks,SG,25,UTA,42,0,653,99,248,0.399,25,76,0.329,74,172,0.43,0.45,60,78,0.769,17,103,120,30,18,5,35,50,283
2017,Jimmy Butler,SF,27,CHI,76,75,2809,570,1252,0.455,91,248,0.367,479,1004,0.477,0.492,585,676,0.865,129,341,470,417,143,32,159,112,1816
2017,Bruno Caboclo,SF,21,TOR,9,0,40,6,16,0.375,2,6,0.333,4,10,0.4,0.438,0,0,NA,5,5,10,4,2,1,2,4,14
2017,José Calderón,PG,35,LAL,24,11,292,32,77,0.416,12,34,0.353,20,43,0.465,0.494,4,4,1,8,34,42,51,7,1,26,22,80
2017,José Calderón,PG,35,ATL,17,2,247,23,57,0.404,8,30,0.267,15,27,0.556,0.474,7,8,0.875,7,25,32,37,4,0,15,14,61
2017,Isaiah Canaan,SG,25,CHI,39,0,592,63,173,0.364,25,94,0.266,38,79,0.481,0.436,30,33,0.909,6,44,50,37,22,1,21,35,181
2017,DeMarre Carroll,SF,30,TOR,72,72,1882,220,550,0.4,109,320,0.341,111,230,0.483,0.499,89,117,0.761,63,212,275,74,81,27,54,143,638
2017,Vince Carter,SF,40,MEM,73,15,1799,193,490,0.394,112,296,0.378,81,194,0.418,0.508,88,115,0.765,36,191,227,133,60,36,50,163,586
2017,Michael Carter-Williams,PG,25,CHI,45,19,846,112,306,0.366,15,64,0.234,97,242,0.401,0.391,58,77,0.753,24,129,153,113,38,23,66,102,297
2017,Omri Casspi,PF,28,SAC,22,2,397,53,117,0.453,11,29,0.379,42,88,0.477,0.5,12,21,0.571,20,70,90,26,10,1,17,23,129
2017,Omri Casspi,PF,28,NOP,1,0,24,5,9,0.556,2,4,0.5,3,5,0.6,0.667,0,0,NA,1,1,2,0,0,0,2,3,12
2017,Omri Casspi,PF,28,MIN,13,0,222,19,38,0.5,2,10,0.2,17,28,0.607,0.526,5,8,0.625,6,14,20,11,13,2,10,24,45
2017,Willie Cauley-Stein,C,23,SAC,75,21,1421,255,481,0.53,0,2,0,255,479,0.532,0.53,101,151,0.669,85,254,339,80,53,44,69,147,611
2017,Tyson Chandler,C,34,PHO,47,46,1298,153,228,0.671,0,0,NA,153,228,0.671,0.671,91,124,0.734,153,386,539,30,33,24,65,126,397
2017,Wilson Chandler,SF,29,DEN,71,33,2197,433,939,0.461,110,326,0.337,323,613,0.527,0.52,141,194,0.727,103,357,460,141,51,30,114,172,1117
2017,Marquese Chriss,PF,19,PHO,82,75,1743,284,632,0.449,72,224,0.321,212,408,0.52,0.506,113,181,0.624,96,252,348,60,67,70,108,263,753
2017,Ian Clark,SG,25,GSW,77,0,1137,211,433,0.487,61,163,0.374,150,270,0.556,0.558,44,58,0.759,22,99,121,90,39,8,55,77,527
2017,Jordan Clarkson,SG,24,LAL,82,19,2397,477,1071,0.445,117,356,0.329,360,715,0.503,0.5,134,168,0.798,49,197,246,213,88,8,164,150,1205
2017,Norris Cole,PG,28,OKC,13,0,125,16,52,0.308,3,13,0.231,13,39,0.333,0.337,8,10,0.8,0,11,11,14,8,0,7,18,43
2017,Quinn Cook,PG,23,DAL,5,0,77,11,25,0.44,5,14,0.357,6,11,0.545,0.54,0,2,0,0,3,3,12,1,0,8,6,27
2017,Quinn Cook,PG,23,NOP,9,0,111,22,41,0.537,6,12,0.5,16,29,0.552,0.61,2,3,0.667,1,3,4,14,3,0,5,7,52
2017,DeMarcus Cousins,C,26,SAC,55,55,1891,505,1118,0.452,95,267,0.356,410,851,0.482,0.494,423,549,0.77,115,468,583,266,75,74,207,203,1528
2017,DeMarcus Cousins,C,26,NOP,17,17,574,142,314,0.452,36,96,0.375,106,218,0.486,0.51,94,121,0.777,37,174,211,66,25,19,62,75,414
2017,Robert Covington,SF,26,PHI,67,67,2119,292,732,0.399,137,412,0.333,155,320,0.484,0.492,143,174,0.822,92,344,436,102,127,69,131,203,864
2017,Allen Crabbe,SG,24,POR,79,7,2254,303,647,0.468,134,302,0.444,169,345,0.49,0.572,105,124,0.847,19,207,226,94,54,20,62,171,845
2017,Jamal Crawford,SG,36,LAC,82,1,2157,359,870,0.413,116,322,0.36,243,548,0.443,0.479,174,203,0.857,17,112,129,214,61,14,134,115,1008
2017,Jordan Crawford,SG,28,NOP,19,0,442,105,218,0.482,37,95,0.389,68,123,0.553,0.567,20,26,0.769,4,30,34,57,11,2,25,30,267
2017,Jae Crowder,SF,26,BOS,72,72,2335,333,720,0.463,157,394,0.398,176,326,0.54,0.572,176,217,0.811,48,367,415,155,73,23,80,161,999
2017,Dante Cunningham,PF,29,NOP,66,35,1649,174,359,0.485,71,181,0.392,103,178,0.579,0.584,16,27,0.593,56,221,277,37,39,28,28,100,435
2017,Seth Curry,PG,26,DAL,70,42,2029,338,703,0.481,137,322,0.425,201,381,0.528,0.578,85,100,0.85,25,154,179,189,79,7,92,126,898
2017,Troy Daniels,SG,25,MEM,67,3,1183,185,495,0.374,138,355,0.389,47,140,0.336,0.513,43,54,0.796,22,78,100,46,20,4,45,90,551
2017,Ed Davis,PF,27,POR,46,12,789,75,142,0.528,0,0,NA,75,142,0.528,0.528,50,81,0.617,96,148,244,26,15,22,37,137,200
2017,Dewayne Dedmon,C,27,SAS,76,37,1330,161,259,0.622,0,0,NA,161,259,0.622,0.622,65,93,0.699,129,367,496,44,37,61,61,180,387
2017,Sam Dekker,PF,22,HOU,77,2,1419,203,429,0.473,60,187,0.321,143,242,0.591,0.543,38,68,0.559,94,190,284,76,38,21,41,83,504
2017,Matthew Dellavedova,PG,26,MIL,76,54,1986,208,534,0.39,79,215,0.367,129,319,0.404,0.463,82,96,0.854,24,123,147,357,53,0,133,153,577
2017,Luol Deng,SF,31,LAL,56,49,1486,164,424,0.387,51,165,0.309,113,259,0.436,0.447,46,63,0.73,63,232,295,74,48,20,43,61,425
2017,Boris Diaw,PF,34,UTA,73,33,1283,146,327,0.446,20,81,0.247,126,246,0.512,0.477,26,35,0.743,46,112,158,170,18,9,87,83,338
2017,Gorgui Dieng,PF,27,MIN,82,82,2653,332,661,0.502,16,43,0.372,316,618,0.511,0.514,136,167,0.814,188,459,647,158,88,95,107,254,816
2017,Toney Douglas,PG,30,MEM,24,0,394,43,117,0.368,7,42,0.167,36,75,0.48,0.397,24,29,0.828,13,48,61,56,18,5,21,50,117
2017,Goran Dragić,PG,30,MIA,73,73,2459,534,1124,0.475,117,289,0.405,417,835,0.499,0.527,298,377,0.79,62,217,279,423,89,13,212,199,1483
2017,Andre Drummond,C,23,DET,81,81,2409,483,911,0.53,2,7,0.286,481,904,0.532,0.531,137,355,0.386,345,770,1115,90,124,89,152,237,1105
2017,Jared Dudley,PF,31,PHO,64,7,1362,157,346,0.454,77,203,0.379,80,143,0.559,0.565,43,65,0.662,31,194,225,121,42,16,73,154,434
2017,Mike Dunleavy,SF,36,CLE,23,2,366,36,90,0.4,20,57,0.351,16,33,0.485,0.511,14,19,0.737,5,42,47,20,6,2,14,32,106
2017,Mike Dunleavy,SF,36,ATL,30,0,475,57,130,0.438,33,77,0.429,24,53,0.453,0.565,22,26,0.846,13,55,68,30,9,5,14,35,169
2017,Jarell Eddie,SF,25,PHO,5,0,62,6,19,0.316,4,16,0.25,2,3,0.667,0.421,8,9,0.889,1,6,7,0,1,0,1,1,24
2017,Henry Ellenson,PF,20,DET,19,2,146,23,64,0.359,10,35,0.286,13,29,0.448,0.438,4,8,0.5,8,33,41,7,1,1,14,6,60
2017,Wayne Ellington,SG,29,MIA,62,13,1500,231,555,0.416,149,394,0.378,82,161,0.509,0.55,37,43,0.86,18,114,132,70,35,4,30,70,648
2017,Monta Ellis,SG,31,IND,74,33,1998,247,557,0.443,43,135,0.319,204,422,0.483,0.482,93,128,0.727,19,185,204,236,78,27,135,149,630
2017,James Ennis III,SF,26,MEM,64,28,1501,146,321,0.455,51,137,0.372,95,184,0.516,0.534,86,110,0.782,69,190,259,64,46,19,59,165,429
2017,Tyler Ennis,PG,22,HOU,31,0,196,25,64,0.391,6,16,0.375,19,48,0.396,0.438,2,3,0.667,4,15,19,34,6,0,24,29,58
2017,Tyler Ennis,PG,22,LAL,22,2,392,65,144,0.451,21,54,0.389,44,90,0.489,0.524,19,22,0.864,5,21,26,52,19,2,21,29,170
2017,Tyreke Evans,SF,27,NOP,26,0,474,91,227,0.401,21,70,0.3,70,157,0.446,0.447,45,58,0.776,6,80,86,91,23,4,39,41,248
2017,Tyreke Evans,SF,27,SAC,14,6,314,59,143,0.413,21,48,0.438,38,95,0.4,0.486,24,34,0.706,7,44,51,33,12,5,22,19,163
2017,Dante Exum,PG,21,UTA,66,26,1228,155,363,0.427,44,149,0.295,111,214,0.519,0.488,58,73,0.795,30,102,132,111,21,12,80,146,412
2017,Kenneth Faried,PF,27,DEN,61,34,1296,228,416,0.548,0,6,0,228,410,0.556,0.548,131,189,0.693,183,279,462,55,43,40,59,124,587
2017,Derrick Favors,PF,25,UTA,50,39,1186,203,417,0.487,3,10,0.3,200,407,0.491,0.49,67,109,0.615,92,213,305,56,45,40,60,103,476
2017,Kay Felder,PG,21,CLE,42,0,386,62,158,0.392,7,22,0.318,55,136,0.404,0.415,35,49,0.714,3,38,41,58,18,7,30,38,166
2017,Raymond Felton,PG,32,LAC,80,11,1700,221,514,0.43,46,144,0.319,175,370,0.473,0.475,50,64,0.781,33,185,218,191,66,22,83,125,538
2017,Yogi Ferrell,PG,23,BRK,10,0,151,18,49,0.367,8,27,0.296,10,22,0.455,0.449,10,16,0.625,4,8,12,17,2,2,14,11,54
2017,Yogi Ferrell,PG,23,DAL,36,29,1046,142,345,0.412,60,149,0.403,82,196,0.418,0.499,64,73,0.877,16,83,99,155,40,7,56,79,408
2017,Evan Fournier,SG,24,ORL,68,66,2234,408,930,0.439,128,360,0.356,280,570,0.491,0.508,223,277,0.805,44,165,209,202,66,4,141,180,1167
2017,Randy Foye,SG,33,BRK,69,40,1284,118,325,0.363,67,203,0.33,51,122,0.418,0.466,54,63,0.857,9,146,155,135,35,9,80,99,357
2017,Tim Frazier,PG,26,NOP,65,35,1525,163,404,0.403,40,128,0.313,123,276,0.446,0.453,98,129,0.76,34,139,173,335,56,6,101,133,464
2017,Enes Freedom,C,24,OKC,72,0,1533,402,737,0.545,5,38,0.132,397,699,0.568,0.549,224,285,0.786,195,287,482,67,32,38,123,154,1033
2017,Channing Frye,C,33,CLE,74,15,1398,238,520,0.458,137,335,0.409,101,185,0.546,0.589,63,74,0.851,37,253,290,45,33,37,53,138,676
2017,Danilo Gallinari,SF,28,DEN,63,63,2134,335,750,0.447,126,324,0.389,209,426,0.491,0.531,349,387,0.902,39,286,325,135,40,15,82,93,1145
2017,Langston Galloway,PG,25,NOP,55,0,1120,165,441,0.374,101,268,0.377,64,173,0.37,0.489,40,52,0.769,20,101,121,65,40,5,28,76,471
2017,Langston Galloway,PG,25,SAC,19,2,375,42,104,0.404,19,40,0.475,23,64,0.359,0.495,11,12,0.917,7,28,35,28,6,1,18,20,114
2017,Marc Gasol,C,32,MEM,74,74,2531,532,1160,0.459,104,268,0.388,428,892,0.48,0.503,278,332,0.837,60,404,464,338,67,99,166,171,1446
2017,Pau Gasol,C,36,SAS,64,39,1627,303,604,0.502,56,104,0.538,247,500,0.494,0.548,130,184,0.707,107,394,501,150,24,70,81,110,792
2017,Rudy Gay,SF,30,SAC,30,30,1013,201,442,0.455,42,113,0.372,159,329,0.483,0.502,118,138,0.855,35,155,190,83,44,26,74,79,562
2017,Alonzo Gee,SF,29,DEN,13,0,89,3,14,0.214,0,3,0,3,11,0.273,0.214,5,9,0.556,4,11,15,6,5,1,4,14,11
2017,Taj Gibson,PF,31,CHI,55,55,1502,276,530,0.521,2,12,0.167,274,518,0.529,0.523,85,119,0.714,120,262,382,60,27,50,77,123,639
2017,Taj Gibson,PF,31,OKC,23,16,487,89,179,0.497,1,1,1,88,178,0.494,0.5,28,39,0.718,38,65,103,13,14,15,28,40,207
2017,Archie Goodwin,SG,22,NOP,3,0,30,2,5,0.4,1,2,0.5,1,3,0.333,0.5,10,10,1,0,0,0,1,0,1,0,1,15
2017,Archie Goodwin,SG,22,BRK,12,0,184,34,61,0.557,4,13,0.308,30,48,0.625,0.59,23,32,0.719,7,21,28,23,4,4,14,7,95
2017,Aaron Gordon,SF,21,ORL,80,72,2298,393,865,0.454,77,267,0.288,316,598,0.528,0.499,156,217,0.719,116,289,405,150,65,40,89,172,1019
2017,Marcin Gortat,C,32,WAS,82,82,2556,390,674,0.579,0,2,0,390,672,0.58,0.579,103,159,0.648,238,611,849,121,40,61,119,213,883
2017,Treveon Graham,SG,23,CHO,27,1,189,19,40,0.475,9,15,0.6,10,25,0.4,0.588,10,15,0.667,5,17,22,6,6,1,3,18,57
2017,Jerami Grant,PF,22,PHI,2,0,41,6,17,0.353,0,2,0,6,15,0.4,0.353,4,8,0.5,0,6,6,0,0,4,3,5,16
2017,Jerami Grant,PF,22,OKC,78,4,1490,146,311,0.469,43,114,0.377,103,197,0.523,0.539,86,139,0.619,38,161,199,46,33,75,41,144,421
2017,Gerald Green,SF,31,BOS,47,0,538,95,232,0.409,39,111,0.351,56,121,0.463,0.494,33,41,0.805,16,68,84,33,9,7,25,48,262
2017,JaMychal Green,PF,26,MEM,77,75,2101,250,500,0.5,55,145,0.379,195,355,0.549,0.555,134,167,0.802,167,377,544,84,47,34,94,248,689
2017,Jeff Green,PF,30,ORL,69,11,1534,220,558,0.394,53,193,0.275,167,365,0.458,0.442,145,168,0.863,39,175,214,81,37,13,75,103,638
2017,Blake Griffin,PF,27,LAC,61,61,2076,479,971,0.493,38,113,0.336,441,858,0.514,0.513,320,421,0.76,112,385,497,300,57,22,142,157,1316
2017,Justin Hamilton,C,26,BRK,64,7,1177,174,379,0.459,55,180,0.306,119,199,0.598,0.532,39,52,0.75,71,191,262,55,29,43,43,91,442
2017,Tim Hardaway Jr.,SG,24,ATL,79,30,2154,415,912,0.455,149,417,0.357,266,495,0.537,0.537,164,214,0.766,35,189,224,182,55,15,106,103,1143
2017,James Harden,PG,27,HOU,81,81,2947,674,1533,0.44,262,756,0.347,412,777,0.53,0.525,746,881,0.847,95,564,659,907,121,38,464,215,2356
2017,Maurice Harkless,SF,23,POR,77,69,2223,314,624,0.503,68,194,0.351,246,430,0.572,0.558,77,124,0.621,125,216,341,88,85,70,86,214,773
2017,Devin Harris,PG,33,DAL,65,0,1087,136,341,0.399,58,177,0.328,78,164,0.476,0.484,107,129,0.829,11,116,127,136,43,7,57,101,437
2017,Gary Harris,SG,22,DEN,57,56,1782,320,637,0.502,107,255,0.42,213,382,0.558,0.586,104,134,0.776,48,130,178,164,71,8,76,92,851
2017,Tobias Harris,PF,24,DET,82,48,2567,511,1063,0.481,109,314,0.347,402,749,0.537,0.532,190,226,0.841,63,353,416,142,60,39,96,133,1321
2017,Andrew Harrison,PG,22,MEM,72,18,1474,117,360,0.325,43,156,0.276,74,204,0.363,0.385,148,194,0.763,23,113,136,198,53,21,85,194,425
2017,Spencer Hawes,PF,28,CHO,35,1,626,104,218,0.477,16,55,0.291,88,163,0.54,0.514,30,34,0.882,32,114,146,62,13,26,40,61,254
2017,Spencer Hawes,PF,28,MIL,19,0,171,30,59,0.508,9,26,0.346,21,33,0.636,0.585,14,18,0.778,6,39,45,19,2,4,9,16,83
2017,Gerald Henderson,SG,29,PHI,72,41,1667,234,553,0.423,61,173,0.353,173,380,0.455,0.478,133,165,0.806,34,151,185,112,40,15,62,129,662
2017,John Henson,C,26,MIL,58,39,1123,159,309,0.515,0,1,0,159,308,0.516,0.515,74,107,0.692,92,203,295,57,29,78,52,151,392
2017,Juancho Hernangómez,PF,21,DEN,62,9,842,101,224,0.451,46,113,0.407,55,111,0.495,0.554,57,76,0.75,43,144,187,29,30,12,31,62,305
2017,Willy Hernangómez,C,22,NYK,72,22,1324,246,465,0.529,4,15,0.267,242,450,0.538,0.533,91,125,0.728,170,332,502,96,41,36,100,150,587
2017,Roy Hibbert,C,30,CHO,42,13,671,78,144,0.542,0,0,NA,78,144,0.542,0.542,61,75,0.813,53,97,150,20,8,44,31,97,217
2017,Roy Hibbert,C,30,DEN,6,0,11,2,3,0.667,0,0,NA,2,3,0.667,0.667,0,0,NA,1,1,2,1,0,2,1,3,4
2017,Buddy Hield,SG,24,NOP,57,37,1161,185,471,0.393,89,241,0.369,96,230,0.417,0.487,29,33,0.879,19,147,166,77,18,7,48,81,488
2017,Buddy Hield,SG,24,SAC,25,18,727,142,296,0.48,59,138,0.428,83,158,0.525,0.579,35,43,0.814,16,87,103,44,20,2,53,34,378
2017,Nenê,C,34,HOU,67,8,1198,245,397,0.617,3,9,0.333,242,388,0.624,0.621,116,197,0.589,95,187,282,65,56,39,73,163,609
2017,George Hill,PG,30,UTA,49,49,1544,289,606,0.477,94,233,0.403,195,373,0.523,0.554,157,196,0.801,23,144,167,204,50,11,85,114,829
2017,Jordan Hill,C,29,MIN,7,0,47,5,13,0.385,0,0,NA,5,13,0.385,0.385,2,2,1,8,6,14,0,1,0,4,9,12
2017,Solomon Hill,SF,25,NOP,80,71,2374,183,478,0.383,94,270,0.348,89,208,0.428,0.481,103,128,0.805,51,256,307,141,72,32,82,182,563
2017,Justin Holiday,SG,27,NYK,82,4,1639,233,538,0.433,97,273,0.355,136,265,0.513,0.523,66,80,0.825,27,198,225,102,65,31,66,109,629
2017,Rodney Hood,SG,24,UTA,59,55,1593,272,666,0.408,114,307,0.371,158,359,0.44,0.494,90,115,0.783,16,186,202,96,38,11,65,132,748
2017,Kris Humphries,PF,31,ATL,56,4,689,87,214,0.407,19,54,0.352,68,160,0.425,0.451,64,82,0.78,60,146,206,29,15,21,28,69,257
2017,Serge Ibaka,PF,27,ORL,56,56,1710,343,703,0.488,83,214,0.388,260,489,0.532,0.547,77,91,0.846,100,282,382,60,34,91,66,139,846
2017,Serge Ibaka,PF,27,TOR,23,23,712,128,279,0.459,41,103,0.398,87,176,0.494,0.532,30,34,0.882,29,127,156,15,7,33,39,76,327
2017,Ersan İlyasova,PF,29,OKC,3,0,62,6,16,0.375,3,12,0.25,3,4,0.75,0.469,0,0,NA,2,14,16,1,3,1,4,5,15
2017,Ersan İlyasova,PF,29,PHI,53,40,1447,285,648,0.44,107,298,0.359,178,350,0.509,0.522,109,142,0.768,71,243,314,97,33,14,78,133,786
2017,Ersan İlyasova,PF,29,ATL,26,12,633,93,226,0.412,32,92,0.348,61,134,0.455,0.482,52,65,0.8,42,109,151,43,22,8,34,73,270
2017,Jarrett Jack,PG,33,NOP,2,0,33,2,3,0.667,0,1,0,2,2,1,0.667,2,2,1,0,0,0,5,2,0,3,4,6
2017,Demetrius Jackson,PG,22,BOS,5,0,17,3,4,0.75,1,1,1,2,3,0.667,0.875,3,6,0.5,2,2,4,3,0,0,0,0,10
2017,Reggie Jackson,PG,26,DET,52,50,1424,284,677,0.419,66,184,0.359,218,493,0.442,0.468,118,136,0.868,21,93,114,270,35,5,114,129,752
2017,Richard Jefferson,SF,36,CLE,79,13,1614,153,343,0.446,62,186,0.333,91,157,0.58,0.536,80,108,0.741,28,175,203,78,26,10,52,153,448
2017,John Jenkins,SG,25,PHO,4,0,13,2,5,0.4,1,2,0.5,1,3,0.333,0.5,2,2,1,0,1,1,1,0,0,0,0,7
2017,Brandon Jennings,PG,27,NYK,58,11,1428,163,429,0.38,68,200,0.34,95,229,0.415,0.459,102,135,0.756,21,131,152,287,55,4,106,84,496
2017,Brandon Jennings,PG,27,WAS,23,2,374,29,106,0.274,11,52,0.212,18,54,0.333,0.325,12,17,0.706,8,36,44,108,15,0,22,32,81
2017,Jonas Jerebko,PF,29,BOS,78,6,1232,114,262,0.435,45,130,0.346,69,132,0.523,0.521,26,37,0.703,59,213,272,71,25,17,39,122,299
2017,Brice Johnson,PF,22,LAC,3,0,9,2,7,0.286,0,0,NA,2,7,0.286,0.286,0,0,NA,1,2,3,1,2,1,1,0,4
2017,James Johnson,PF,29,MIA,76,5,2085,368,769,0.479,87,256,0.34,281,513,0.548,0.535,152,215,0.707,66,310,376,276,76,86,171,197,975
2017,Joe Johnson,SF,35,UTA,78,14,1843,273,626,0.436,106,258,0.411,167,368,0.454,0.521,63,77,0.818,33,210,243,144,36,18,69,93,715
2017,Stanley Johnson,SF,20,DET,77,1,1371,129,365,0.353,45,154,0.292,84,211,0.398,0.415,36,53,0.679,36,153,189,105,56,24,71,121,339
2017,Tyler Johnson,PG,24,MIA,73,0,2178,357,824,0.433,93,250,0.372,264,574,0.46,0.49,195,254,0.768,50,243,293,233,84,44,90,176,1002
2017,Wesley Johnson,SF,29,LAC,68,3,810,73,200,0.365,29,118,0.246,44,82,0.537,0.438,11,17,0.647,26,155,181,23,29,30,18,83,186
2017,Dahntay Jones,SF,36,CLE,1,0,12,3,8,0.375,0,2,0,3,6,0.5,0.375,3,4,0.75,1,1,2,1,0,0,1,1,9
2017,Damian Jones,C,21,GSW,10,0,85,8,16,0.5,0,0,NA,8,16,0.5,0.5,3,10,0.3,9,14,23,0,1,4,6,15,19
2017,Derrick Jones Jr.,SF,19,PHO,32,8,545,68,121,0.562,3,11,0.273,65,110,0.591,0.574,29,41,0.707,39,40,79,12,14,13,13,63,168
2017,Terrence Jones,PF,25,NOP,51,12,1264,231,489,0.472,19,75,0.253,212,414,0.512,0.492,103,170,0.606,65,238,303,59,39,53,48,67,584
2017,Terrence Jones,PF,25,MIL,3,0,6,0,3,0,0,0,NA,0,3,0,0,0,0,NA,0,3,3,0,1,1,0,0,0
2017,DeAndre Jordan,C,28,LAC,81,81,2570,412,577,0.714,0,2,0,412,575,0.717,0.714,205,425,0.482,298,816,1114,96,51,134,115,212,1029
2017,Cory Joseph,PG,25,TOR,80,22,2003,299,661,0.452,48,135,0.356,251,526,0.477,0.489,94,122,0.77,51,184,235,265,66,13,108,140,740
2017,Michael Kidd-Gilchrist,SF,23,CHO,81,81,2349,295,618,0.477,1,9,0.111,294,609,0.483,0.478,152,194,0.784,156,409,565,114,81,77,56,187,743
2017,Sean Kilpatrick,SG,27,BRK,70,24,1754,305,735,0.415,105,308,0.341,200,427,0.468,0.486,204,242,0.843,22,258,280,157,45,6,135,118,919
2017,Brandon Knight,SG,25,PHO,54,5,1140,209,525,0.398,45,139,0.324,164,386,0.425,0.441,132,154,0.857,25,93,118,130,27,5,88,87,595
2017,Kyle Korver,SG,35,ATL,32,21,894,108,246,0.439,65,159,0.409,43,87,0.494,0.571,24,27,0.889,0,89,89,75,23,13,40,47,305
2017,Kyle Korver,SG,35,CLE,35,1,859,131,269,0.487,97,200,0.485,34,69,0.493,0.667,14,15,0.933,7,90,97,35,11,8,29,60,373
2017,Kosta Koufos,C,27,SAC,71,62,1419,216,392,0.551,0,1,0,216,391,0.552,0.551,38,62,0.613,118,285,403,47,36,48,61,172,470
2017,Skal Labissière,PF,20,SAC,33,12,612,117,218,0.537,3,8,0.375,114,210,0.543,0.544,52,74,0.703,51,111,162,27,16,13,37,64,289
2017,Joffrey Lauvergne,PF,25,OKC,50,0,739,111,244,0.455,27,78,0.346,84,166,0.506,0.51,37,58,0.638,51,132,183,51,18,6,40,71,286
2017,Joffrey Lauvergne,C,25,CHI,20,1,241,37,92,0.402,6,20,0.3,31,72,0.431,0.435,9,15,0.6,21,47,68,19,7,0,16,12,89
2017,Ty Lawson,PG,29,SAC,69,24,1732,237,522,0.454,34,118,0.288,203,404,0.502,0.487,173,217,0.797,44,135,179,334,74,6,129,119,681
2017,Courtney Lee,SG,31,NYK,77,74,2459,321,704,0.456,108,269,0.401,213,435,0.49,0.533,85,98,0.867,53,206,259,179,81,24,69,141,835
2017,David Lee,PF,33,SAS,79,10,1477,248,420,0.59,0,0,NA,248,420,0.59,0.59,80,113,0.708,149,292,441,124,31,40,82,125,576
2017,Alex Len,C,23,PHO,77,34,1560,230,463,0.497,3,12,0.25,227,451,0.503,0.5,150,208,0.721,156,354,510,44,38,98,102,242,613
2017,Jon Leuer,PF,27,DET,75,34,1944,310,646,0.48,49,167,0.293,261,479,0.545,0.518,98,113,0.867,102,300,402,111,31,26,66,145,767
2017,Caris LeVert,SF,22,BRK,57,26,1237,171,380,0.45,59,184,0.321,112,196,0.571,0.528,67,93,0.72,23,165,188,110,49,8,59,91,468
2017,DeAndre Liggins,SG,28,CLE,61,19,752,52,136,0.382,17,45,0.378,35,91,0.385,0.445,23,37,0.622,17,84,101,54,45,14,42,78,144
2017,DeAndre Liggins,SG,28,DAL,1,0,25,3,6,0.5,0,1,0,3,5,0.6,0.5,2,3,0.667,3,4,7,0,2,0,0,3,8
2017,Jeremy Lin,PG,28,BRK,36,33,883,175,400,0.438,58,156,0.372,117,244,0.48,0.51,115,141,0.816,11,124,135,184,42,14,86,79,523
2017,Shaun Livingston,PG,31,GSW,76,3,1345,173,316,0.547,1,3,0.333,172,313,0.55,0.549,42,60,0.7,28,123,151,139,38,20,62,120,389
2017,Kyle Lowry,PG,30,TOR,60,60,2244,426,918,0.464,193,468,0.412,233,450,0.518,0.569,299,365,0.819,48,238,286,417,88,19,173,170,1344
2017,Timothé Luwawu-Cabarrot,SF,21,PHI,69,19,1190,145,361,0.402,50,161,0.311,95,200,0.475,0.471,105,123,0.854,25,124,149,75,32,10,73,154,445
2017,Shelvin Mack,PG,26,UTA,55,9,1205,170,381,0.446,37,120,0.308,133,261,0.51,0.495,53,77,0.688,20,105,125,154,42,3,90,100,430
2017,Thon Maker,C,19,MIL,57,34,562,83,181,0.459,28,74,0.378,55,107,0.514,0.536,32,49,0.653,40,74,114,23,10,26,17,84,226
2017,Boban Marjanović,C,28,DET,35,0,293,72,132,0.545,0,0,NA,72,132,0.545,0.545,47,58,0.81,46,84,130,9,6,12,10,25,191
2017,Wesley Matthews,SG,30,DAL,73,73,2495,333,847,0.393,174,479,0.363,159,368,0.432,0.496,146,179,0.816,18,241,259,210,77,15,102,161,986
2017,Luc Mbah a Moute,SF,30,LAC,80,76,1787,191,378,0.505,43,110,0.391,148,268,0.552,0.562,59,87,0.678,44,126,170,39,81,35,46,122,484
2017,Patrick McCaw,SG,21,GSW,71,20,1074,106,245,0.433,41,123,0.333,65,122,0.533,0.516,29,37,0.784,21,79,100,77,32,15,36,62,282
2017,Chris McCullough,PF,21,BRK,14,0,72,16,31,0.516,1,6,0.167,15,25,0.6,0.532,2,3,0.667,9,8,17,2,1,2,2,7,35
2017,Chris McCullough,PF,21,WAS,2,0,8,0,1,0,0,1,0,0,0,NA,0,1,2,0.5,0,2,2,0,1,0,1,0,1
2017,K.J. McDaniels,SF,23,HOU,29,0,212,31,68,0.456,9,27,0.333,22,41,0.537,0.522,9,10,0.9,6,24,30,4,7,8,10,24,80
2017,K.J. McDaniels,SF,23,BRK,20,0,293,46,101,0.455,11,39,0.282,35,62,0.565,0.51,23,28,0.821,9,43,52,9,12,10,19,25,126
2017,Doug McDermott,SF,25,CHI,44,4,1078,166,373,0.445,56,150,0.373,110,223,0.493,0.52,59,67,0.881,14,116,130,45,11,4,32,57,447
2017,Doug McDermott,SF,25,OKC,22,1,430,56,124,0.452,21,58,0.362,35,66,0.53,0.536,12,17,0.706,6,43,49,13,2,1,6,22,145
2017,JaVale McGee,C,29,GSW,77,10,739,208,319,0.652,0,3,0,208,316,0.658,0.652,56,111,0.505,100,144,244,17,19,67,40,109,472
2017,Ben McLemore,SG,23,SAC,61,26,1176,180,419,0.43,65,170,0.382,115,249,0.462,0.507,70,93,0.753,19,110,129,51,29,6,62,108,495
2017,Jordan McRae,SG,25,CLE,37,4,384,58,150,0.387,18,51,0.353,40,99,0.404,0.447,27,34,0.794,6,35,41,19,8,6,14,31,161
2017,Josh McRoberts,PF,29,MIA,22,14,381,44,118,0.373,13,31,0.419,31,87,0.356,0.428,6,9,0.667,23,51,74,50,10,4,23,31,107
2017,Jodie Meeks,SG,29,ORL,36,10,738,103,256,0.402,56,137,0.409,47,119,0.395,0.512,65,74,0.878,5,72,77,45,34,4,36,41,327
2017,C.J. Miles,SF,29,IND,76,29,1776,281,647,0.434,169,409,0.413,112,238,0.471,0.565,84,93,0.903,30,199,229,48,46,25,40,151,815
2017,Mike Miller,SF,36,DEN,20,0,151,9,23,0.391,8,20,0.4,1,3,0.333,0.565,2,2,1,2,36,38,22,2,0,13,9,28
2017,Nikola Mirotić,PF,25,CHI,70,15,1679,258,625,0.413,129,377,0.342,129,248,0.52,0.516,99,128,0.773,61,323,384,75,53,55,80,128,744
2017,Greg Monroe,C,26,MIL,81,0,1823,387,726,0.533,0,4,0,387,722,0.536,0.533,177,239,0.741,167,365,532,187,92,38,140,168,951
2017,Marcus Morris,SF,27,DET,79,79,2565,421,1007,0.418,118,357,0.331,303,650,0.466,0.477,145,185,0.784,77,289,366,160,52,25,87,168,1105
2017,Markieff Morris,PF,27,WAS,76,76,2374,406,889,0.457,71,196,0.362,335,693,0.483,0.497,180,215,0.837,107,386,493,126,82,42,129,254,1063
2017,Anthony Morrow,SG,31,OKC,40,7,627,86,223,0.386,35,119,0.294,51,104,0.49,0.464,23,26,0.885,11,18,29,19,22,2,6,40,230
2017,Anthony Morrow,SG,31,CHI,9,0,87,12,29,0.414,6,14,0.429,6,15,0.4,0.517,11,11,1,1,1,2,6,2,0,0,4,41
2017,Timofey Mozgov,C,30,LAL,54,52,1104,169,328,0.515,0,1,0,169,327,0.517,0.515,63,78,0.808,104,160,264,43,16,31,72,133,401
2017,Emmanuel Mudiay,PG,20,DEN,55,41,1406,208,551,0.377,56,178,0.315,152,373,0.408,0.428,131,167,0.784,29,149,178,217,41,13,123,95,603
2017,Shabazz Muhammad,SF,24,MIN,78,1,1516,288,598,0.482,49,145,0.338,239,453,0.528,0.523,147,190,0.774,84,136,220,35,22,6,56,86,772
2017,Mike Muscala,C,25,ATL,70,3,1237,170,337,0.504,46,110,0.418,124,227,0.546,0.573,49,64,0.766,76,164,240,95,30,41,55,97,435
2017,Larry Nance Jr.,PF,24,LAL,63,7,1442,190,361,0.526,10,36,0.278,180,325,0.554,0.54,59,80,0.738,120,249,369,96,82,39,56,149,449
2017,Shabazz Napier,PG,25,POR,53,2,512,73,183,0.399,34,92,0.37,39,91,0.429,0.492,38,49,0.776,8,53,61,67,32,2,41,38,218
2017,Gary Neal,SG,32,ATL,2,0,18,0,7,0,0,2,0,0,5,0,0,4,4,1,0,1,1,1,0,0,0,1,4
2017,Jameer Nelson,PG,34,DEN,75,39,2045,268,604,0.444,106,273,0.388,162,331,0.489,0.531,45,63,0.714,28,164,192,385,54,8,128,197,687
2017,Andrew Nicholson,PF,27,WAS,28,0,231,30,77,0.39,3,16,0.188,27,61,0.443,0.409,7,12,0.583,11,23,34,7,11,6,11,37,70
2017,Andrew Nicholson,PF,27,BRK,10,0,111,13,34,0.382,2,11,0.182,11,23,0.478,0.412,2,2,1,4,23,27,3,5,0,6,18,30
2017,Nerlens Noel,C,22,PHI,29,7,564,107,175,0.611,0,1,0,107,174,0.615,0.611,43,63,0.683,46,98,144,30,43,26,29,71,257
2017,Nerlens Noel,C,22,DAL,22,12,483,77,134,0.575,0,0,NA,77,134,0.575,0.575,34,48,0.708,47,103,150,20,22,24,22,55,188
2017,Steve Novak,PF,33,MIL,8,0,22,2,7,0.286,1,6,0.167,1,1,1,0.357,0,0,NA,0,3,3,0,0,0,0,1,5
2017,Jusuf Nurkić,C,22,DEN,45,29,807,151,298,0.507,0,0,NA,151,298,0.507,0.507,56,113,0.496,89,171,260,60,25,36,81,88,358
2017,Jusuf Nurkić,C,22,POR,20,19,584,120,236,0.508,0,1,0,120,235,0.511,0.508,64,97,0.66,65,142,207,63,25,38,62,73,304
2017,Johnny O'Bryant,PF,23,DEN,7,0,46,7,15,0.467,2,3,0.667,5,12,0.417,0.533,4,4,1,5,6,11,2,0,1,3,4,20
2017,Johnny O'Bryant,PF,23,CHO,4,0,34,8,15,0.533,1,3,0.333,7,12,0.583,0.567,1,2,0.5,4,4,8,4,0,0,3,6,18
2017,Jahlil Okafor,C,21,PHI,50,33,1134,242,471,0.514,0,0,NA,242,471,0.514,0.514,106,158,0.671,81,159,240,58,20,49,91,122,590
2017,Victor Oladipo,SG,24,OKC,67,67,2222,412,932,0.442,127,352,0.361,285,580,0.491,0.51,116,154,0.753,39,252,291,176,78,21,119,155,1067
2017,Kelly Olynyk,C,25,BOS,75,6,1538,260,508,0.512,68,192,0.354,192,316,0.608,0.579,90,123,0.732,73,288,361,148,43,29,96,207,678
2017,Arinze Onuaku,C,29,ORL,8,0,28,2,4,0.5,0,0,NA,2,4,0.5,0.5,0,0,NA,2,4,6,2,0,1,2,3,4
2017,Kelly Oubre Jr.,SF,21,WAS,79,5,1605,186,442,0.421,54,188,0.287,132,254,0.52,0.482,75,99,0.758,61,200,261,47,58,17,50,195,501
2017,Georgios Papagiannis,C,19,SAC,22,0,355,56,102,0.549,0,2,0,56,100,0.56,0.549,12,14,0.857,24,62,86,20,3,17,24,44,124
2017,Jabari Parker,PF,21,MIL,51,50,1728,399,814,0.49,65,178,0.365,334,636,0.525,0.53,162,218,0.743,79,235,314,142,50,22,93,111,1025
2017,Patrick Patterson,PF,27,TOR,65,8,1599,154,384,0.401,94,253,0.372,60,131,0.458,0.523,43,60,0.717,62,231,293,76,40,23,38,120,445
2017,Adreian Payne,PF,25,MIN,18,0,135,23,54,0.426,3,15,0.2,20,39,0.513,0.454,14,19,0.737,9,24,33,7,8,7,8,32,63
2017,Cameron Payne,PG,22,OKC,20,0,320,43,130,0.331,16,52,0.308,27,78,0.346,0.392,4,4,1,2,29,31,40,10,4,16,38,106
2017,Cameron Payne,PG,22,CHI,11,0,142,21,63,0.333,11,34,0.324,10,29,0.345,0.421,1,4,0.25,1,16,17,15,4,0,13,14,54
2017,Elfrid Payton,PG,22,ORL,82,58,2412,430,912,0.471,40,146,0.274,390,766,0.509,0.493,146,211,0.692,89,298,387,529,88,40,178,177,1046
2017,Gary Payton II,PG,24,MIL,6,0,99,8,22,0.364,1,9,0.111,7,13,0.538,0.386,3,5,0.6,0,12,12,13,3,4,10,9,20
2017,Mason Plumlee,C,26,POR,54,54,1516,235,442,0.532,0,5,0,235,437,0.538,0.532,127,224,0.567,120,312,432,214,50,63,88,149,597
2017,Mason Plumlee,C,26,DEN,27,10,632,99,181,0.547,0,1,0,99,180,0.55,0.547,47,76,0.618,50,123,173,70,19,29,46,77,245
2017,Miles Plumlee,C,28,MIL,32,12,310,30,68,0.441,0,0,NA,30,68,0.441,0.441,22,35,0.629,23,30,53,18,11,9,22,48,82
2017,Miles Plumlee,C,28,CHO,13,0,174,14,24,0.583,0,0,NA,14,24,0.583,0.583,3,4,0.75,15,27,42,3,7,4,8,25,31
2017,Otto Porter Jr.,SF,23,WAS,80,80,2605,414,803,0.516,148,341,0.434,266,462,0.576,0.608,99,119,0.832,118,396,514,121,116,42,44,193,1075
2017,Bobby Portis,PF,21,CHI,64,13,1000,183,375,0.488,32,96,0.333,151,279,0.541,0.531,39,59,0.661,75,221,296,35,16,11,37,94,437
2017,Dwight Powell,C,25,DAL,77,3,1333,194,377,0.515,21,74,0.284,173,303,0.571,0.542,107,141,0.759,93,213,306,49,61,39,34,135,516
2017,Norman Powell,SG,23,TOR,76,18,1368,227,506,0.449,56,173,0.324,171,333,0.514,0.504,126,159,0.792,26,143,169,82,52,14,70,127,636
2017,Taurean Prince,SF,22,ATL,59,10,981,114,285,0.4,33,102,0.324,81,183,0.443,0.458,74,94,0.787,25,132,157,55,43,27,61,96,335
2017,Chasson Randle,PG,23,PHI,8,0,74,12,26,0.462,6,15,0.4,6,11,0.545,0.577,12,12,1,0,5,5,6,3,1,3,11,42
2017,Chasson Randle,PG,23,NYK,18,0,225,28,72,0.389,10,32,0.313,18,40,0.45,0.458,29,31,0.935,6,21,27,28,6,1,16,28,95
2017,Zach Randolph,PF,35,MEM,73,5,1786,433,964,0.449,21,94,0.223,412,870,0.474,0.46,141,193,0.731,182,416,598,122,38,10,99,136,1028
2017,J.J. Redick,SG,32,LAC,78,78,2198,396,890,0.445,201,468,0.429,195,422,0.462,0.558,180,202,0.891,11,160,171,110,54,13,98,125,1173
2017,Willie Reed,C,26,MIA,71,5,1031,162,285,0.568,1,4,0.25,161,281,0.573,0.57,49,88,0.557,129,203,332,26,18,47,31,137,374
2017,Malachi Richardson,SG,21,SAC,22,0,198,28,68,0.412,8,28,0.286,20,40,0.5,0.471,15,19,0.789,3,20,23,11,5,1,8,23,79
2017,Austin Rivers,SG,24,LAC,74,29,2054,323,731,0.442,111,299,0.371,212,432,0.491,0.518,132,191,0.691,20,141,161,204,48,10,115,187,889
2017,Brian Roberts,PG,31,CHO,41,2,416,46,122,0.377,17,44,0.386,29,78,0.372,0.447,33,39,0.846,5,34,39,52,9,1,26,18,142
2017,Glenn Robinson III,SF,23,IND,69,27,1427,158,338,0.467,49,125,0.392,109,213,0.512,0.54,54,76,0.711,57,189,246,47,41,20,37,63,419
2017,Thomas Robinson,PF,25,LAL,48,1,560,105,196,0.536,0,1,0,105,195,0.538,0.536,31,66,0.47,84,139,223,31,26,9,46,76,241
2017,Sergio Rodríguez,PG,30,PHI,68,30,1518,210,536,0.392,92,252,0.365,118,284,0.415,0.478,18,27,0.667,21,136,157,344,49,4,128,95,530
2017,Rajon Rondo,PG,30,CHI,69,42,1843,229,561,0.408,50,133,0.376,179,428,0.418,0.453,30,50,0.6,73,282,355,461,99,11,169,144,538
2017,Derrick Rose,PG,28,NYK,64,64,2082,460,977,0.471,13,60,0.217,447,917,0.487,0.477,221,253,0.874,66,180,246,283,44,17,147,84,1154
2017,Terrence Ross,SF,25,TOR,54,0,1207,211,479,0.441,96,256,0.375,115,223,0.516,0.541,41,50,0.82,14,124,138,45,53,20,33,82,559
2017,Terrence Ross,SF,25,ORL,24,24,748,115,267,0.431,46,135,0.341,69,132,0.523,0.517,23,27,0.852,4,64,68,43,34,13,35,61,299
2017,D'Angelo Russell,PG,20,LAL,63,60,1811,351,867,0.405,135,384,0.352,216,483,0.447,0.483,147,188,0.782,31,190,221,303,87,16,176,130,984
2017,Dario Šarić,PF,22,PHI,81,36,2129,381,927,0.411,106,341,0.311,275,586,0.469,0.468,172,220,0.782,112,401,513,182,57,30,183,162,1040
2017,Mike Scott,PF,28,ATL,18,0,195,17,59,0.288,4,27,0.148,13,32,0.406,0.322,7,8,0.875,10,27,37,17,4,3,8,12,45
2017,Thabo Sefolosha,SF,32,ATL,62,42,1596,174,395,0.441,41,120,0.342,133,275,0.484,0.492,55,75,0.733,54,216,270,107,96,31,58,97,444
2017,Wayne Selden,SG,22,NOP,3,3,47,5,8,0.625,4,7,0.571,1,1,1,0.875,2,4,0.5,0,5,5,1,2,0,3,6,16
2017,Wayne Selden,SG,22,MEM,11,2,189,20,50,0.4,3,21,0.143,17,29,0.586,0.43,12,18,0.667,1,10,11,12,4,1,9,12,55
2017,Ramon Sessions,PG,30,CHO,50,1,811,100,263,0.38,21,62,0.339,79,201,0.393,0.42,91,118,0.771,11,62,73,129,27,3,46,43,312
2017,Iman Shumpert,SG,26,CLE,76,31,1937,201,489,0.411,94,261,0.36,107,228,0.469,0.507,71,90,0.789,39,179,218,109,62,27,78,150,567
2017,Jonathon Simmons,SG,27,SAS,78,8,1392,177,421,0.42,30,102,0.294,147,319,0.461,0.456,99,132,0.75,20,140,160,126,47,25,76,146,483
2017,Kyle Singler,SF,28,OKC,32,2,385,34,83,0.41,7,37,0.189,27,46,0.587,0.452,13,17,0.765,8,40,48,9,7,5,11,29,88
2017,Ish Smith,PG,28,DET,81,32,1955,329,749,0.439,28,105,0.267,301,644,0.467,0.458,72,102,0.706,21,214,235,418,61,33,112,127,758
2017,J.R. Smith,SG,31,CLE,41,35,1187,123,356,0.346,95,271,0.351,28,85,0.329,0.479,10,15,0.667,17,96,113,62,40,11,26,77,351
2017,Jason Smith,C,30,WAS,74,3,1068,174,329,0.529,37,78,0.474,137,251,0.546,0.585,35,51,0.686,64,194,258,37,21,54,58,168,420
2017,Marreese Speights,C,29,LAC,82,2,1286,244,548,0.445,103,277,0.372,141,271,0.52,0.539,120,137,0.876,88,285,373,65,23,41,69,229,711
2017,Nik Stauskas,SG,23,PHI,80,27,2188,251,634,0.396,132,359,0.368,119,275,0.433,0.5,122,150,0.813,21,205,226,188,45,32,128,144,756
2017,Lance Stephenson,SG,26,NOP,6,0,162,26,55,0.473,1,10,0.1,25,45,0.556,0.482,5,8,0.625,3,15,18,29,2,1,11,18,58
2017,Lance Stephenson,SG,26,MIN,6,0,67,10,21,0.476,0,2,0,10,19,0.526,0.476,1,2,0.5,0,10,10,5,0,0,4,2,21
2017,Lance Stephenson,SG,26,IND,6,0,132,18,44,0.409,5,8,0.625,13,36,0.361,0.466,2,3,0.667,1,23,24,25,3,2,11,12,43
2017,Jarnell Stokes,C,23,DEN,2,0,7,1,1,1,0,0,NA,1,1,1,1,1,2,0.5,1,1,2,2,1,0,0,3,3
2017,Edy Tavares,C,24,ATL,1,0,4,1,1,1,0,0,NA,1,1,1,1,0,2,0,0,1,1,0,0,0,0,0,2
2017,Edy Tavares,C,24,CLE,1,0,24,3,4,0.75,0,0,NA,3,4,0.75,0.75,0,1,0,4,6,10,1,0,6,2,3,6
2017,Jeff Teague,PG,28,IND,82,82,2657,402,909,0.442,90,252,0.357,312,657,0.475,0.492,360,415,0.867,33,297,330,639,100,32,216,165,1254
2017,Garrett Temple,SG,30,SAC,65,21,1728,183,432,0.424,82,220,0.373,101,212,0.476,0.519,58,74,0.784,32,152,184,168,84,28,78,141,506
2017,Isaiah Thomas,PG,27,BOS,76,76,2569,682,1473,0.463,245,646,0.379,437,827,0.528,0.546,590,649,0.909,43,162,205,448,70,13,210,167,2199
2017,Lance Thomas,PF,28,NYK,46,15,968,97,244,0.398,38,85,0.447,59,159,0.371,0.475,43,51,0.843,32,110,142,35,21,5,25,85,275
2017,Hollis Thompson,SG,25,PHI,31,1,561,66,159,0.415,26,71,0.366,40,88,0.455,0.497,13,20,0.65,15,69,84,26,14,6,9,55,171
2017,Hollis Thompson,SG,25,NOP,9,8,191,11,41,0.268,6,24,0.25,5,17,0.294,0.341,6,9,0.667,4,24,28,9,6,0,2,14,34
2017,Marcus Thornton,SG,29,WAS,33,1,575,84,210,0.4,28,80,0.35,56,130,0.431,0.467,23,27,0.852,22,54,76,41,19,3,25,48,219
2017,Anthony Tolliver,PF,31,SAC,65,9,1477,155,351,0.442,90,230,0.391,65,121,0.537,0.57,61,82,0.744,51,186,237,77,34,20,56,109,461
2017,Axel Toupane,SF,24,MIL,2,0,6,0,1,0,0,1,0,0,0,NA,0,0,0,NA,0,0,0,0,0,0,0,1,0
2017,Axel Toupane,SF,24,NOP,2,0,41,5,8,0.625,1,3,0.333,4,5,0.8,0.688,0,0,NA,0,1,1,0,1,1,0,5,11
2017,P.J. Tucker,SF,31,PHO,57,17,1627,147,354,0.415,46,136,0.338,101,218,0.463,0.48,61,77,0.792,94,248,342,73,85,14,52,143,401
2017,P.J. Tucker,SF,31,TOR,24,4,609,52,128,0.406,24,60,0.4,28,68,0.412,0.5,11,16,0.688,23,106,129,26,31,5,14,53,139
2017,Evan Turner,SF,28,POR,65,12,1658,235,552,0.426,31,118,0.263,204,434,0.47,0.454,85,103,0.825,36,211,247,205,53,24,100,121,586
2017,Beno Udrih,PG,34,DET,39,0,560,92,197,0.467,11,32,0.344,81,165,0.491,0.495,32,34,0.941,6,51,57,131,13,0,36,29,227
2017,Jarrod Uthoff,PF,23,DAL,9,0,115,16,38,0.421,3,9,0.333,13,29,0.448,0.461,5,7,0.714,8,14,22,9,2,4,3,8,40
2017,Jonas Valančiūnas,C,24,TOR,80,80,2066,391,702,0.557,1,2,0.5,390,700,0.557,0.558,176,217,0.811,226,533,759,57,37,63,106,216,959
2017,Anderson Varejão,C,34,GSW,14,1,92,5,14,0.357,0,0,NA,5,14,0.357,0.357,8,11,0.727,12,15,27,10,3,3,8,16,18
2017,Greivis Vásquez,PG,30,BRK,3,0,39,2,8,0.25,1,3,0.333,1,5,0.2,0.313,2,3,0.667,0,2,2,5,1,1,1,6,7
2017,Rashad Vaughn,SG,20,MIL,41,2,458,57,156,0.365,26,81,0.321,31,75,0.413,0.449,2,5,0.4,4,45,49,23,19,10,14,32,142
2017,Noah Vonleh,PF,21,POR,74,41,1265,130,270,0.481,7,20,0.35,123,250,0.492,0.494,60,94,0.638,131,256,387,31,30,27,64,154,327
2017,Nikola Vučević,C,26,ORL,75,55,2163,483,1031,0.468,23,75,0.307,460,956,0.481,0.48,107,160,0.669,176,603,779,208,76,74,117,180,1096
2017,Sasha Vujačić,SG,32,NYK,42,4,408,42,136,0.309,23,74,0.311,19,62,0.306,0.393,17,24,0.708,12,47,59,52,13,2,16,38,124
2017,Dwyane Wade,SG,35,CHI,60,59,1792,414,955,0.434,45,145,0.31,369,810,0.456,0.457,223,281,0.794,63,207,270,228,86,41,138,112,1096
2017,Dion Waiters,SG,25,MIA,46,43,1384,281,663,0.424,85,215,0.395,196,448,0.438,0.488,82,127,0.646,18,135,153,200,42,20,103,95,729
2017,Briante Weber,PG,24,GSW,7,0,46,5,14,0.357,0,3,0,5,11,0.455,0.357,2,3,0.667,0,4,4,5,3,1,3,4,12
2017,Briante Weber,PG,24,CHO,13,0,159,20,46,0.435,1,7,0.143,19,39,0.487,0.446,9,13,0.692,8,14,22,16,9,0,5,12,50
2017,Andrew Wiggins,SF,21,MIN,82,82,3048,709,1570,0.452,103,289,0.356,606,1281,0.473,0.484,412,542,0.76,102,226,328,189,82,30,187,183,1933
2017,Deron Williams,PG,32,DAL,40,40,1171,195,453,0.43,63,181,0.348,132,272,0.485,0.5,69,84,0.821,13,89,102,274,25,2,98,96,522
2017,Deron Williams,PG,32,CLE,24,4,486,68,147,0.463,22,53,0.415,46,94,0.489,0.537,21,25,0.84,1,44,45,86,6,6,40,42,179
2017,Derrick Williams,PF,25,MIA,25,11,377,54,137,0.394,9,45,0.2,45,92,0.489,0.427,31,50,0.62,16,57,73,14,9,5,14,33,148
2017,Derrick Williams,PF,25,CLE,25,0,427,54,107,0.505,21,52,0.404,33,55,0.6,0.603,27,39,0.692,3,54,57,14,5,2,14,27,156
2017,Lou Williams,SG,30,LAL,58,1,1403,326,734,0.444,122,317,0.385,204,417,0.489,0.527,304,344,0.884,14,118,132,183,65,11,120,67,1078
2017,Lou Williams,SG,30,HOU,23,0,591,102,264,0.386,41,129,0.318,61,135,0.452,0.464,98,113,0.867,12,58,70,56,15,9,40,25,343
2017,Marvin Williams,PF,30,CHO,76,76,2295,297,704,0.422,124,354,0.35,173,350,0.494,0.51,131,150,0.873,89,411,500,106,58,53,60,134,849
2017,Reggie Williams,SF,30,NOP,6,0,79,8,23,0.348,5,11,0.455,3,12,0.25,0.457,6,7,0.857,2,4,6,4,3,0,0,2,27
2017,Troy Williams,SF,22,MEM,24,13,418,51,123,0.415,10,41,0.244,41,82,0.5,0.455,15,25,0.6,6,39,45,19,24,9,26,42,127
2017,Troy Williams,SF,22,HOU,6,3,139,22,44,0.5,8,21,0.381,14,23,0.609,0.591,6,7,0.857,9,15,24,6,3,1,6,18,58
2017,Christian Wood,PF,21,CHO,13,0,107,12,23,0.522,0,5,0,12,18,0.667,0.522,11,15,0.733,14,15,29,2,3,6,7,11,35
2017,Metta World Peace,SF,37,LAL,25,2,160,19,68,0.279,9,38,0.237,10,30,0.333,0.346,10,16,0.625,5,15,20,11,10,2,7,18,57
2017,Brandan Wright,PF,29,MEM,28,5,447,83,135,0.615,0,1,0,83,134,0.619,0.615,23,35,0.657,31,47,78,15,11,20,10,42,189
2017,Delon Wright,PG,24,TOR,27,0,446,49,116,0.422,10,30,0.333,39,86,0.453,0.466,42,55,0.764,16,32,48,57,27,11,25,31,150
2017,Nick Young,SG,31,LAL,60,60,1556,272,633,0.43,170,421,0.404,102,212,0.481,0.564,77,90,0.856,25,113,138,58,37,14,36,137,791
2017,Thaddeus Young,PF,28,IND,74,74,2237,362,687,0.527,45,118,0.381,317,569,0.557,0.56,45,86,0.523,131,317,448,122,113,29,95,135,814
2017,Tyler Zeller,C,27,BOS,51,5,525,78,158,0.494,0,1,0,78,157,0.497,0.494,22,39,0.564,43,81,124,42,7,21,20,61,178
2017,Ivica Zubac,C,19,LAL,38,11,609,126,238,0.529,0,3,0,126,235,0.536,0.529,32,49,0.653,41,118,159,30,14,33,30,66,284
2018,Quincy Acy,PF,27,BRK,70,8,1359,130,365,0.356,102,292,0.349,28,73,0.384,0.496,49,60,0.817,40,217,257,57,33,29,60,149,411
2018,Arron Afflalo,SG,32,ORL,53,3,682,65,162,0.401,27,70,0.386,38,92,0.413,0.485,22,26,0.846,4,62,66,30,4,9,21,56,179
2018,Cole Aldrich,C,29,MIN,21,0,49,5,15,0.333,0,0,NA,5,15,0.333,0.333,2,6,0.333,3,12,15,3,2,1,1,11,12
2018,LaMarcus Aldridge,C,32,SAS,75,75,2509,687,1347,0.51,27,92,0.293,660,1255,0.526,0.52,334,399,0.837,246,389,635,152,43,90,111,161,1735
2018,Jarrett Allen,C,19,BRK,72,31,1441,234,397,0.589,5,15,0.333,229,382,0.599,0.596,114,147,0.776,144,244,388,49,28,88,82,147,587
2018,Al-Farouq Aminu,PF,27,POR,69,67,2072,230,582,0.395,125,339,0.369,105,243,0.432,0.503,59,80,0.738,97,428,525,84,79,40,79,136,644
2018,Justin Anderson,SF,24,PHI,38,0,519,87,202,0.431,34,103,0.33,53,99,0.535,0.515,28,38,0.737,25,68,93,25,15,7,16,54,236
2018,Ryan Anderson,PF,29,HOU,66,50,1725,207,480,0.431,131,339,0.386,76,141,0.539,0.568,72,93,0.774,94,237,331,60,24,21,42,126,617
2018,Carmelo Anthony,PF,33,OKC,78,78,2501,472,1168,0.404,169,474,0.357,303,694,0.437,0.476,148,193,0.767,67,386,453,103,47,49,99,197,1261
2018,Trevor Ariza,SF,32,HOU,67,67,2269,268,651,0.412,170,462,0.368,98,189,0.519,0.542,76,89,0.854,33,261,294,105,98,13,52,132,782
2018,Ömer Aşık,C,31,NOP,14,0,121,7,16,0.438,0,0,NA,7,16,0.438,0.438,4,12,0.333,7,30,37,2,1,2,5,14,18
2018,Ömer Aşık,C,31,CHI,4,0,61,2,6,0.333,0,0,NA,2,6,0.333,0.333,0,1,0,2,8,10,1,1,2,4,6,4
2018,D.J. Augustin,PG,30,ORL,75,36,1760,244,540,0.452,114,272,0.419,130,268,0.485,0.557,164,189,0.868,30,130,160,287,54,0,123,94,766
2018,Luke Babbitt,SF,28,ATL,37,9,570,80,168,0.476,49,111,0.441,31,57,0.544,0.622,17,22,0.773,5,76,81,26,7,5,15,47,226
2018,Luke Babbitt,SF,28,MIA,13,5,145,11,47,0.234,11,45,0.244,0,2,0,0.351,0,0,NA,2,13,15,5,1,2,4,7,33
2018,Ron Baker,SG,24,NYK,29,1,385,20,59,0.339,11,33,0.333,9,26,0.346,0.432,20,26,0.769,5,25,30,47,26,6,18,33,71
2018,Harrison Barnes,PF,25,DAL,77,77,2634,537,1208,0.445,119,333,0.357,418,875,0.478,0.494,259,313,0.827,77,391,468,152,49,14,118,94,1452
2018,Will Barton,SG,27,DEN,81,40,2683,465,1028,0.452,156,422,0.37,309,606,0.51,0.528,182,226,0.805,70,339,409,331,82,52,149,168,1268
2018,Jerryd Bayless,SG,29,PHI,39,11,925,109,262,0.416,54,146,0.37,55,116,0.474,0.519,35,44,0.795,15,65,80,54,23,6,46,91,307
2018,Kent Bazemore,SG,28,ATL,65,65,1789,284,676,0.42,108,274,0.394,176,402,0.438,0.5,160,201,0.796,25,223,248,228,100,45,157,147,836
2018,Malik Beasley,SG,21,DEN,62,0,583,73,178,0.41,28,82,0.341,45,96,0.469,0.489,22,33,0.667,14,57,71,31,15,7,24,36,196
2018,Marco Belinelli,SG,31,ATL,52,1,1210,199,485,0.41,92,247,0.372,107,238,0.45,0.505,101,109,0.927,14,86,100,103,46,3,54,41,591
2018,Marco Belinelli,SG,31,PHI,28,1,737,138,279,0.495,57,148,0.385,81,131,0.618,0.597,47,54,0.87,6,45,51,45,20,9,40,50,380
2018,Jordan Bell,C,23,GSW,57,13,809,116,185,0.627,0,4,0,116,181,0.641,0.627,30,44,0.682,60,147,207,102,35,56,51,92,262
2018,Dragan Bender,PF,20,PHO,82,37,2069,187,484,0.386,118,322,0.366,69,162,0.426,0.508,39,51,0.765,40,321,361,130,22,53,112,166,531
2018,Khem Birch,C,25,ORL,42,0,578,68,126,0.54,0,0,NA,68,126,0.54,0.54,42,61,0.689,70,110,180,34,15,21,21,56,178
2018,Nemanja Bjelica,PF,29,MIN,67,21,1371,171,371,0.461,76,183,0.415,95,188,0.505,0.563,36,45,0.8,53,221,274,86,50,16,52,141,454
2018,Tarik Black,C,26,HOU,51,2,536,75,127,0.591,1,11,0.091,74,116,0.638,0.594,29,63,0.46,63,100,163,13,21,30,35,107,180
2018,Eric Bledsoe,PG,28,PHO,3,3,83,16,40,0.4,4,13,0.308,12,27,0.444,0.45,11,14,0.786,3,4,7,9,4,2,10,6,47
2018,Eric Bledsoe,PG,28,MIL,71,71,2239,452,949,0.476,121,347,0.349,331,602,0.55,0.54,241,303,0.795,48,229,277,361,145,40,206,179,1266
2018,Bojan Bogdanović,SF,28,IND,80,80,2464,404,852,0.474,155,386,0.402,249,466,0.534,0.565,178,205,0.868,30,240,270,119,55,8,106,129,1141
2018,Andrew Bogut,C,33,LAL,24,5,216,17,25,0.68,0,0,NA,17,25,0.68,0.68,2,2,1,26,52,78,15,4,13,19,40,36
2018,Trevor Booker,PF,30,BRK,18,6,395,77,150,0.513,3,12,0.25,74,138,0.536,0.523,24,43,0.558,38,81,119,38,8,5,30,43,181
2018,Trevor Booker,PF,30,PHI,33,0,494,61,109,0.56,2,7,0.286,59,102,0.578,0.569,32,39,0.821,47,75,122,27,16,11,20,50,156
2018,Trevor Booker,PF,30,IND,17,1,269,39,84,0.464,3,14,0.214,36,70,0.514,0.482,10,11,0.909,32,45,77,17,4,5,9,26,91
2018,Avery Bradley,SG,27,DET,40,40,1268,233,570,0.409,74,194,0.381,159,376,0.423,0.474,61,80,0.763,19,75,94,83,46,7,93,80,601
2018,Avery Bradley,SG,27,LAC,6,6,165,26,55,0.473,1,9,0.111,25,46,0.543,0.482,2,2,1,3,19,22,11,5,1,8,12,55
2018,Tony Bradley,C,20,UTA,9,0,29,3,11,0.273,0,1,0,3,10,0.3,0.273,2,2,1,4,7,11,1,0,0,0,1,8
2018,Corey Brewer,SF,31,LAL,54,2,694,78,172,0.453,8,43,0.186,70,129,0.543,0.477,34,51,0.667,23,70,93,41,41,8,38,83,198
2018,Corey Brewer,SG,31,OKC,18,16,514,64,144,0.444,23,67,0.343,41,77,0.532,0.524,31,39,0.795,20,41,61,24,38,6,11,56,182
2018,Aaron Brooks,PG,33,MIN,32,1,189,28,69,0.406,11,31,0.355,17,38,0.447,0.486,8,11,0.727,7,10,17,20,6,0,11,28,75
2018,MarShon Brooks,SG,29,MEM,7,1,193,51,102,0.5,19,32,0.594,32,70,0.457,0.593,20,23,0.87,8,13,21,25,11,3,16,6,141
2018,Anthony Brown,SF,25,MIN,1,0,4,1,1,1,1,1,1,0,0,NA,1.5,0,0,NA,0,0,0,1,0,0,0,0,3
2018,Bobby Brown,PG,33,HOU,20,0,115,19,58,0.328,11,40,0.275,8,18,0.444,0.422,1,2,0.5,0,7,7,11,4,0,9,6,50
2018,Reggie Bullock,SF,26,DET,62,52,1732,267,546,0.489,125,281,0.445,142,265,0.536,0.603,39,49,0.796,27,127,154,95,47,13,47,70,698
2018,Trey Burke,PG,25,NYK,36,9,785,193,384,0.503,38,105,0.362,155,279,0.556,0.552,37,57,0.649,13,58,71,170,24,4,43,43,461
2018,Alec Burks,SG,26,UTA,64,1,1059,170,414,0.411,47,142,0.331,123,272,0.452,0.467,107,124,0.863,19,173,192,67,37,8,60,75,494
2018,Jimmy Butler,SG,28,MIN,59,59,2164,437,921,0.474,70,200,0.35,367,721,0.509,0.512,363,425,0.854,79,235,314,288,116,24,108,78,1307
2018,Bruno Caboclo,SF,22,TOR,2,0,7,0,2,0,0,2,0,0,0,NA,0,0,0,NA,0,1,1,1,1,0,0,1,0
2018,Bruno Caboclo,SF,22,SAC,10,0,100,9,29,0.31,3,15,0.2,6,14,0.429,0.362,5,6,0.833,7,14,21,3,2,4,4,7,26
2018,José Calderón,PG,36,CLE,57,32,914,93,185,0.503,45,97,0.464,48,88,0.545,0.624,24,30,0.8,14,70,84,117,27,2,41,81,255
2018,Isaiah Canaan,SG,26,HOU,1,0,4,0,1,0,0,0,NA,0,1,0,0,0,0,NA,0,1,1,0,0,0,0,0,0
2018,Isaiah Canaan,PG,26,PHO,19,1,418,52,136,0.382,22,66,0.333,30,70,0.429,0.463,46,51,0.902,6,38,44,76,16,1,29,36,172
2018,DeMarre Carroll,PF,31,BRK,73,73,2180,325,785,0.414,145,391,0.371,180,394,0.457,0.506,188,246,0.764,105,374,479,147,59,30,103,165,983
2018,Vince Carter,SF,41,SAC,58,5,1026,114,283,0.403,57,165,0.345,57,118,0.483,0.504,28,37,0.757,18,130,148,69,42,26,36,96,313
2018,Michael Carter-Williams,PG,26,CHO,52,2,835,76,229,0.332,14,59,0.237,62,170,0.365,0.362,73,89,0.82,37,101,138,116,44,23,52,99,239
2018,Omri Casspi,SF,29,GSW,53,7,740,120,207,0.58,10,22,0.455,110,185,0.595,0.604,50,69,0.725,30,170,200,51,18,19,37,71,300
2018,Willie Cauley-Stein,C,24,SAC,73,58,2044,388,773,0.502,3,12,0.25,385,761,0.506,0.504,153,247,0.619,131,379,510,172,77,67,109,185,932
2018,Mario Chalmers,PG,31,MEM,66,10,1421,168,443,0.379,53,191,0.277,115,252,0.456,0.439,118,138,0.855,13,144,157,197,79,14,117,179,507
2018,Tyson Chandler,C,35,PHO,46,46,1151,121,187,0.647,0,0,NA,121,187,0.647,0.647,58,93,0.624,134,284,418,53,16,27,59,106,300
2018,Wilson Chandler,SF,30,DEN,74,71,2346,281,631,0.445,88,246,0.358,193,385,0.501,0.515,88,114,0.772,102,296,398,159,43,39,92,156,738
2018,Marquese Chriss,PF,20,PHO,72,49,1527,202,477,0.423,56,190,0.295,146,287,0.509,0.482,96,158,0.608,76,319,395,83,51,70,107,205,556
2018,Ian Clark,SG,26,NOP,74,2,1455,222,495,0.448,62,195,0.318,160,300,0.533,0.511,45,59,0.763,10,117,127,110,33,10,57,120,551
2018,Jordan Clarkson,SG,25,LAL,53,2,1256,299,667,0.448,68,210,0.324,231,457,0.505,0.499,105,132,0.795,44,115,159,173,39,3,95,63,771
2018,Jordan Clarkson,SG,25,CLE,28,0,632,131,287,0.456,44,108,0.407,87,179,0.486,0.533,47,58,0.81,13,45,58,48,19,3,32,44,353
2018,Antonius Cleveland,SG,23,DAL,13,0,81,4,14,0.286,0,1,0,4,13,0.308,0.286,2,4,0.5,2,8,10,2,6,4,2,11,10
2018,Antonius Cleveland,SG,23,ATL,4,0,42,4,7,0.571,3,3,1,1,4,0.25,0.786,2,2,1,1,3,4,0,1,1,5,12,13
2018,Quinn Cook,PG,24,GSW,33,18,740,122,252,0.484,46,104,0.442,76,148,0.514,0.575,22,25,0.88,10,72,82,89,12,1,32,59,312
2018,DeMarcus Cousins,C,27,NOP,48,48,1737,406,864,0.47,104,294,0.354,302,570,0.53,0.53,294,394,0.746,105,512,617,257,79,76,242,183,1210
2018,Robert Covington,SF,27,PHI,80,80,2532,345,836,0.413,203,550,0.369,142,286,0.497,0.534,116,136,0.853,55,378,433,156,137,72,126,238,1009
2018,Allen Crabbe,SG,25,BRK,75,68,2197,337,827,0.407,201,532,0.378,136,295,0.461,0.529,115,135,0.852,28,296,324,117,47,35,78,168,990
2018,Torrey Craig,SF,27,DEN,39,5,629,62,137,0.453,17,58,0.293,45,79,0.57,0.515,22,35,0.629,40,87,127,25,12,15,20,63,163
2018,Jamal Crawford,SG,37,MIN,80,0,1653,308,742,0.415,104,314,0.331,204,428,0.477,0.485,102,113,0.903,21,78,99,185,40,9,95,85,822
2018,Jordan Crawford,SG,29,NOP,5,0,53,12,27,0.444,8,14,0.571,4,13,0.308,0.593,1,1,1,2,2,4,13,1,1,5,7,33
2018,Jae Crowder,SF,27,CLE,53,47,1346,157,376,0.418,62,189,0.328,95,187,0.508,0.5,78,92,0.848,41,132,173,58,41,12,42,124,454
2018,Jae Crowder,SF,27,UTA,27,0,744,114,295,0.386,48,152,0.316,66,143,0.462,0.468,43,56,0.768,18,84,102,41,23,9,32,63,319
2018,Dante Cunningham,SF,30,NOP,51,24,1115,99,225,0.44,35,108,0.324,64,117,0.547,0.518,20,36,0.556,50,143,193,26,27,16,16,75,253
2018,Dante Cunningham,SF,30,BRK,22,1,447,65,139,0.468,23,60,0.383,42,79,0.532,0.55,11,16,0.688,28,77,105,22,12,14,17,36,164
2018,Troy Daniels,SG,26,PHO,79,15,1622,232,575,0.403,183,458,0.4,49,117,0.419,0.563,56,64,0.875,12,115,127,48,26,5,56,137,703
2018,Ed Davis,C,28,POR,78,0,1471,170,292,0.582,0,1,0,170,291,0.584,0.582,74,111,0.667,183,392,575,40,32,52,66,188,414
2018,Dewayne Dedmon,C,28,ATL,62,46,1542,250,477,0.524,50,141,0.355,200,336,0.595,0.577,67,86,0.779,100,389,489,90,40,51,86,162,617
2018,Sam Dekker,PF,23,LAC,73,1,883,128,259,0.494,10,60,0.167,118,199,0.593,0.514,37,56,0.661,44,130,174,38,24,9,33,71,303
2018,Matthew Dellavedova,PG,27,MIL,38,3,712,55,152,0.362,29,78,0.372,26,74,0.351,0.457,25,27,0.926,14,50,64,145,14,0,49,67,164
2018,Luol Deng,SF,32,LAL,1,1,13,1,2,0.5,0,0,NA,1,2,0.5,0.5,0,0,NA,0,0,0,1,1,0,1,0,2
2018,Gorgui Dieng,C,28,MIN,79,0,1333,186,388,0.479,19,61,0.311,167,327,0.511,0.504,79,102,0.775,106,254,360,71,45,39,59,147,470
2018,Tyler Dorsey,SG,21,ATL,56,5,974,144,382,0.377,72,199,0.362,72,183,0.393,0.471,45,63,0.714,17,113,130,79,17,5,37,63,405
2018,Goran Dragić,PG,31,MIA,75,75,2378,484,1075,0.45,111,300,0.37,373,775,0.481,0.502,217,271,0.801,54,252,306,359,63,12,166,180,1296
2018,Larry Drew II,PG,27,PHI,3,0,15,1,7,0.143,0,3,0,1,4,0.25,0.143,0,0,NA,1,0,1,2,0,0,1,2,2
2018,Larry Drew II,PG,27,NOP,7,0,55,6,17,0.353,3,6,0.5,3,11,0.273,0.441,0,0,NA,2,0,2,8,0,0,2,4,15
2018,Andre Drummond,C,24,DET,78,78,2625,466,881,0.529,0,11,0,466,870,0.536,0.529,239,395,0.605,399,848,1247,237,114,127,200,250,1171
2018,Jared Dudley,PF,32,PHO,48,0,686,48,122,0.393,29,80,0.363,19,42,0.452,0.512,27,35,0.771,8,86,94,78,24,11,28,85,152
2018,Jarell Eddie,SF,26,BOS,2,0,6,0,1,0,0,1,0,0,0,NA,0,0,0,NA,0,1,1,0,1,0,0,0,0
2018,Jarell Eddie,SF,26,CHI,1,0,3,0,1,0,0,1,0,0,0,NA,0,0,0,NA,0,0,0,0,0,0,0,0,0
2018,Henry Ellenson,PF,21,DET,38,0,329,53,146,0.363,20,60,0.333,33,86,0.384,0.432,25,29,0.862,10,71,81,20,5,0,18,22,151
2018,Wayne Ellington,SG,30,MIA,77,2,2041,285,700,0.407,227,579,0.392,58,121,0.479,0.569,67,78,0.859,23,195,218,79,53,8,52,94,864
2018,James Ennis III,SF,27,MEM,45,14,1053,108,222,0.486,30,84,0.357,78,138,0.565,0.554,64,73,0.877,53,104,157,49,32,12,38,81,310
2018,James Ennis III,SF,27,DET,27,8,551,74,162,0.457,21,69,0.304,53,93,0.57,0.522,33,43,0.767,20,47,67,22,15,6,18,53,202
2018,Tyler Ennis,PG,23,LAL,54,11,683,94,224,0.42,14,56,0.25,80,168,0.476,0.451,22,29,0.759,19,76,95,105,30,10,38,75,224
2018,Jawun Evans,PG,21,LAC,48,4,778,89,253,0.352,15,54,0.278,74,199,0.372,0.381,38,49,0.776,9,75,84,100,36,6,44,97,231
2018,Tyreke Evans,PG,28,MEM,52,32,1607,366,809,0.452,114,286,0.399,252,523,0.482,0.523,164,209,0.785,44,221,265,269,57,17,117,96,1010
2018,Dante Exum,PG,22,UTA,14,0,235,42,87,0.483,5,18,0.278,37,69,0.536,0.511,25,31,0.806,4,22,26,43,8,3,20,20,114
2018,Kenneth Faried,PF,28,DEN,32,7,461,76,148,0.514,0,1,0,76,147,0.517,0.514,36,51,0.706,68,85,153,18,12,13,23,51,188
2018,Derrick Favors,C,26,UTA,77,77,2153,395,702,0.563,14,63,0.222,381,639,0.596,0.573,140,215,0.651,198,354,552,102,54,82,88,164,944
2018,Kay Felder,PG,22,CHI,14,0,134,20,66,0.303,4,18,0.222,16,48,0.333,0.333,11,12,0.917,1,13,14,20,3,1,15,11,55
2018,Kay Felder,PG,22,DET,2,0,6,1,4,0.25,0,1,0,1,3,0.333,0.25,0,0,NA,2,2,4,0,0,0,1,0,2
2018,Raymond Felton,PG,33,OKC,82,2,1365,224,552,0.406,81,230,0.352,143,322,0.444,0.479,36,44,0.818,25,131,156,203,49,16,76,91,565
2018,Yogi Ferrell,SG,24,DAL,82,21,2282,311,730,0.426,134,359,0.373,177,371,0.477,0.518,82,103,0.796,26,223,249,201,64,9,78,153,838
2018,Evan Fournier,SF,25,ORL,57,57,1837,368,802,0.459,127,335,0.379,241,467,0.516,0.538,150,173,0.867,23,157,180,165,47,16,95,138,1013
2018,Tim Frazier,PG,27,WAS,59,11,838,68,172,0.395,17,56,0.304,51,116,0.44,0.445,23,30,0.767,18,97,115,194,47,7,57,97,176
2018,Enes Freedom,C,25,NYK,71,71,1830,422,713,0.592,0,2,0,422,711,0.594,0.592,156,184,0.848,273,507,780,105,36,37,122,187,1000
2018,Channing Frye,C,34,CLE,44,1,545,84,169,0.497,30,90,0.333,54,79,0.684,0.586,14,15,0.933,10,100,110,28,17,12,17,54,212
2018,Channing Frye,C,34,LAL,9,0,150,20,43,0.465,9,25,0.36,11,18,0.611,0.57,3,4,0.75,2,23,25,10,1,1,4,15,52
2018,Danilo Gallinari,SF,29,LAC,21,21,671,102,256,0.398,36,111,0.324,66,145,0.455,0.469,81,87,0.931,9,92,101,41,12,10,26,30,321
2018,Langston Galloway,SG,26,DET,58,2,863,126,340,0.371,75,218,0.344,51,122,0.418,0.481,33,41,0.805,13,79,92,58,35,5,18,39,360
2018,Marc Gasol,C,33,MEM,73,73,2408,434,1033,0.42,109,320,0.341,325,713,0.456,0.473,281,337,0.834,78,514,592,305,54,101,194,185,1258
2018,Pau Gasol,C,37,SAS,77,63,1812,287,627,0.458,43,120,0.358,244,507,0.481,0.492,158,209,0.756,129,490,619,238,24,79,108,121,775
2018,Rudy Gay,PF,31,SAS,57,6,1231,253,537,0.471,37,118,0.314,216,419,0.516,0.506,112,145,0.772,76,215,291,73,46,38,78,98,655
2018,Taj Gibson,PF,32,MIN,82,82,2726,425,737,0.577,7,35,0.2,418,702,0.595,0.581,142,185,0.768,194,390,584,99,62,59,89,218,999
2018,Aaron Gordon,PF,22,ORL,58,57,1909,375,865,0.434,115,342,0.336,260,523,0.497,0.5,157,225,0.698,87,370,457,136,59,45,107,111,1022
2018,Marcin Gortat,C,33,WAS,82,82,2075,290,560,0.518,0,0,NA,290,560,0.518,0.518,110,163,0.675,181,442,623,151,40,61,99,175,690
2018,Treveon Graham,SG,24,CHO,63,2,1050,96,221,0.434,40,97,0.412,56,124,0.452,0.525,41,59,0.695,42,79,121,59,33,2,27,109,273
2018,Jerami Grant,PF,23,OKC,81,1,1647,244,456,0.535,32,110,0.291,212,346,0.613,0.57,162,240,0.675,86,233,319,57,31,77,54,155,682
2018,Gerald Green,SG,32,HOU,41,2,929,168,413,0.407,110,298,0.369,58,115,0.504,0.54,51,60,0.85,15,118,133,25,24,15,31,87,497
2018,JaMychal Green,PF,27,MEM,55,54,1542,223,488,0.457,43,127,0.339,180,361,0.499,0.501,80,111,0.721,147,317,464,79,32,25,76,153,569
2018,Jeff Green,PF,31,CLE,78,13,1828,295,618,0.477,53,170,0.312,242,448,0.54,0.52,203,234,0.868,60,186,246,99,41,34,75,149,846
2018,Blake Griffin,PF,28,LAC,33,33,1139,255,578,0.441,64,187,0.342,191,391,0.488,0.497,172,219,0.785,46,216,262,179,30,9,99,78,746
2018,Blake Griffin,PF,28,DET,25,25,831,181,418,0.433,47,135,0.348,134,283,0.473,0.489,87,111,0.784,27,139,166,155,11,9,66,61,496
2018,Tim Hardaway Jr.,SG,25,NYK,57,54,1885,360,856,0.421,130,410,0.317,230,446,0.516,0.496,146,179,0.816,32,192,224,155,62,10,92,123,996
2018,James Harden,SG,28,HOU,72,72,2551,651,1449,0.449,265,722,0.367,386,727,0.531,0.541,624,727,0.858,41,348,389,630,126,50,315,169,2191
2018,Maurice Harkless,SF,24,POR,59,36,1264,147,297,0.495,49,118,0.415,98,179,0.547,0.577,42,59,0.712,46,116,162,53,48,43,40,103,385
2018,Devin Harris,PG,34,DAL,44,1,807,118,284,0.415,44,125,0.352,74,159,0.465,0.493,93,112,0.83,9,76,85,85,33,8,49,103,373
2018,Devin Harris,PG,34,DEN,27,0,533,69,170,0.406,35,102,0.343,34,68,0.5,0.509,49,58,0.845,3,39,42,67,14,4,27,55,222
2018,Gary Harris,SG,23,DEN,67,65,2304,440,908,0.485,156,394,0.396,284,514,0.553,0.57,134,162,0.827,37,139,176,194,122,15,119,119,1170
2018,Tobias Harris,PF,25,DET,48,48,1563,320,709,0.451,113,276,0.409,207,433,0.478,0.531,115,136,0.846,36,208,244,94,34,15,51,91,868
2018,Tobias Harris,PF,25,LAC,32,32,1105,242,512,0.473,70,169,0.414,172,343,0.501,0.541,64,80,0.8,22,171,193,98,37,20,54,73,618
2018,Andrew Harrison,PG,23,MEM,56,46,1326,181,429,0.422,47,142,0.331,134,287,0.467,0.477,124,159,0.78,23,108,131,177,38,26,81,138,533
2018,Shaquille Harrison,PG,24,PHO,23,2,384,59,124,0.476,6,26,0.231,53,98,0.541,0.5,28,38,0.737,9,52,61,55,26,7,22,42,152
2018,Nigel Hayes,SF,23,LAL,2,0,11,1,3,0.333,0,2,0,1,1,1,0.333,1,1,1,0,0,0,2,0,0,0,0,3
2018,Nigel Hayes,SF,23,TOR,2,0,6,2,2,1,2,2,1,0,0,NA,1.5,0,0,NA,0,0,0,0,0,0,1,0,6
2018,Nigel Hayes,SF,23,SAC,5,0,105,8,28,0.286,2,12,0.167,6,16,0.375,0.321,0,2,0,4,18,22,4,2,3,1,8,18
2018,John Henson,C,27,MIL,76,69,1970,287,502,0.572,1,7,0.143,286,495,0.578,0.573,90,158,0.57,150,363,513,114,45,109,84,202,665
2018,Juancho Hernangómez,PF,22,DEN,25,3,277,29,75,0.387,14,50,0.28,15,25,0.6,0.48,10,12,0.833,18,36,54,12,6,3,9,25,82
2018,Willy Hernangómez,C,23,NYK,26,0,233,49,81,0.605,1,5,0.2,48,76,0.632,0.611,12,28,0.429,22,45,67,21,8,7,26,32,111
2018,Willy Hernangómez,C,23,CHO,22,1,262,42,83,0.506,4,7,0.571,38,76,0.5,0.53,47,62,0.758,39,77,116,12,10,9,9,32,135
2018,Buddy Hield,SG,25,SAC,80,12,2024,416,933,0.446,176,408,0.431,240,525,0.457,0.54,71,81,0.877,55,252,307,155,85,22,124,148,1079
2018,Nenê,C,35,HOU,52,4,758,136,239,0.569,0,2,0,136,237,0.574,0.569,68,107,0.636,54,122,176,45,28,14,38,123,340
2018,George Hill,PG,31,SAC,43,36,1143,153,326,0.469,58,128,0.453,95,198,0.48,0.558,77,99,0.778,22,95,117,119,39,12,60,75,441
2018,George Hill,PG,31,CLE,24,24,669,83,187,0.444,27,77,0.351,56,110,0.509,0.516,33,41,0.805,20,44,64,67,22,15,28,53,226
2018,Solomon Hill,SF,26,NOP,12,1,187,11,41,0.268,4,21,0.19,7,20,0.35,0.317,3,6,0.5,9,27,36,22,7,1,9,22,29
2018,Justin Holiday,SG,28,CHI,72,72,2265,290,782,0.371,161,449,0.359,129,333,0.387,0.474,135,164,0.823,31,260,291,153,80,31,93,134,876
2018,Rodney Hood,SG,25,UTA,39,12,1084,234,552,0.424,102,262,0.389,132,290,0.455,0.516,85,97,0.876,14,97,111,65,30,7,63,64,655
2018,Rodney Hood,SG,25,CLE,21,11,532,88,199,0.442,25,71,0.352,63,128,0.492,0.505,26,32,0.813,8,46,54,30,15,5,7,41,227
2018,Serge Ibaka,PF,28,TOR,76,76,2093,379,784,0.483,107,297,0.36,272,487,0.559,0.552,94,118,0.797,78,400,478,62,29,99,90,209,959
2018,Ersan İlyasova,PF,30,ATL,46,40,1175,184,401,0.459,61,170,0.359,123,231,0.532,0.535,72,90,0.8,74,177,251,51,44,17,43,92,501
2018,Ersan İlyasova,PF,30,PHI,23,3,554,93,212,0.439,30,83,0.361,63,129,0.488,0.509,33,45,0.733,44,110,154,39,17,9,29,65,249
2018,Wes Iwundu,SF,23,ORL,62,12,1020,93,218,0.427,9,46,0.196,84,172,0.488,0.447,34,47,0.723,36,101,137,57,33,12,30,81,229
2018,Jarrett Jack,PG,34,NYK,62,56,1548,189,443,0.427,25,86,0.291,164,357,0.459,0.455,63,75,0.84,22,169,191,348,35,4,115,98,466
2018,Demetrius Jackson,PG,23,HOU,12,0,63,4,14,0.286,0,6,0,4,8,0.5,0.286,0,0,NA,4,7,11,5,4,1,9,6,8
2018,Demetrius Jackson,PG,23,PHI,3,0,17,3,4,0.75,1,1,1,2,3,0.667,0.875,1,2,0.5,1,0,1,4,1,0,1,1,8
2018,Justin Jackson,SF,22,SAC,68,41,1506,185,419,0.442,57,185,0.308,128,234,0.547,0.51,26,36,0.722,27,160,187,74,28,13,40,81,453
2018,Reggie Jackson,PG,27,DET,45,45,1201,246,577,0.426,52,169,0.308,194,408,0.475,0.471,112,134,0.836,29,96,125,238,27,4,99,87,656
2018,Mike James,PG,27,PHO,32,10,669,121,312,0.388,26,97,0.268,95,215,0.442,0.429,64,84,0.762,12,77,89,120,27,7,48,45,332
2018,Mike James,PG,27,NOP,4,0,18,2,9,0.222,0,1,0,2,8,0.25,0.222,0,0,NA,1,0,1,6,1,0,1,3,4
2018,Richard Jefferson,SF,37,DEN,20,0,163,12,27,0.444,2,7,0.286,10,20,0.5,0.481,4,7,0.571,2,15,17,15,2,1,5,11,30
2018,Brandon Jennings,PG,28,MIL,14,0,205,27,72,0.375,9,33,0.273,18,39,0.462,0.438,10,10,1,5,26,31,44,6,4,18,11,73
2018,Jonas Jerebko,PF,30,UTA,74,19,1134,159,341,0.466,65,157,0.414,94,184,0.511,0.562,46,57,0.807,53,193,246,42,24,12,27,127,429
2018,Brice Johnson,PF,23,LAC,9,0,38,7,11,0.636,0,1,0,7,10,0.7,0.636,2,2,1,2,11,13,1,6,2,4,7,16
2018,Brice Johnson,PF,23,MEM,9,0,60,13,31,0.419,0,0,NA,13,31,0.419,0.419,1,3,0.333,7,11,18,1,3,4,1,6,27
2018,James Johnson,PF,30,MIA,73,41,1943,309,614,0.503,57,185,0.308,252,429,0.587,0.55,113,162,0.698,61,297,358,280,70,51,141,192,788
2018,Joe Johnson,SF,36,UTA,32,3,700,95,226,0.42,23,84,0.274,72,142,0.507,0.471,20,24,0.833,12,95,107,45,12,6,31,32,233
2018,Joe Johnson,SF,36,HOU,23,1,505,51,134,0.381,17,61,0.279,34,73,0.466,0.444,20,21,0.952,2,63,65,38,6,1,18,35,139
2018,Stanley Johnson,SF,21,DET,69,50,1894,210,560,0.375,67,234,0.286,143,326,0.439,0.435,112,145,0.772,33,219,252,112,95,14,77,169,599
2018,Tyler Johnson,PG,25,MIA,72,39,2052,309,711,0.435,119,324,0.367,190,387,0.491,0.518,106,129,0.822,34,214,248,165,60,34,81,148,843
2018,Wesley Johnson,SF,30,LAC,74,40,1486,150,368,0.408,60,177,0.339,90,191,0.471,0.489,43,58,0.741,29,187,216,61,76,62,55,146,403
2018,Damian Jones,C,22,GSW,15,0,89,11,22,0.5,0,0,NA,11,22,0.5,0.5,3,5,0.6,5,9,14,2,1,3,4,14,25
2018,Derrick Jones Jr.,SF,20,PHO,6,0,33,2,4,0.5,0,2,0,2,2,1,0.5,5,6,0.833,2,2,4,3,1,4,1,2,9
2018,Derrick Jones Jr.,SF,20,MIA,14,8,212,19,49,0.388,3,16,0.188,16,33,0.485,0.418,11,18,0.611,19,15,34,6,3,9,6,22,52
2018,Jalen Jones,SF,24,NOP,4,0,19,1,4,0.25,1,1,1,0,3,0,0.375,2,2,1,0,3,3,0,0,0,0,2,5
2018,Jalen Jones,SF,24,DAL,12,0,162,25,64,0.391,9,25,0.36,16,39,0.41,0.461,10,17,0.588,13,22,35,4,5,1,7,20,69
2018,DeAndre Jordan,C,29,LAC,77,77,2424,373,578,0.645,0,0,NA,373,578,0.645,0.645,181,312,0.58,329,842,1171,117,39,71,137,203,927
2018,Cory Joseph,PG,26,IND,82,17,2210,256,604,0.424,67,190,0.353,189,414,0.457,0.479,70,94,0.745,39,224,263,260,80,18,87,141,649
2018,Michael Kidd-Gilchrist,SF,24,CHO,74,74,1850,282,560,0.504,0,2,0,282,558,0.505,0.504,117,171,0.684,84,218,302,71,51,32,53,143,681
2018,Sean Kilpatrick,SG,28,BRK,16,0,183,25,87,0.287,11,43,0.256,14,44,0.318,0.351,18,19,0.947,1,34,35,15,2,1,16,8,79
2018,Sean Kilpatrick,SG,28,MIL,23,0,205,31,82,0.378,13,46,0.283,18,36,0.5,0.457,18,19,0.947,1,24,25,15,5,1,9,15,93
2018,Sean Kilpatrick,SG,28,LAC,4,0,38,7,18,0.389,3,7,0.429,4,11,0.364,0.472,2,2,1,0,2,2,3,0,0,1,2,19
2018,Sean Kilpatrick,SG,28,CHI,9,1,214,47,107,0.439,19,48,0.396,28,59,0.475,0.528,26,32,0.813,3,22,25,13,6,3,12,8,139
2018,Luke Kornet,PF,22,NYK,20,1,326,49,125,0.392,28,79,0.354,21,46,0.457,0.504,8,11,0.727,11,53,64,26,6,16,12,28,134
2018,Kyle Korver,SG,36,CLE,73,4,1574,222,484,0.459,164,376,0.436,58,108,0.537,0.628,64,72,0.889,9,156,165,88,31,27,55,130,672
2018,Kosta Koufos,C,28,SAC,71,13,1391,222,389,0.571,0,0,NA,222,389,0.571,0.571,33,74,0.446,149,323,472,87,47,32,49,146,477
2018,Skal Labissière,PF,21,SAC,60,28,1240,205,458,0.448,18,51,0.353,187,407,0.459,0.467,95,118,0.805,99,189,288,72,25,49,73,132,523
2018,Joffrey Lauvergne,C,26,SAS,55,1,534,98,190,0.516,0,5,0,98,185,0.53,0.516,30,47,0.638,63,108,171,41,9,3,33,45,226
2018,Courtney Lee,SG,32,NYK,76,69,2310,343,755,0.454,113,278,0.406,230,477,0.482,0.529,114,124,0.919,30,194,224,180,80,17,84,109,913
2018,Alex Len,C,24,PHO,69,13,1395,214,378,0.566,1,3,0.333,213,375,0.568,0.567,158,231,0.684,175,343,518,82,27,61,78,158,587
2018,Jon Leuer,PF,28,DET,8,0,136,15,36,0.417,0,3,0,15,33,0.455,0.417,13,15,0.867,7,25,32,5,1,3,7,16,43
2018,Caris LeVert,SF,23,BRK,71,10,1864,320,735,0.435,85,245,0.347,235,490,0.48,0.493,133,187,0.711,53,207,260,299,82,22,153,159,858
2018,DeAndre Liggins,SG,29,MIL,31,1,480,22,65,0.338,11,36,0.306,11,29,0.379,0.423,2,5,0.4,5,44,49,27,27,10,13,61,57
2018,DeAndre Liggins,SG,29,NOP,27,3,244,18,41,0.439,8,17,0.471,10,24,0.417,0.537,0,0,NA,2,24,26,21,10,4,7,20,44
2018,Jeremy Lin,PG,29,BRK,1,1,25,5,12,0.417,1,2,0.5,4,10,0.4,0.458,7,7,1,0,0,0,4,0,0,3,3,18
2018,Shaun Livingston,PG,32,GSW,71,7,1129,172,343,0.501,0,5,0,172,338,0.509,0.501,50,61,0.82,32,99,131,140,35,21,58,117,394
2018,Kyle Lowry,PG,31,TOR,78,78,2510,403,944,0.427,238,596,0.399,165,348,0.474,0.553,223,261,0.854,66,368,434,537,85,19,183,192,1267
2018,Timothé Luwawu-Cabarrot,SF,22,PHI,52,7,807,100,267,0.375,53,158,0.335,47,109,0.431,0.474,46,58,0.793,14,58,72,54,12,5,38,97,299
2018,Shelvin Mack,PG,27,ORL,69,3,1365,178,414,0.43,48,139,0.345,130,275,0.473,0.488,69,97,0.711,23,143,166,272,54,8,89,91,473
2018,Thon Maker,C,20,MIL,74,12,1238,130,316,0.411,31,104,0.298,99,212,0.467,0.46,65,93,0.699,75,150,225,46,38,53,44,162,356
2018,Boban Marjanović,C,29,DET,19,1,171,41,79,0.519,0,0,NA,41,79,0.519,0.519,36,45,0.8,15,42,57,14,4,6,22,28,118
2018,Boban Marjanović,C,29,LAC,20,0,166,38,69,0.551,0,0,NA,38,69,0.551,0.551,41,52,0.788,33,54,87,8,6,5,14,23,117
2018,Wesley Matthews,SF,31,DAL,63,62,2131,283,697,0.406,153,402,0.381,130,295,0.441,0.516,83,101,0.822,28,170,198,172,76,16,83,140,802
2018,Luc Mbah a Moute,PF,31,HOU,61,15,1564,166,345,0.481,63,173,0.364,103,172,0.599,0.572,65,95,0.684,22,164,186,55,72,25,68,100,460
2018,Patrick McCaw,SG,22,GSW,57,10,961,92,225,0.409,19,80,0.238,73,145,0.503,0.451,26,34,0.765,16,66,82,81,43,10,41,67,229
2018,Chris McCullough,PF,22,WAS,19,0,90,18,42,0.429,1,8,0.125,17,34,0.5,0.44,9,14,0.643,7,18,25,4,0,5,2,8,46
2018,Doug McDermott,SF,26,NYK,55,1,1172,151,328,0.46,53,137,0.387,98,191,0.513,0.541,40,53,0.755,33,101,134,50,10,12,34,73,395
2018,Doug McDermott,SF,26,DAL,26,3,596,86,180,0.478,39,79,0.494,47,101,0.465,0.586,24,28,0.857,7,59,66,29,9,4,22,49,235
2018,JaVale McGee,C,30,GSW,65,17,615,136,219,0.621,0,6,0,136,213,0.638,0.621,38,52,0.731,59,110,169,33,21,57,27,91,310
2018,Ben McLemore,SG,24,MEM,56,17,1091,157,373,0.421,55,159,0.346,102,214,0.477,0.495,53,64,0.828,34,105,139,51,38,15,61,139,422
2018,Josh McRoberts,PF,30,DAL,2,0,6,0,1,0,0,1,0,0,0,NA,0,0,0,NA,0,0,0,0,0,0,0,2,0
2018,Jodie Meeks,SG,30,WAS,77,0,1119,157,393,0.399,72,210,0.343,85,183,0.464,0.491,101,117,0.863,15,111,126,70,29,4,37,55,487
2018,C.J. Miles,SF,30,TOR,70,3,1337,227,599,0.379,164,454,0.361,63,145,0.434,0.516,81,97,0.835,18,134,152,55,37,21,39,134,699
2018,Nikola Mirotić,PF,26,CHI,25,3,622,143,302,0.474,69,161,0.429,74,141,0.525,0.588,65,79,0.823,18,141,159,39,15,13,31,45,420
2018,Nikola Mirotić,PF,26,NOP,30,11,872,163,382,0.427,66,197,0.335,97,185,0.524,0.513,47,58,0.81,41,205,246,41,29,26,31,63,439
2018,Greg Monroe,C,27,MIL,5,0,79,16,33,0.485,0,0,NA,16,33,0.485,0.485,2,4,0.5,6,19,25,5,0,0,6,7,34
2018,Greg Monroe,C,27,PHO,20,14,465,97,155,0.626,0,0,NA,97,155,0.626,0.626,31,46,0.674,50,110,160,50,16,6,40,40,225
2018,Greg Monroe,C,27,BOS,26,0,496,105,198,0.53,0,0,NA,105,198,0.53,0.53,55,69,0.797,53,112,165,59,28,17,48,48,265
2018,Eric Moreland,PF,26,DET,67,3,805,66,122,0.541,0,0,NA,66,122,0.541,0.541,11,29,0.379,81,197,278,78,31,51,42,116,143
2018,Marcus Morris,PF,28,BOS,54,21,1442,262,611,0.429,86,234,0.368,176,377,0.467,0.499,124,154,0.805,43,246,289,72,35,12,65,100,734
2018,Markieff Morris,PF,28,WAS,73,73,1968,330,687,0.48,76,207,0.367,254,480,0.529,0.536,105,128,0.82,75,334,409,142,56,38,127,216,841
2018,Timofey Mozgov,C,31,BRK,31,13,359,52,93,0.559,4,18,0.222,48,75,0.64,0.581,23,30,0.767,32,66,98,11,5,13,33,39,131
2018,Emmanuel Mudiay,PG,21,DEN,42,0,752,129,322,0.401,38,102,0.373,91,220,0.414,0.46,63,78,0.808,16,78,94,121,21,4,72,47,359
2018,Emmanuel Mudiay,PG,21,NYK,22,14,493,75,204,0.368,9,46,0.196,66,158,0.418,0.39,35,51,0.686,10,48,58,85,20,7,41,33,194
2018,Shabazz Muhammad,SF,25,MIN,32,2,301,47,121,0.388,4,19,0.211,43,102,0.422,0.405,22,31,0.71,15,30,45,7,5,2,5,23,120
2018,Shabazz Muhammad,SG,25,MIL,11,0,117,37,67,0.552,3,8,0.375,34,59,0.576,0.575,17,19,0.895,8,23,31,7,4,1,1,7,94
2018,Mike Muscala,C,26,ATL,53,7,1060,143,312,0.458,62,167,0.371,81,145,0.559,0.558,57,62,0.919,56,174,230,51,31,27,42,80,405
2018,Larry Nance Jr.,C,25,LAL,42,17,922,152,253,0.601,1,4,0.25,151,249,0.606,0.603,55,87,0.632,108,176,284,57,59,20,41,113,360
2018,Larry Nance Jr.,C,25,CLE,24,10,499,88,160,0.55,1,8,0.125,87,152,0.572,0.553,36,50,0.72,53,115,168,25,29,18,10,59,213
2018,Shabazz Napier,PG,26,POR,74,10,1535,223,531,0.42,82,218,0.376,141,313,0.45,0.497,116,138,0.841,26,144,170,150,81,14,90,84,644
2018,Jameer Nelson,PG,35,NOP,43,0,897,84,205,0.41,40,110,0.364,44,95,0.463,0.507,13,17,0.765,11,85,96,156,23,3,56,67,221
2018,Jameer Nelson,PG,35,DET,7,0,116,11,39,0.282,1,14,0.071,10,25,0.4,0.295,3,3,1,2,6,8,23,4,1,11,14,26
2018,Nerlens Noel,C,23,DAL,30,6,472,55,105,0.524,0,1,0,55,104,0.529,0.524,21,28,0.75,48,120,168,20,31,22,26,59,131
2018,Jusuf Nurkić,C,23,POR,79,79,2088,480,951,0.505,0,7,0,480,944,0.508,0.505,172,273,0.63,189,519,708,143,64,111,183,247,1132
2018,Johnny O'Bryant,PF,24,CHO,36,0,379,68,171,0.398,14,43,0.326,54,128,0.422,0.439,21,25,0.84,29,64,93,14,9,6,15,45,171
2018,Jahlil Okafor,C,22,PHI,2,0,25,4,9,0.444,0,0,NA,4,9,0.444,0.444,2,4,0.5,4,5,9,1,0,2,3,7,10
2018,Jahlil Okafor,C,22,BRK,26,0,328,73,129,0.566,1,4,0.25,72,125,0.576,0.57,19,25,0.76,17,59,76,11,3,16,18,44,166
2018,Victor Oladipo,SG,25,IND,75,75,2552,640,1342,0.477,161,434,0.371,479,908,0.528,0.537,294,368,0.799,47,343,390,323,177,57,219,175,1735
2018,Kelly Olynyk,PF,26,MIA,76,22,1779,316,636,0.497,106,280,0.379,210,356,0.59,0.58,134,174,0.77,89,342,431,207,62,35,147,222,872
2018,Kelly Oubre Jr.,SF,22,WAS,81,11,2231,318,790,0.403,126,369,0.341,192,421,0.456,0.482,191,233,0.82,59,304,363,98,80,35,90,234,953
2018,Georgios Papagiannis,C,20,SAC,16,0,118,17,41,0.415,0,0,NA,17,41,0.415,0.415,0,0,NA,12,24,36,9,2,6,8,12,34
2018,Georgios Papagiannis,C,20,POR,1,0,4,1,1,1,0,0,NA,1,1,1,1,0,0,NA,1,0,1,0,2,0,0,0,2
2018,Jabari Parker,PF,22,MIL,31,3,743,160,332,0.482,31,81,0.383,129,251,0.514,0.529,40,54,0.741,42,109,151,59,25,10,45,50,391
2018,Patrick Patterson,PF,28,OKC,82,3,1270,106,266,0.398,66,171,0.386,40,95,0.421,0.523,40,46,0.87,32,161,193,57,48,23,33,87,318
2018,Adreian Payne,PF,26,ORL,5,0,43,7,10,0.7,2,3,0.667,5,7,0.714,0.8,5,6,0.833,2,7,9,0,2,0,2,6,21
2018,Cameron Payne,PG,23,CHI,25,14,582,87,215,0.405,35,91,0.385,52,124,0.419,0.486,12,16,0.75,18,51,69,113,26,9,36,44,221
2018,Elfrid Payton,PG,23,ORL,44,44,1257,238,458,0.52,25,67,0.373,213,391,0.545,0.547,72,114,0.632,47,127,174,275,64,16,114,97,573
2018,Elfrid Payton,PG,23,PHO,19,19,551,91,209,0.435,5,25,0.2,86,184,0.467,0.447,37,54,0.685,17,83,100,118,19,6,54,50,224
2018,Gary Payton II,PG,25,MIL,12,6,106,13,33,0.394,2,12,0.167,11,21,0.524,0.424,2,3,0.667,4,13,17,9,3,1,3,17,30
2018,Gary Payton II,PG,25,LAL,11,0,115,17,41,0.415,4,13,0.308,13,28,0.464,0.463,1,6,0.167,9,18,27,12,4,2,4,13,39
2018,Kendrick Perkins,C,33,CLE,1,0,15,1,2,0.5,0,0,NA,1,2,0.5,0.5,1,2,0.5,0,1,1,2,1,0,1,1,3
2018,Mason Plumlee,C,27,DEN,74,26,1439,221,368,0.601,0,1,0,221,367,0.602,0.601,82,179,0.458,132,268,400,142,49,81,103,184,524
2018,Miles Plumlee,C,29,ATL,55,35,918,105,180,0.583,0,0,NA,105,180,0.583,0.583,27,60,0.45,77,151,228,45,17,30,63,79,237
2018,Quincy Pondexter,SF,29,CHI,23,1,196,14,49,0.286,3,22,0.136,11,27,0.407,0.316,14,17,0.824,8,19,27,9,8,2,11,24,45
2018,Otto Porter Jr.,SF,24,WAS,77,77,2432,445,885,0.503,138,313,0.441,307,572,0.537,0.581,106,128,0.828,103,389,492,157,116,41,75,151,1134
2018,Bobby Portis,PF,22,CHI,73,4,1643,382,811,0.471,80,223,0.359,302,588,0.514,0.52,120,156,0.769,159,339,498,123,50,23,103,130,964
2018,Dwight Powell,C,26,DAL,79,25,1672,255,430,0.593,28,84,0.333,227,346,0.656,0.626,133,185,0.719,135,309,444,91,67,32,59,186,671
2018,Norman Powell,SG,24,TOR,70,18,1062,150,374,0.401,53,186,0.285,97,188,0.516,0.472,32,39,0.821,14,105,119,89,37,16,66,111,385
2018,Taurean Prince,SF,23,ATL,82,82,2464,415,975,0.426,176,457,0.385,239,518,0.461,0.516,152,180,0.844,50,339,389,214,85,42,191,168,1158
2018,Zach Randolph,PF,36,SAC,59,57,1508,361,763,0.473,51,147,0.347,310,616,0.503,0.507,84,107,0.785,97,300,397,127,42,10,116,119,857
2018,J.J. Redick,SG,33,PHI,70,70,2116,404,879,0.46,193,460,0.42,211,419,0.504,0.569,197,218,0.904,9,169,178,210,35,6,103,123,1198
2018,Willie Reed,C,27,LAC,39,5,419,80,120,0.667,1,2,0.5,79,118,0.669,0.671,32,55,0.582,35,85,120,9,9,22,19,53,193
2018,Willie Reed,C,27,DET,3,0,9,1,1,1,0,0,NA,1,1,1,1,0,0,NA,0,1,1,1,0,0,0,3,2
2018,Malachi Richardson,SG,22,SAC,25,4,319,29,88,0.33,12,39,0.308,17,49,0.347,0.398,17,22,0.773,5,28,33,13,10,1,10,27,87
2018,Malachi Richardson,SG,22,TOR,1,0,5,1,2,0.5,0,1,0,1,1,1,0.5,0,0,NA,0,1,1,0,0,0,0,0,2
2018,Austin Rivers,SG,25,LAC,61,59,2057,341,805,0.424,136,360,0.378,205,445,0.461,0.508,102,159,0.642,27,118,145,242,74,16,109,152,920
2018,Glenn Robinson III,SF,24,IND,23,1,338,36,85,0.424,14,34,0.412,22,51,0.431,0.506,9,11,0.818,11,26,37,17,13,1,5,14,95
2018,Rajon Rondo,PG,31,NOP,65,63,1705,231,494,0.468,50,150,0.333,181,344,0.526,0.518,25,46,0.543,31,232,263,533,70,10,151,119,537
2018,Derrick Rose,PG,29,CLE,16,7,308,58,132,0.439,6,24,0.25,52,108,0.481,0.462,35,41,0.854,10,19,29,26,3,4,28,14,157
2018,Derrick Rose,PG,29,MIN,9,0,112,23,54,0.426,1,6,0.167,22,48,0.458,0.435,5,5,1,3,3,6,11,4,0,7,2,52
2018,Terrence Ross,SG,26,ORL,24,20,600,76,191,0.398,30,93,0.323,46,98,0.469,0.476,27,36,0.75,10,63,73,38,27,11,29,45,209
2018,D'Angelo Russell,PG,21,BRK,48,35,1234,278,672,0.414,90,278,0.324,188,394,0.477,0.481,97,131,0.74,30,159,189,249,36,17,147,93,743
2018,JaKarr Sampson,SF,24,SAC,22,6,344,44,81,0.543,5,10,0.5,39,71,0.549,0.574,10,16,0.625,21,57,78,9,8,22,8,48,103
2018,Dario Šarić,PF,23,PHI,78,73,2310,403,890,0.453,157,399,0.393,246,491,0.501,0.541,178,207,0.86,154,366,520,202,51,20,148,160,1141
2018,Mike Scott,PF,29,WAS,76,1,1406,276,524,0.527,66,163,0.405,210,361,0.582,0.59,50,76,0.658,50,197,247,80,23,10,79,148,668
2018,Thabo Sefolosha,SF,33,UTA,38,6,806,118,240,0.492,32,84,0.381,86,156,0.551,0.558,44,54,0.815,29,132,161,33,52,12,30,59,312
2018,Wayne Selden,SG,23,MEM,35,9,692,116,269,0.431,49,122,0.402,67,147,0.456,0.522,44,59,0.746,16,40,56,66,18,5,54,59,325
2018,Ramon Sessions,PG,31,NYK,13,3,167,17,53,0.321,2,11,0.182,15,42,0.357,0.34,12,15,0.8,1,17,18,27,7,1,15,14,48
2018,Ramon Sessions,PG,31,WAS,15,0,225,25,64,0.391,6,15,0.4,19,49,0.388,0.438,32,42,0.762,5,15,20,50,7,1,15,15,88
2018,Iman Shumpert,SG,27,CLE,14,6,276,22,58,0.379,7,26,0.269,15,32,0.469,0.44,11,15,0.733,7,34,41,17,9,4,16,22,62
2018,Jonathon Simmons,SG,28,ORL,69,50,2029,354,761,0.465,69,204,0.338,285,557,0.512,0.511,185,241,0.768,61,178,239,171,58,16,146,175,962
2018,Kyle Singler,SF,29,OKC,12,0,59,7,21,0.333,2,5,0.4,5,16,0.313,0.381,7,13,0.538,1,9,10,2,1,0,3,4,23
2018,Dennis Smith Jr.,PG,20,DAL,69,69,2049,404,1024,0.395,106,339,0.313,298,685,0.435,0.446,134,193,0.694,50,210,260,358,71,18,194,152,1048
2018,Ish Smith,PG,29,DET,82,35,2043,389,801,0.486,35,101,0.347,354,700,0.506,0.507,81,116,0.698,27,197,224,360,64,20,108,140,894
2018,J.R. Smith,SG,32,CLE,80,61,2244,240,595,0.403,143,381,0.375,97,214,0.453,0.524,39,56,0.696,29,206,235,141,68,11,81,161,662
2018,Jason Smith,C,31,WAS,33,2,285,45,115,0.391,4,32,0.125,41,83,0.494,0.409,19,21,0.905,18,35,53,14,3,13,16,44,113
2018,Josh Smith,PF,32,NOP,3,0,12,1,4,0.25,0,0,NA,1,4,0.25,0.25,0,0,NA,3,1,4,0,0,0,0,3,2
2018,Marreese Speights,C,30,ORL,52,3,675,138,349,0.395,86,233,0.369,52,116,0.448,0.519,40,55,0.727,21,112,133,40,8,22,40,106,402
2018,Nik Stauskas,SG,24,PHI,6,0,45,1,4,0.25,0,1,0,1,3,0.333,0.25,2,2,1,0,1,1,1,4,0,4,3,4
2018,Nik Stauskas,SG,24,BRK,35,0,478,59,150,0.393,40,99,0.404,19,51,0.373,0.527,19,27,0.704,4,59,63,38,5,4,22,21,177
2018,Lance Stephenson,SG,27,IND,82,7,1850,303,709,0.427,67,232,0.289,236,477,0.495,0.475,84,127,0.661,62,362,424,235,46,17,131,177,757
2018,Caleb Swanigan,PF,20,POR,27,3,189,24,60,0.4,1,8,0.125,23,52,0.442,0.408,12,18,0.667,15,39,54,14,5,3,18,37,61
2018,Jeff Teague,PG,29,MIN,70,70,2311,354,794,0.446,84,228,0.368,270,566,0.477,0.499,202,239,0.845,24,185,209,492,102,23,177,171,994
2018,Marquis Teague,PG,24,MEM,3,0,74,4,16,0.25,1,4,0.25,3,12,0.25,0.281,2,5,0.4,1,5,6,13,4,0,3,5,11
2018,Garrett Temple,SG,31,SAC,65,35,1615,199,476,0.418,89,227,0.392,110,249,0.442,0.512,60,78,0.769,22,130,152,124,57,27,79,135,547
2018,Daniel Theis,C,25,BOS,63,3,936,126,233,0.541,18,58,0.31,108,175,0.617,0.579,61,81,0.753,90,184,274,56,30,48,56,157,331
2018,Isaiah Thomas,PG,28,CLE,15,14,406,70,194,0.361,22,87,0.253,48,107,0.449,0.418,59,68,0.868,7,24,31,68,9,2,41,25,221
2018,Isaiah Thomas,PG,28,LAL,17,1,456,87,227,0.383,33,101,0.327,54,126,0.429,0.456,58,63,0.921,10,26,36,85,6,1,54,33,265
2018,Lance Thomas,PF,29,NYK,73,31,1353,102,267,0.382,50,124,0.403,52,143,0.364,0.476,44,53,0.83,44,131,175,44,30,14,40,134,298
2018,Sindarius Thornwell,SG,23,LAC,73,17,1156,100,233,0.429,23,61,0.377,77,172,0.448,0.479,59,88,0.67,33,107,140,68,48,25,53,125,282
2018,Anthony Tolliver,PF,32,DET,79,14,1757,219,472,0.464,159,365,0.436,60,107,0.561,0.632,106,133,0.797,50,191,241,90,32,21,58,144,703
2018,P.J. Tucker,PF,32,HOU,82,34,2281,172,441,0.39,115,310,0.371,57,131,0.435,0.52,43,60,0.717,93,364,457,77,78,26,74,205,502
2018,Evan Turner,SF,29,POR,79,40,2034,258,577,0.447,42,132,0.318,216,445,0.485,0.484,91,107,0.85,30,214,244,173,47,29,99,163,649
2018,Ekpe Udoh,C,30,UTA,63,3,810,60,120,0.5,0,1,0,60,119,0.504,0.5,42,56,0.75,68,82,150,53,43,74,20,105,162
2018,Jonas Valančiūnas,C,25,TOR,77,77,1727,390,687,0.568,30,74,0.405,360,613,0.587,0.59,170,211,0.806,183,477,660,81,29,69,115,192,980
2018,Rashad Vaughn,SG,21,MIL,22,0,173,21,50,0.42,13,35,0.371,8,15,0.533,0.55,4,6,0.667,2,15,17,12,4,3,4,12,59
2018,Rashad Vaughn,SG,21,BRK,1,0,4,0,0,NA,0,0,NA,0,0,NA,NA,0,0,NA,0,0,0,1,0,0,0,1,0
2018,Rashad Vaughn,SG,21,ORL,5,0,35,2,6,0.333,1,2,0.5,1,4,0.25,0.417,0,0,NA,1,3,4,0,1,0,2,2,5
2018,Noah Vonleh,PF,22,POR,33,12,476,47,96,0.49,2,6,0.333,45,90,0.5,0.5,23,31,0.742,35,132,167,13,6,11,15,42,119
2018,Noah Vonleh,PF,22,CHI,21,4,399,57,138,0.413,18,60,0.3,39,78,0.5,0.478,13,27,0.481,35,109,144,21,13,6,16,26,145
2018,Nikola Vučević,C,27,ORL,57,57,1683,399,840,0.475,64,204,0.314,335,636,0.527,0.513,77,94,0.819,101,422,523,191,56,62,109,144,939
2018,Dwyane Wade,SG,36,CLE,46,3,1069,198,435,0.455,23,70,0.329,175,365,0.479,0.482,94,134,0.701,39,142,181,163,42,32,92,84,513
2018,Dwyane Wade,SG,36,MIA,21,0,467,101,247,0.409,9,41,0.22,92,206,0.447,0.427,41,55,0.745,11,60,71,65,19,15,48,40,252
2018,Dion Waiters,SG,26,MIA,30,30,918,163,410,0.398,52,170,0.306,111,240,0.463,0.461,51,69,0.739,8,69,77,113,23,9,70,61,429
2018,Derrick Walton,PG,22,MIA,16,0,147,8,25,0.32,7,17,0.412,1,8,0.125,0.46,6,6,1,2,14,16,16,7,3,2,7,29
2018,Briante Weber,PG,25,HOU,13,0,118,9,22,0.409,4,9,0.444,5,13,0.385,0.5,4,4,1,3,15,18,13,10,3,7,18,26
2018,Briante Weber,PG,25,MEM,5,0,119,10,21,0.476,0,2,0,10,19,0.526,0.476,4,6,0.667,5,12,17,9,8,2,8,10,24
2018,Andrew Wiggins,SF,22,MIN,82,82,2979,569,1300,0.438,112,338,0.331,457,962,0.475,0.481,202,314,0.643,82,276,358,160,91,51,138,163,1452
2018,Derrick Williams,PF,26,LAL,2,0,9,1,4,0.25,0,2,0,1,2,0.5,0.25,0,0,NA,0,1,1,0,0,0,0,0,2
2018,Lou Williams,SG,31,LAC,79,19,2589,582,1337,0.435,186,518,0.359,396,819,0.484,0.505,432,491,0.88,40,158,198,417,85,19,234,106,1782
2018,Marvin Williams,PF,31,CHO,78,78,2006,258,563,0.458,126,305,0.413,132,258,0.512,0.57,102,123,0.829,74,296,370,96,56,38,66,116,744
2018,Troy Williams,SF,23,HOU,4,0,17,2,9,0.222,0,5,0,2,4,0.5,0.222,1,3,0.333,1,3,4,1,1,0,1,2,5
2018,Troy Williams,SF,23,NYK,17,1,290,49,100,0.49,11,33,0.333,38,67,0.567,0.545,19,27,0.704,21,38,59,15,19,4,18,32,128
2018,D.J. Wilson,PF,21,MIL,22,0,71,9,16,0.563,2,5,0.4,7,11,0.636,0.625,1,2,0.5,2,8,10,3,3,1,4,7,21
2018,Nate Wolters,PG,26,UTA,5,0,19,1,6,0.167,0,0,NA,1,6,0.167,0.167,0,0,NA,1,1,2,1,0,0,0,1,2
2018,Brandan Wright,PF,30,MEM,27,1,366,57,99,0.576,0,0,NA,57,99,0.576,0.576,21,33,0.636,32,61,93,13,13,25,8,29,135
2018,Brandan Wright,PF,30,HOU,1,0,15,2,3,0.667,0,0,NA,2,3,0.667,0.667,0,0,NA,1,1,2,0,0,1,0,3,4
2018,Delon Wright,PG,25,TOR,69,4,1433,201,432,0.465,56,153,0.366,145,279,0.52,0.53,97,117,0.829,45,153,198,200,72,33,78,81,555
2018,Nick Young,SG,32,GSW,80,8,1393,201,488,0.412,123,326,0.377,78,162,0.481,0.538,56,65,0.862,20,105,125,36,38,7,39,100,581
2018,Thaddeus Young,PF,29,IND,81,81,2607,421,864,0.487,58,181,0.32,363,683,0.531,0.521,55,92,0.598,184,328,512,152,135,36,105,175,955
2018,Tyler Zeller,C,28,BRK,42,33,703,125,229,0.546,10,26,0.385,115,203,0.567,0.568,40,60,0.667,63,131,194,28,8,21,35,78,300
2018,Tyler Zeller,C,28,MIL,24,1,406,62,105,0.59,0,2,0,62,103,0.602,0.59,17,19,0.895,47,64,111,19,7,14,12,48,141
2018,Ivica Zubac,C,20,LAL,43,0,410,61,122,0.5,0,1,0,61,121,0.504,0.5,39,51,0.765,45,78,123,25,8,15,26,47,161
2019,Quincy Acy,PF,28,PHO,10,0,123,4,18,0.222,2,15,0.133,2,3,0.667,0.278,7,10,0.7,3,22,25,8,1,4,4,24,17
2019,LaMarcus Aldridge,C,33,SAS,81,81,2687,684,1319,0.519,10,42,0.238,674,1277,0.528,0.522,349,412,0.847,251,493,744,194,43,107,144,179,1727
2019,Jarrett Allen,C,20,BRK,80,80,2096,335,568,0.59,6,45,0.133,329,523,0.629,0.595,197,278,0.709,191,481,672,110,43,120,103,184,873
2019,Al-Farouq Aminu,PF,28,POR,81,81,2292,257,593,0.433,96,280,0.343,161,313,0.514,0.514,150,173,0.867,112,498,610,104,68,33,72,143,760
2019,Justin Anderson,SF,25,ATL,48,4,463,64,157,0.408,24,77,0.312,40,80,0.5,0.484,26,35,0.743,24,60,84,23,22,13,23,48,178
2019,Ryan Anderson,PF,30,PHO,15,8,278,19,60,0.317,7,34,0.206,12,26,0.462,0.375,11,14,0.786,14,31,45,17,3,1,12,23,56
2019,Ryan Anderson,PF,30,MIA,10,0,44,2,9,0.222,2,6,0.333,0,3,0,0.333,1,2,0.5,4,5,9,2,1,0,2,2,7
2019,Carmelo Anthony,PF,34,HOU,10,2,294,49,121,0.405,21,64,0.328,28,57,0.491,0.492,15,22,0.682,9,45,54,5,4,7,8,32,134
2019,Trevor Ariza,SF,33,PHO,26,26,884,86,227,0.379,50,139,0.36,36,88,0.409,0.489,36,43,0.837,16,129,145,87,38,8,39,44,258
2019,Trevor Ariza,SF,33,WAS,43,43,1465,208,509,0.409,95,295,0.322,113,214,0.528,0.502,94,121,0.777,34,192,226,165,53,13,67,86,605
2019,D.J. Augustin,PG,31,ORL,81,81,2269,318,677,0.47,131,311,0.421,187,366,0.511,0.566,181,209,0.866,41,162,203,426,52,4,128,115,948
2019,Ron Baker,SG,25,NYK,11,0,107,4,16,0.25,1,9,0.111,3,7,0.429,0.281,5,6,0.833,1,6,7,13,5,0,3,16,14
2019,Ron Baker,SG,25,WAS,4,0,45,0,4,0,0,4,0,0,0,NA,0,0,0,NA,0,4,4,2,1,1,2,2,0
2019,Harrison Barnes,PF,26,DAL,49,49,1584,290,717,0.404,121,311,0.389,169,406,0.416,0.489,165,198,0.833,36,171,207,62,33,11,68,79,866
2019,Harrison Barnes,SF,26,SAC,28,28,949,141,310,0.455,53,130,0.408,88,180,0.489,0.54,64,80,0.8,21,133,154,53,17,2,30,43,399
2019,Will Barton,SF,28,DEN,43,38,1189,185,460,0.402,67,196,0.342,118,264,0.447,0.475,57,74,0.77,32,167,199,124,18,22,65,82,494
2019,Keita Bates-Diop,SF,23,MIN,30,3,503,60,142,0.423,13,52,0.25,47,90,0.522,0.468,18,28,0.643,16,67,83,17,18,14,14,29,151
2019,Jerryd Bayless,PG,30,MIN,34,6,657,82,230,0.357,29,98,0.296,53,132,0.402,0.42,16,28,0.571,11,51,62,119,18,2,32,56,209
2019,Kent Bazemore,SG,29,ATL,67,35,1643,278,691,0.402,96,300,0.32,182,391,0.465,0.472,127,175,0.726,37,224,261,152,89,42,121,170,779
2019,Malik Beasley,SG,22,DEN,81,18,1879,349,737,0.474,163,405,0.402,186,332,0.56,0.584,56,66,0.848,35,165,200,97,55,10,55,116,917
2019,Marco Belinelli,SG,32,SAS,79,1,1815,285,690,0.413,147,395,0.372,138,295,0.468,0.52,112,124,0.903,16,182,198,132,35,8,72,121,829
2019,Jordan Bell,C,24,GSW,68,3,788,99,192,0.516,0,2,0,99,190,0.521,0.516,25,41,0.61,55,129,184,76,20,51,42,80,223
2019,Dragan Bender,PF,21,PHO,46,27,826,88,197,0.447,22,101,0.218,66,96,0.688,0.503,32,54,0.593,34,149,183,56,18,22,37,90,230
2019,Khem Birch,C,26,ORL,50,1,643,91,151,0.603,0,1,0,91,150,0.607,0.603,58,83,0.699,79,111,190,38,18,29,20,72,240
2019,Nemanja Bjelica,PF,30,SAC,77,70,1788,284,593,0.479,103,257,0.401,181,336,0.539,0.566,70,92,0.761,125,319,444,147,54,56,82,197,741
2019,Eric Bledsoe,PG,29,MIL,78,78,2272,470,971,0.484,124,377,0.329,346,594,0.582,0.548,177,236,0.75,82,280,362,430,116,29,165,156,1241
2019,Bojan Bogdanović,SF,29,IND,81,81,2573,522,1051,0.497,164,386,0.425,358,665,0.538,0.575,246,305,0.807,33,300,333,161,69,1,134,138,1454
2019,Andrew Bogut,C,34,GSW,11,5,134,18,36,0.5,0,0,NA,18,36,0.5,0.5,3,3,1,12,43,55,11,3,8,8,22,39
2019,Jonah Bolden,PF,23,PHI,44,10,639,80,162,0.494,34,96,0.354,46,66,0.697,0.599,13,27,0.481,47,118,165,40,17,39,36,99,207
2019,Avery Bradley,SG,28,LAC,49,49,1463,161,420,0.383,58,172,0.337,103,248,0.415,0.452,20,25,0.8,35,96,131,96,27,16,61,133,400
2019,Avery Bradley,SG,28,MEM,14,14,442,87,188,0.463,28,73,0.384,59,115,0.513,0.537,23,25,0.92,8,36,44,56,14,0,28,34,225
2019,Tony Bradley,C,21,UTA,3,0,36,8,16,0.5,0,0,NA,8,16,0.5,0.5,1,2,0.5,9,6,15,1,2,2,3,6,17
2019,Corey Brewer,SF,32,PHI,7,3,140,20,49,0.408,4,14,0.286,16,35,0.457,0.449,9,13,0.692,4,13,17,10,12,2,8,16,53
2019,Corey Brewer,SF,32,SAC,24,0,352,33,74,0.446,10,30,0.333,23,44,0.523,0.514,22,30,0.733,22,37,59,29,20,5,11,47,98
2019,MarShon Brooks,SG,30,MEM,29,0,387,76,169,0.45,15,54,0.278,61,115,0.53,0.494,23,33,0.697,12,33,45,25,9,4,21,33,190
2019,Troy Brown Jr.,SF,19,WAS,52,10,730,97,234,0.415,22,69,0.319,75,165,0.455,0.462,32,47,0.681,35,110,145,80,21,5,30,56,248
2019,Reggie Bullock,SG,27,DET,44,44,1355,182,441,0.413,114,294,0.388,68,147,0.463,0.542,56,64,0.875,20,103,123,109,24,5,54,79,534
2019,Reggie Bullock,SG,27,LAL,19,16,524,63,153,0.412,34,99,0.343,29,54,0.537,0.523,17,21,0.81,2,48,50,20,16,7,11,30,177
2019,Trey Burke,PG,26,NYK,33,7,689,148,358,0.413,30,86,0.349,118,272,0.434,0.455,62,75,0.827,15,47,62,94,21,5,29,33,388
2019,Trey Burke,PG,26,DAL,25,1,436,88,190,0.463,26,73,0.356,62,117,0.53,0.532,41,49,0.837,13,24,37,65,12,2,20,25,243
2019,Alec Burks,SG,27,UTA,17,0,269,47,114,0.412,16,43,0.372,31,71,0.437,0.482,33,38,0.868,2,25,27,20,6,4,15,22,143
2019,Alec Burks,SG,27,CLE,34,24,979,136,340,0.4,45,119,0.378,91,221,0.412,0.466,79,98,0.806,26,160,186,98,25,16,46,62,396
2019,Alec Burks,SG,27,SAC,13,0,127,9,20,0.45,0,6,0,9,14,0.643,0.45,4,5,0.8,2,20,22,10,8,1,4,7,22
2019,Jimmy Butler,SG,29,MIN,10,10,361,74,157,0.471,17,45,0.378,57,112,0.509,0.525,48,61,0.787,16,36,52,43,24,10,14,18,213
2019,Jimmy Butler,SF,29,PHI,55,55,1824,344,747,0.461,50,148,0.338,294,599,0.491,0.494,264,304,0.868,105,185,290,220,99,29,81,93,1002
2019,Bruno Caboclo,PF,23,MEM,34,19,800,96,225,0.427,48,130,0.369,48,95,0.505,0.533,42,50,0.84,42,116,158,50,14,33,38,81,282
2019,José Calderón,PG,37,DET,49,0,632,45,120,0.375,14,57,0.246,31,63,0.492,0.433,9,11,0.818,11,49,60,115,16,3,35,64,113
2019,Isaiah Canaan,PG,27,PHO,19,15,503,51,129,0.395,25,72,0.347,26,57,0.456,0.492,15,20,0.75,5,44,49,62,12,0,29,46,142
2019,Isaiah Canaan,PG,27,MIN,7,1,95,11,29,0.379,7,19,0.368,4,10,0.4,0.5,4,4,1,0,5,5,19,2,1,4,4,33
2019,Isaiah Canaan,PG,27,MIL,4,0,31,2,6,0.333,2,5,0.4,0,1,0,0.5,0,0,NA,1,3,4,3,0,1,2,2,6
2019,DeMarre Carroll,PF,32,BRK,67,8,1703,227,575,0.395,106,310,0.342,121,265,0.457,0.487,184,242,0.76,68,281,349,85,31,10,73,114,744
2019,Vince Carter,PF,42,ATL,76,9,1330,196,468,0.419,123,316,0.389,73,152,0.48,0.55,47,66,0.712,31,163,194,87,44,27,48,141,562
2019,Wendell Carter Jr.,C,19,CHI,44,44,1110,180,371,0.485,6,32,0.188,174,339,0.513,0.493,89,112,0.795,87,220,307,78,26,58,65,152,455
2019,Michael Carter-Williams,PG,27,HOU,16,1,145,25,61,0.41,7,19,0.368,18,42,0.429,0.467,12,26,0.462,3,10,13,21,9,6,10,27,69
2019,Michael Carter-Williams,PG,27,ORL,12,0,227,21,62,0.339,3,19,0.158,18,43,0.419,0.363,20,27,0.741,16,41,57,49,11,9,10,21,65
2019,Omri Casspi,SF,30,MEM,36,0,520,86,161,0.534,15,43,0.349,71,118,0.602,0.581,39,58,0.672,17,98,115,26,20,9,23,35,226
2019,Willie Cauley-Stein,C,25,SAC,81,81,2213,412,741,0.556,1,2,0.5,411,739,0.556,0.557,140,254,0.551,181,497,678,194,96,51,84,227,965
2019,Tyson Chandler,C,36,PHO,7,0,89,8,12,0.667,0,0,NA,8,12,0.667,0.667,10,18,0.556,7,32,39,6,2,1,7,21,26
2019,Tyson Chandler,C,36,LAL,48,6,786,53,87,0.609,0,1,0,53,86,0.616,0.609,41,69,0.594,85,183,268,31,19,22,35,89,147
2019,Wilson Chandler,PF,31,PHI,36,32,951,91,207,0.44,46,118,0.39,45,89,0.506,0.551,13,18,0.722,44,124,168,72,22,18,39,94,241
2019,Wilson Chandler,SF,31,LAC,15,1,226,23,66,0.348,13,40,0.325,10,26,0.385,0.447,5,7,0.714,4,43,47,10,3,3,7,29,64
2019,Chris Chiozza,PG,23,HOU,7,0,33,2,8,0.25,2,5,0.4,0,3,0,0.375,0,0,NA,1,3,4,4,1,1,1,2,6
2019,Marquese Chriss,PF,21,HOU,16,0,104,11,34,0.324,1,15,0.067,10,19,0.526,0.338,6,7,0.857,7,21,28,6,2,4,12,17,29
2019,Marquese Chriss,PF,21,CLE,27,2,395,56,146,0.384,15,57,0.263,41,89,0.461,0.435,26,38,0.684,33,81,114,16,15,7,24,64,153
2019,Gary Clark,PF,24,HOU,51,2,641,50,151,0.331,41,138,0.297,9,13,0.692,0.467,7,7,1,24,92,116,18,20,26,7,47,148
2019,Ian Clark,SG,27,NOP,60,6,973,151,383,0.394,66,202,0.327,85,181,0.47,0.48,33,37,0.892,13,76,89,94,22,8,58,95,401
2019,Jordan Clarkson,SG,26,CLE,81,0,2214,529,1180,0.448,144,445,0.324,385,735,0.524,0.509,162,192,0.844,82,188,270,196,57,13,135,112,1364
2019,Quinn Cook,PG,25,GSW,74,10,1059,204,439,0.465,81,200,0.405,123,239,0.515,0.557,20,26,0.769,22,135,157,116,20,3,50,92,509
2019,DeMarcus Cousins,C,28,GSW,30,30,771,178,371,0.48,26,95,0.274,152,276,0.551,0.515,106,144,0.736,43,204,247,107,40,44,72,109,488
2019,Robert Covington,SF,28,PHI,13,13,440,50,117,0.427,30,77,0.39,20,40,0.5,0.556,17,23,0.739,7,60,67,14,24,23,22,45,147
2019,Robert Covington,SF,28,MIN,22,22,763,106,245,0.433,55,148,0.372,51,97,0.526,0.545,51,66,0.773,21,105,126,32,50,24,25,81,318
2019,Allen Crabbe,SG,26,BRK,43,20,1133,137,373,0.367,98,259,0.378,39,114,0.342,0.499,41,56,0.732,16,132,148,46,23,13,46,102,413
2019,Torrey Craig,SF,28,DEN,75,37,1503,160,362,0.442,61,188,0.324,99,174,0.569,0.526,49,70,0.7,89,174,263,72,37,46,44,175,430
2019,Jamal Crawford,SG,38,PHO,64,0,1211,174,438,0.397,67,202,0.332,107,236,0.453,0.474,93,110,0.845,8,77,85,229,33,12,99,75,508
2019,Mitch Creek,SF,26,BRK,4,0,36,5,10,0.5,0,1,0,5,9,0.556,0.5,5,7,0.714,5,5,10,5,1,0,0,3,15
2019,Mitch Creek,SF,26,MIN,1,0,12,3,6,0.5,0,1,0,3,5,0.6,0.5,0,0,NA,1,1,2,1,1,0,1,0,6
2019,Jae Crowder,SF,28,UTA,80,11,2166,318,797,0.399,173,522,0.331,145,275,0.527,0.508,142,197,0.721,60,324,384,133,64,31,85,170,951
2019,Dante Cunningham,PF,31,SAS,64,21,928,75,158,0.475,30,65,0.462,45,93,0.484,0.57,14,18,0.778,48,140,188,50,27,13,22,71,194
2019,Seth Curry,SG,28,POR,74,2,1399,212,465,0.456,113,251,0.45,99,214,0.463,0.577,44,52,0.846,27,93,120,66,36,12,61,97,581
2019,Troy Daniels,SG,27,PHO,51,1,760,113,275,0.411,74,194,0.381,39,81,0.481,0.545,18,23,0.783,13,60,73,26,26,5,27,79,318
2019,Ed Davis,C,29,BRK,81,1,1446,186,302,0.616,0,2,0,186,300,0.62,0.616,100,162,0.617,216,478,694,61,35,33,64,226,472
2019,Dewayne Dedmon,C,29,ATL,64,52,1609,259,526,0.492,83,217,0.382,176,309,0.57,0.571,92,113,0.814,105,375,480,90,69,71,84,214,693
2019,Sam Dekker,PF,24,CLE,9,5,169,22,48,0.458,5,13,0.385,17,35,0.486,0.51,8,10,0.8,9,24,33,9,11,0,5,13,57
2019,Sam Dekker,PF,24,WAS,38,0,619,98,208,0.471,14,49,0.286,84,159,0.528,0.505,20,36,0.556,44,71,115,37,27,7,19,34,230
2019,Matthew Dellavedova,PG,28,MIL,12,0,97,6,19,0.316,4,11,0.364,2,8,0.25,0.421,4,4,1,0,10,10,29,2,0,11,9,20
2019,Matthew Dellavedova,PG,28,CLE,36,0,715,92,223,0.413,40,119,0.336,52,104,0.5,0.502,38,48,0.792,6,61,67,152,12,2,57,66,262
2019,Luol Deng,SF,33,MIN,22,2,392,59,118,0.5,14,44,0.318,45,74,0.608,0.559,25,35,0.714,20,53,73,18,15,8,14,24,157
2019,Hamidou Diallo,SG,20,OKC,51,3,526,75,165,0.455,4,24,0.167,71,141,0.504,0.467,36,59,0.61,38,59,97,17,21,10,23,77,190
2019,Gorgui Dieng,C,29,MIN,76,2,1031,189,377,0.501,19,56,0.339,170,321,0.53,0.527,88,106,0.83,81,230,311,72,48,41,57,134,485
2019,Tyler Dorsey,SG,22,ATL,27,0,251,32,89,0.36,10,39,0.256,22,50,0.44,0.416,16,26,0.615,9,34,43,17,7,1,10,20,90
2019,Tyler Dorsey,SG,22,MEM,21,11,447,75,175,0.429,34,93,0.366,41,82,0.5,0.526,22,35,0.629,18,52,70,39,7,1,17,33,206
2019,Goran Dragić,PG,32,MIA,36,22,991,179,433,0.413,57,164,0.348,122,269,0.454,0.479,79,101,0.782,20,91,111,174,30,5,71,81,494
2019,Andre Drummond,C,25,DET,79,79,2647,561,1052,0.533,5,38,0.132,556,1014,0.548,0.536,243,412,0.59,423,809,1232,112,136,138,175,272,1370
2019,Jared Dudley,PF,33,BRK,59,25,1220,101,239,0.423,53,151,0.351,48,88,0.545,0.533,32,46,0.696,34,121,155,83,36,16,43,131,287
2019,Henry Ellenson,PF,22,DET,2,0,25,4,10,0.4,2,4,0.5,2,6,0.333,0.5,2,2,1,0,9,9,1,0,0,0,2,12
2019,Henry Ellenson,PF,22,NYK,17,0,234,35,85,0.412,15,34,0.441,20,51,0.392,0.5,17,23,0.739,5,52,57,15,7,2,9,25,102
2019,Wayne Ellington,SG,31,MIA,25,12,533,69,184,0.375,57,155,0.368,12,29,0.414,0.53,14,16,0.875,6,41,47,29,24,3,14,40,209
2019,Wayne Ellington,SG,31,DET,28,26,764,115,273,0.421,81,217,0.373,34,56,0.607,0.57,25,33,0.758,8,52,60,43,30,3,26,52,336
2019,James Ennis III,SF,28,HOU,40,25,949,104,211,0.493,44,120,0.367,60,91,0.659,0.597,42,58,0.724,37,80,117,27,38,16,23,111,294
2019,James Ennis III,SF,28,PHI,18,2,281,34,83,0.41,11,36,0.306,23,47,0.489,0.476,16,23,0.696,23,42,65,14,3,7,11,39,95
2019,Jacob Evans,SG,21,GSW,30,1,204,18,53,0.34,4,15,0.267,14,38,0.368,0.377,0,1,0,6,19,25,23,5,3,11,28,40
2019,Jawun Evans,PG,22,PHO,7,0,64,3,13,0.231,0,2,0,3,11,0.273,0.231,0,0,NA,1,11,12,10,3,0,6,8,6
2019,Jawun Evans,PG,22,OKC,1,0,1,0,1,0,0,1,0,0,0,NA,0,0,0,NA,0,0,0,0,0,0,0,0,0
2019,Tyreke Evans,SG,29,IND,69,18,1402,257,660,0.389,77,216,0.356,180,444,0.405,0.448,115,160,0.719,33,168,201,166,58,18,118,117,706
2019,Dante Exum,PG,23,UTA,42,1,664,101,241,0.419,18,62,0.29,83,179,0.464,0.456,68,86,0.791,16,52,68,110,14,5,52,69,288
2019,Kenneth Faried,C,29,BRK,12,0,118,25,42,0.595,1,5,0.2,24,37,0.649,0.607,10,16,0.625,15,29,44,2,2,4,6,8,61
2019,Kenneth Faried,C,29,HOU,25,13,610,131,223,0.587,7,20,0.35,124,203,0.611,0.603,54,83,0.651,82,124,206,18,15,19,27,74,323
2019,Derrick Favors,C,27,UTA,76,70,1766,363,619,0.586,17,78,0.218,346,541,0.64,0.6,154,228,0.675,207,353,560,89,56,106,84,163,897
2019,Raymond Felton,PG,34,OKC,33,0,379,55,135,0.407,20,61,0.328,35,74,0.473,0.481,12,13,0.923,4,30,34,52,10,6,14,29,142
2019,Yogi Ferrell,PG,25,SAC,71,3,1067,153,352,0.435,54,149,0.362,99,203,0.488,0.511,60,67,0.896,13,96,109,137,36,4,40,64,420
2019,Evan Fournier,SG,26,ORL,81,81,2553,468,1069,0.438,153,450,0.34,315,619,0.509,0.509,137,170,0.806,38,220,258,295,71,12,154,225,1226
2019,Tim Frazier,PG,28,NOP,47,17,909,88,195,0.451,27,77,0.351,61,118,0.517,0.521,32,41,0.78,32,105,137,206,25,4,60,93,235
2019,Tim Frazier,PG,28,MIL,12,2,211,28,66,0.424,10,24,0.417,18,42,0.429,0.5,9,13,0.692,9,22,31,42,5,1,16,19,75
2019,Jimmer Fredette,SG,29,PHO,6,0,65,8,29,0.276,0,13,0,8,16,0.5,0.276,6,6,1,1,6,7,8,3,0,5,5,22
2019,Enes Freedom,C,26,NYK,44,23,1128,251,468,0.536,7,22,0.318,244,446,0.547,0.544,105,129,0.814,171,290,461,84,18,17,79,106,614
2019,Enes Freedom,C,26,POR,23,8,512,124,215,0.577,3,12,0.25,121,203,0.596,0.584,50,68,0.735,86,112,198,32,14,9,39,61,301
2019,Channing Frye,C,35,CLE,36,6,341,43,117,0.368,32,79,0.405,11,38,0.289,0.504,11,14,0.786,4,48,52,20,6,5,13,44,129
2019,Danilo Gallinari,SF,30,LAC,68,68,2059,409,884,0.463,161,372,0.433,248,512,0.484,0.554,367,406,0.904,54,363,417,178,49,23,99,129,1346
2019,Langston Galloway,SG,27,DET,80,4,1745,228,587,0.388,135,380,0.355,93,207,0.449,0.503,81,96,0.844,49,122,171,85,37,8,24,135,672
2019,Marc Gasol,C,34,MEM,53,53,1788,303,683,0.444,76,221,0.344,227,462,0.491,0.499,152,201,0.756,56,399,455,248,60,63,119,147,834
2019,Marc Gasol,C,34,TOR,26,19,648,87,187,0.465,23,52,0.442,64,135,0.474,0.527,40,52,0.769,24,148,172,101,24,23,36,70,237
2019,Pau Gasol,C,38,SAS,27,6,330,41,88,0.466,5,10,0.5,36,78,0.462,0.494,27,38,0.711,22,105,127,50,5,14,14,28,114
2019,Pau Gasol,C,38,MIL,3,0,30,1,6,0.167,1,3,0.333,0,3,0,0.25,1,2,0.5,0,10,10,2,0,1,2,1,4
2019,Rudy Gay,PF,32,SAS,69,51,1842,376,746,0.504,74,184,0.402,302,562,0.537,0.554,120,147,0.816,63,407,470,182,54,34,114,159,946
2019,Taj Gibson,PF,33,MIN,70,57,1686,304,537,0.566,11,34,0.324,293,503,0.583,0.576,134,177,0.757,172,286,458,84,53,39,73,186,753
2019,Aaron Gordon,PF,23,ORL,78,78,2633,470,1046,0.449,121,347,0.349,349,699,0.499,0.507,185,253,0.731,129,445,574,289,57,56,162,172,1246
2019,Marcin Gortat,C,34,LAC,47,43,751,99,186,0.532,0,0,NA,99,186,0.532,0.532,35,48,0.729,67,194,261,65,6,24,50,92,233
2019,Treveon Graham,SG,25,BRK,35,21,715,64,191,0.335,38,128,0.297,26,63,0.413,0.435,18,22,0.818,23,84,107,34,13,7,17,68,184
2019,Jerami Grant,PF,24,OKC,80,77,2612,409,823,0.497,115,293,0.392,294,530,0.555,0.567,157,221,0.71,96,321,417,79,61,100,67,214,1090
2019,Gerald Green,SG,33,HOU,73,0,1473,231,578,0.4,156,441,0.354,75,137,0.547,0.535,57,68,0.838,30,152,182,40,33,27,55,126,675
2019,JaMychal Green,PF,28,MEM,41,4,900,151,312,0.484,38,96,0.396,113,216,0.523,0.545,63,80,0.788,72,180,252,36,33,26,64,123,403
2019,JaMychal Green,PF,28,LAC,24,2,471,79,164,0.482,33,80,0.413,46,84,0.548,0.582,17,21,0.81,32,125,157,14,12,8,23,70,208
2019,Jeff Green,PF,32,WAS,77,44,2097,326,687,0.475,111,320,0.347,215,367,0.586,0.555,183,206,0.888,57,252,309,137,43,39,101,160,946
2019,Blake Griffin,PF,29,DET,75,75,2622,619,1341,0.462,189,522,0.362,430,819,0.525,0.532,414,550,0.753,100,465,565,402,52,28,253,199,1841
2019,Tim Hardaway Jr.,SG,26,NYK,46,46,1499,282,726,0.388,117,337,0.347,165,389,0.424,0.469,199,233,0.854,26,135,161,122,42,6,81,106,880
2019,Tim Hardaway Jr.,SG,26,DAL,19,17,558,108,267,0.404,45,140,0.321,63,127,0.496,0.489,33,43,0.767,7,54,61,37,12,2,24,35,294
2019,James Harden,PG,29,HOU,78,78,2867,843,1909,0.442,378,1028,0.368,465,881,0.528,0.541,754,858,0.879,66,452,518,586,158,58,387,244,2818
2019,Maurice Harkless,SF,25,POR,60,53,1415,189,388,0.487,33,120,0.275,156,268,0.582,0.53,49,73,0.671,77,192,269,74,67,53,45,163,460
2019,Devin Harris,PG,35,DAL,68,2,1071,132,347,0.38,62,200,0.31,70,147,0.476,0.47,102,134,0.761,12,100,112,122,35,16,56,133,428
2019,Gary Harris,SG,24,DEN,57,48,1639,270,637,0.424,82,242,0.339,188,395,0.476,0.488,115,144,0.799,41,119,160,127,55,19,68,113,737
2019,Tobias Harris,PF,26,LAC,55,55,1903,424,855,0.496,112,258,0.434,312,597,0.523,0.561,192,219,0.877,37,395,432,150,40,24,109,123,1152
2019,Tobias Harris,PF,26,PHI,27,27,944,187,399,0.469,44,135,0.326,143,264,0.542,0.524,74,88,0.841,32,181,213,79,11,13,42,61,492
2019,Andrew Harrison,PG,24,MEM,1,0,5,1,2,0.5,0,1,0,1,1,1,0.5,0,0,NA,0,0,0,0,0,0,0,1,2
2019,Andrew Harrison,PG,24,CLE,10,0,144,12,39,0.308,3,14,0.214,9,25,0.36,0.346,16,16,1,4,11,15,17,4,2,10,26,43
2019,Andrew Harrison,PG,24,NOP,6,0,38,3,12,0.25,2,10,0.2,1,2,0.5,0.333,1,2,0.5,2,3,5,7,0,0,2,7,9
2019,Shaquille Harrison,SG,25,CHI,73,11,1430,184,426,0.432,24,89,0.27,160,337,0.475,0.46,82,123,0.667,33,189,222,139,89,30,60,124,474
2019,Isaiah Hartenstein,PF,20,HOU,28,0,221,20,41,0.488,2,6,0.333,18,35,0.514,0.512,11,14,0.786,21,26,47,15,7,12,13,56,53
2019,John Henson,C,28,MIL,14,0,188,31,67,0.463,11,31,0.355,20,36,0.556,0.545,6,10,0.6,16,55,71,14,7,11,12,16,79
2019,Juancho Hernangómez,PF,23,DEN,70,25,1358,138,314,0.439,66,181,0.365,72,133,0.541,0.545,66,86,0.767,64,201,265,55,27,24,37,94,408
2019,Willy Hernangómez,C,24,CHO,58,3,812,153,295,0.519,15,39,0.385,138,256,0.539,0.544,100,144,0.694,117,194,311,60,16,20,58,98,421
2019,Buddy Hield,SG,26,SAC,82,82,2615,623,1360,0.458,278,651,0.427,345,709,0.487,0.56,171,193,0.886,106,306,412,205,58,33,146,202,1695
2019,Nenê,C,36,HOU,42,2,546,60,116,0.517,0,3,0,60,113,0.531,0.517,31,47,0.66,34,89,123,26,18,15,11,87,151
2019,George Hill,PG,32,CLE,13,13,344,55,107,0.514,13,28,0.464,42,79,0.532,0.575,17,20,0.85,12,15,27,36,12,1,20,35,140
2019,George Hill,PG,32,MIL,47,0,958,115,269,0.428,35,125,0.28,80,144,0.556,0.493,53,65,0.815,27,94,121,99,40,7,31,67,318
2019,Solomon Hill,SF,27,NOP,44,15,878,68,178,0.382,32,101,0.317,36,77,0.468,0.472,23,32,0.719,34,99,133,55,23,10,31,80,191
2019,Justin Holiday,SG,29,CHI,38,38,1325,151,394,0.383,97,270,0.359,54,124,0.435,0.506,41,46,0.891,19,150,169,85,67,21,47,79,440
2019,Justin Holiday,SG,29,MEM,44,39,1282,149,383,0.389,65,195,0.333,84,188,0.447,0.474,54,60,0.9,27,127,154,61,54,15,57,85,417
2019,Rodney Hood,SG,26,CLE,45,45,1234,194,454,0.427,55,152,0.362,139,302,0.46,0.488,104,114,0.912,18,94,112,92,38,5,36,101,547
2019,Rodney Hood,SG,26,POR,27,4,659,98,217,0.452,29,84,0.345,69,133,0.519,0.518,33,41,0.805,7,38,45,34,21,7,19,45,258
2019,Chandler Hutchison,SF,22,CHI,44,14,895,96,209,0.459,14,50,0.28,82,159,0.516,0.493,23,38,0.605,31,154,185,34,23,6,25,59,229
2019,Serge Ibaka,C,29,TOR,74,51,2010,464,877,0.529,49,169,0.29,415,708,0.586,0.557,135,177,0.763,156,445,601,99,29,103,114,211,1112
2019,Ersan İlyasova,PF,31,MIL,67,7,1231,167,381,0.438,58,160,0.363,109,221,0.493,0.514,61,74,0.824,94,208,302,52,32,20,48,172,453
2019,Wes Iwundu,SF,24,ORL,68,13,1233,113,274,0.412,29,79,0.367,84,195,0.431,0.465,84,103,0.816,37,147,184,73,28,22,44,123,339
2019,Demetrius Jackson,PG,24,PHI,6,0,39,8,15,0.533,2,6,0.333,6,9,0.667,0.6,4,4,1,2,1,3,5,2,0,1,4,22
2019,Justin Jackson,SF,23,SAC,52,3,1083,125,295,0.424,55,159,0.346,70,136,0.515,0.517,41,50,0.82,25,121,146,68,23,13,22,67,346
2019,Justin Jackson,SF,23,DAL,29,11,531,92,190,0.484,32,86,0.372,60,104,0.577,0.568,21,29,0.724,19,47,66,28,9,1,7,32,237
2019,Reggie Jackson,PG,28,DET,82,82,2289,441,1047,0.421,174,471,0.369,267,576,0.464,0.504,204,236,0.864,45,171,216,344,55,9,148,208,1260
2019,John Jenkins,SG,27,WAS,4,0,14,2,2,1,2,2,1,0,0,NA,1.5,0,0,NA,0,1,1,1,0,0,0,0,6
2019,John Jenkins,SG,27,NYK,22,0,319,40,103,0.388,20,56,0.357,20,47,0.426,0.485,15,18,0.833,6,30,36,21,0,2,9,10,115
2019,Jonas Jerebko,PF,31,GSW,73,6,1218,163,355,0.459,69,188,0.367,94,167,0.563,0.556,64,80,0.8,72,216,288,96,27,18,43,137,459
2019,B.J. Johnson,SF,23,ATL,6,0,43,8,16,0.5,3,6,0.5,5,10,0.5,0.594,2,2,1,2,6,8,0,2,0,2,3,21
2019,B.J. Johnson,SF,23,SAC,1,0,6,1,2,0.5,0,1,0,1,1,1,0.5,0,0,NA,0,0,0,0,0,0,0,1,2
2019,James Johnson,PF,31,MIA,55,33,1164,164,379,0.433,50,149,0.336,114,230,0.496,0.499,50,70,0.714,22,154,176,135,35,27,74,114,428
2019,Stanley Johnson,SF,22,DET,48,7,961,133,349,0.381,51,181,0.282,82,168,0.488,0.454,41,51,0.804,25,150,175,60,48,13,55,92,358
2019,Stanley Johnson,SF,22,NOP,18,0,247,38,91,0.418,11,34,0.324,27,57,0.474,0.478,9,13,0.692,9,33,42,28,12,1,26,22,96
2019,Tyler Johnson,PG,26,MIA,44,10,1123,171,401,0.426,72,204,0.353,99,197,0.503,0.516,61,88,0.693,19,102,121,112,40,21,63,72,475
2019,Tyler Johnson,PG,26,PHO,13,12,406,46,125,0.368,18,56,0.321,28,69,0.406,0.44,34,39,0.872,15,37,52,54,14,6,14,25,144
2019,Wesley Johnson,SF,31,NOP,26,13,377,35,88,0.398,19,50,0.38,16,38,0.421,0.506,6,9,0.667,10,44,54,16,12,7,12,45,95
2019,Wesley Johnson,SF,31,WAS,12,0,157,10,40,0.25,6,26,0.231,4,14,0.286,0.325,7,10,0.7,2,16,18,7,2,5,6,18,33
2019,Damian Jones,C,23,GSW,24,22,410,53,74,0.716,0,0,NA,53,74,0.716,0.716,24,37,0.649,31,44,75,28,12,25,16,63,130
2019,Derrick Jones Jr.,SF,21,MIA,60,14,1153,160,324,0.494,28,91,0.308,132,233,0.567,0.537,74,122,0.607,96,144,240,37,46,42,43,123,422
2019,Jalen Jones,SF,25,CLE,16,0,214,26,62,0.419,10,28,0.357,16,34,0.471,0.5,19,27,0.704,11,23,34,7,9,2,8,27,81
2019,Terrence Jones,PF,27,HOU,2,0,5,1,4,0.25,0,2,0,1,2,0.5,0.25,0,1,0,0,4,4,0,0,0,1,1,2
2019,DeAndre Jordan,C,30,DAL,50,50,1554,208,323,0.644,0,0,NA,208,323,0.644,0.644,135,198,0.682,161,525,686,99,33,53,111,125,551
2019,DeAndre Jordan,C,30,NYK,19,19,493,78,123,0.634,0,0,NA,78,123,0.634,0.634,51,66,0.773,64,152,216,57,9,20,42,42,207
2019,Cory Joseph,PG,27,IND,82,9,2063,226,548,0.412,55,171,0.322,171,377,0.454,0.463,30,43,0.698,39,240,279,321,94,22,80,131,537
2019,Michael Kidd-Gilchrist,PF,25,CHO,64,3,1179,158,332,0.476,16,47,0.34,142,285,0.498,0.5,95,123,0.772,88,158,246,61,32,39,43,156,427
2019,Brandon Knight,PG,27,HOU,12,0,118,11,47,0.234,5,32,0.156,6,15,0.4,0.287,9,11,0.818,1,8,9,9,2,0,5,14,36
2019,Brandon Knight,PG,27,CLE,27,26,618,88,213,0.413,36,97,0.371,52,116,0.448,0.498,18,23,0.783,9,41,50,62,19,2,25,48,230
2019,Luke Kornet,PF,23,NYK,46,18,784,107,283,0.378,70,193,0.363,37,90,0.411,0.502,38,46,0.826,28,107,135,54,27,42,25,41,322
2019,Kyle Korver,PF,37,CLE,16,0,251,35,76,0.461,25,54,0.463,10,22,0.455,0.625,13,16,0.813,0,29,29,17,3,2,17,22,108
2019,Kyle Korver,SG,37,UTA,54,0,1083,166,407,0.408,113,294,0.384,53,113,0.469,0.547,47,57,0.825,9,124,133,64,22,10,42,84,492
2019,Kosta Koufos,C,29,SAC,42,1,502,73,153,0.477,0,0,NA,73,153,0.477,0.477,10,24,0.417,52,125,177,36,15,18,27,68,156
2019,Rodions Kurucs,SF,20,BRK,63,46,1294,202,449,0.45,58,184,0.315,144,265,0.543,0.514,72,92,0.783,56,190,246,52,41,25,77,146,534
2019,Skal Labissière,PF,22,SAC,13,0,113,13,30,0.433,4,11,0.364,9,19,0.474,0.5,6,11,0.545,4,20,24,6,2,3,7,21,36
2019,Skal Labissière,PF,22,POR,9,1,63,13,19,0.684,2,2,1,11,17,0.647,0.737,3,6,0.5,5,14,19,5,3,3,4,8,31
2019,Courtney Lee,SG,33,NYK,12,2,160,21,47,0.447,5,16,0.313,16,31,0.516,0.5,9,14,0.643,6,21,27,16,8,2,5,13,56
2019,Courtney Lee,SG,33,DAL,22,4,268,32,82,0.39,11,39,0.282,21,43,0.488,0.457,5,7,0.714,3,24,27,21,13,1,9,19,80
2019,Alex Len,C,25,ATL,77,31,1544,320,648,0.494,74,204,0.363,246,444,0.554,0.551,140,216,0.648,158,266,424,86,27,69,97,200,854
2019,Jon Leuer,PF,29,DET,41,1,402,66,113,0.584,1,11,0.091,65,102,0.637,0.588,23,31,0.742,27,70,97,14,12,4,23,60,156
2019,Caris LeVert,SF,24,BRK,40,25,1063,207,483,0.429,48,154,0.312,159,329,0.483,0.478,85,123,0.691,35,116,151,156,42,14,69,77,547
2019,Jeremy Lin,PG,30,ATL,51,1,1003,180,386,0.466,44,132,0.333,136,254,0.535,0.523,142,168,0.845,16,103,119,181,38,7,98,96,546
2019,Jeremy Lin,PG,30,TOR,23,3,433,58,155,0.374,11,55,0.2,47,100,0.47,0.41,34,42,0.81,6,54,60,50,9,6,26,48,161
2019,Shaun Livingston,PG,33,GSW,64,0,967,109,210,0.519,0,2,0,109,208,0.524,0.519,40,51,0.784,42,75,117,114,31,27,38,74,258
2019,Kyle Lowry,PG,32,TOR,65,65,2213,304,739,0.411,157,453,0.347,147,286,0.514,0.518,161,194,0.83,41,271,312,564,91,31,182,166,926
2019,Timothé Luwawu-Cabarrot,SF,23,OKC,21,1,123,13,43,0.302,5,22,0.227,8,21,0.381,0.36,4,6,0.667,4,14,18,4,4,1,5,14,35
2019,Timothé Luwawu-Cabarrot,SF,23,CHI,29,6,546,69,175,0.394,31,94,0.33,38,81,0.469,0.483,27,35,0.771,7,72,79,22,15,7,16,59,196
2019,Shelvin Mack,PG,28,MEM,53,3,1204,161,389,0.414,46,128,0.359,115,261,0.441,0.473,53,75,0.707,18,84,102,182,45,4,62,81,421
2019,Shelvin Mack,PG,28,CHO,4,0,42,2,14,0.143,0,2,0,2,12,0.167,0.143,5,9,0.556,0,2,2,1,2,0,4,3,9
2019,Thon Maker,C,21,MIL,35,0,409,59,134,0.44,26,78,0.333,33,56,0.589,0.537,20,37,0.541,17,79,96,18,10,18,9,55,164
2019,Thon Maker,PF,21,DET,29,5,563,50,134,0.373,23,75,0.307,27,59,0.458,0.459,36,47,0.766,24,82,106,27,11,33,24,50,159
2019,Boban Marjanović,C,30,LAC,36,9,376,85,140,0.607,0,2,0,85,138,0.616,0.607,72,95,0.758,55,97,152,22,11,17,37,57,242
2019,Boban Marjanović,C,30,PHI,22,3,305,75,120,0.625,4,8,0.5,71,112,0.634,0.642,26,36,0.722,32,81,113,32,5,10,22,33,180
2019,Wesley Matthews,SF,32,DAL,44,44,1312,194,469,0.414,100,263,0.38,94,206,0.456,0.52,87,110,0.791,20,82,102,100,33,12,58,102,575
2019,Wesley Matthews,SG,32,NYK,2,1,54,4,19,0.211,2,10,0.2,2,9,0.222,0.263,4,5,0.8,1,2,3,5,1,1,2,2,14
2019,Wesley Matthews,SG,32,IND,23,23,725,81,210,0.386,48,130,0.369,33,80,0.413,0.5,41,48,0.854,11,54,65,55,20,4,31,56,251
2019,Luc Mbah a Moute,PF,32,LAC,4,0,61,8,18,0.444,2,6,0.333,6,12,0.5,0.5,2,5,0.4,2,5,7,2,1,1,2,8,20
2019,Patrick McCaw,SG,23,CLE,3,0,53,2,9,0.222,1,4,0.25,1,5,0.2,0.278,0,0,NA,0,3,3,2,2,0,3,1,5
2019,Patrick McCaw,SG,23,TOR,26,1,344,24,54,0.444,8,24,0.333,16,30,0.533,0.519,13,15,0.867,7,38,45,27,21,2,14,37,69
2019,Doug McDermott,SF,27,IND,77,1,1340,207,422,0.491,84,206,0.408,123,216,0.569,0.59,66,79,0.835,17,92,109,67,18,8,42,104,564
2019,JaVale McGee,C,31,LAL,75,62,1671,400,641,0.624,1,12,0.083,399,629,0.634,0.625,96,152,0.632,195,371,566,52,47,148,108,208,897
2019,Ben McLemore,SG,25,SAC,19,0,158,25,64,0.391,17,41,0.415,8,23,0.348,0.523,8,12,0.667,3,14,17,4,6,3,5,22,75
2019,Jordan McRae,SG,27,WAS,27,0,333,61,130,0.469,10,35,0.286,51,95,0.537,0.508,28,35,0.8,6,34,40,30,13,7,15,26,160
2019,Jodie Meeks,SG,31,TOR,8,0,104,21,39,0.538,8,18,0.444,13,21,0.619,0.641,1,1,1,1,11,12,8,1,1,2,5,51
2019,C.J. Miles,SF,31,TOR,40,1,562,70,206,0.34,43,137,0.314,27,69,0.391,0.444,35,44,0.795,12,56,68,22,18,10,21,62,218
2019,C.J. Miles,SF,31,MEM,13,0,294,42,105,0.4,24,66,0.364,18,39,0.462,0.514,13,14,0.929,1,26,27,14,8,5,9,17,121
2019,Nikola Mirotić,PF,27,NOP,32,22,925,182,407,0.447,85,231,0.368,97,176,0.551,0.552,85,101,0.842,46,218,264,35,21,25,37,86,534
2019,Nikola Mirotić,PF,27,MIL,14,3,320,56,135,0.415,31,87,0.356,25,48,0.521,0.53,20,23,0.87,14,61,75,20,10,9,11,21,163
2019,Greg Monroe,C,28,TOR,38,2,423,74,161,0.46,0,4,0,74,157,0.471,0.46,35,61,0.574,60,96,156,16,13,8,31,61,183
2019,Greg Monroe,C,28,BOS,2,0,5,3,5,0.6,0,0,NA,3,5,0.6,0.6,0,0,NA,3,0,3,1,0,0,0,0,6
2019,Greg Monroe,C,28,PHI,3,0,52,15,23,0.652,1,1,1,14,22,0.636,0.674,10,11,0.909,4,9,13,7,1,0,1,5,41
2019,Eric Moreland,PF,27,PHO,1,0,5,0,0,NA,0,0,NA,0,0,NA,NA,0,0,NA,0,3,3,0,0,0,0,1,0
2019,Eric Moreland,PF,27,TOR,4,0,38,3,7,0.429,1,1,1,2,6,0.333,0.5,0,0,NA,4,13,17,4,1,1,5,8,7
2019,Marcus Morris,PF,29,BOS,75,53,2091,377,844,0.447,146,389,0.375,231,455,0.508,0.533,146,173,0.844,76,382,458,109,43,25,92,181,1046
2019,Markieff Morris,PF,29,WAS,34,15,883,143,328,0.436,48,144,0.333,95,184,0.516,0.509,57,73,0.781,41,133,174,60,25,20,47,117,391
2019,Markieff Morris,PF,29,OKC,24,1,387,61,156,0.391,20,59,0.339,41,97,0.423,0.455,14,19,0.737,20,71,91,19,11,2,7,58,156
2019,Emmanuel Mudiay,PG,22,NYK,59,42,1607,330,740,0.446,69,210,0.329,261,530,0.492,0.493,144,186,0.774,33,163,196,228,43,19,140,103,873
2019,Mike Muscala,PF,27,PHI,47,6,1041,109,278,0.392,68,199,0.342,41,79,0.519,0.514,63,77,0.818,51,149,200,62,18,27,43,112,349
2019,Mike Muscala,PF,27,LAL,17,4,265,36,83,0.434,21,57,0.368,15,26,0.577,0.56,7,8,0.875,6,38,44,14,4,11,5,18,100
2019,Svi Mykhailiuk,SF,21,LAL,39,0,420,44,132,0.333,27,85,0.318,17,47,0.362,0.436,12,20,0.6,8,26,34,33,13,1,20,25,127
2019,Svi Mykhailiuk,SF,21,DET,3,0,20,2,8,0.25,2,4,0.5,0,4,0,0.375,0,0,NA,1,1,2,4,1,0,1,0,6
2019,Larry Nance Jr.,C,26,CLE,67,30,1795,249,479,0.52,33,98,0.337,216,381,0.567,0.554,96,134,0.716,168,384,552,214,100,40,97,192,627
2019,Shabazz Napier,PG,27,BRK,56,2,983,169,435,0.389,76,228,0.333,93,207,0.449,0.476,115,138,0.833,18,82,100,143,41,16,66,67,529
2019,Nerlens Noel,C,24,OKC,77,2,1055,162,276,0.587,0,0,NA,162,276,0.587,0.587,54,79,0.684,127,198,325,45,66,96,48,166,378
2019,James Nunnally,SF,28,MIN,13,0,64,9,21,0.429,5,13,0.385,4,8,0.5,0.548,4,4,1,0,4,4,5,1,0,1,4,27
2019,James Nunnally,SF,28,HOU,2,0,38,3,13,0.231,3,12,0.25,0,1,0,0.346,0,0,NA,0,1,1,2,0,0,0,6,9
2019,Jusuf Nurkić,C,24,POR,72,72,1974,420,826,0.508,3,29,0.103,417,797,0.523,0.51,282,365,0.773,243,505,748,233,71,103,168,250,1125
2019,Jahlil Okafor,C,23,NOP,59,24,935,212,362,0.586,1,5,0.2,211,357,0.591,0.587,59,89,0.663,82,196,278,40,15,40,52,96,484
2019,Victor Oladipo,SG,26,IND,36,36,1147,249,588,0.423,74,216,0.343,175,372,0.47,0.486,103,141,0.73,21,181,202,186,60,11,82,72,675
2019,Kelly Olynyk,PF,27,MIA,79,36,1812,261,564,0.463,113,319,0.354,148,245,0.604,0.563,152,185,0.822,72,303,375,140,53,37,114,183,787
2019,Kelly Oubre Jr.,SF,23,WAS,29,7,755,132,305,0.433,41,132,0.311,91,173,0.526,0.5,68,85,0.8,24,105,129,20,27,20,30,71,373
2019,Kelly Oubre Jr.,SF,23,PHO,40,12,1180,243,537,0.453,67,206,0.325,176,331,0.532,0.515,121,159,0.761,47,149,196,64,57,39,73,110,674
2019,Jabari Parker,PF,23,CHI,39,17,1042,220,464,0.474,37,114,0.325,183,350,0.523,0.514,79,108,0.731,41,200,241,84,23,14,84,87,556
2019,Jabari Parker,PF,23,WAS,25,0,682,149,285,0.523,24,81,0.296,125,204,0.613,0.565,52,76,0.684,38,142,180,68,23,16,67,58,374
2019,Patrick Patterson,PF,29,OKC,63,5,861,82,219,0.374,46,137,0.336,36,82,0.439,0.479,19,30,0.633,42,105,147,31,16,13,22,46,229
2019,Cameron Payne,PG,24,CHI,31,12,536,69,168,0.411,16,59,0.271,53,109,0.486,0.458,22,25,0.88,10,43,53,83,20,6,34,49,176
2019,Cameron Payne,PG,24,CLE,9,1,176,27,55,0.491,9,25,0.36,18,30,0.6,0.573,11,16,0.688,3,16,19,23,8,3,11,15,74
2019,Elfrid Payton,PG,24,NOP,42,42,1250,179,412,0.434,33,105,0.314,146,307,0.476,0.475,55,74,0.743,49,171,220,320,44,17,112,81,446
2019,Gary Payton II,PG,26,WAS,3,0,16,5,8,0.625,1,2,0.5,4,6,0.667,0.688,0,0,NA,1,1,2,4,3,1,1,2,11
2019,Mason Plumlee,C,28,DEN,82,17,1731,262,442,0.593,2,10,0.2,260,432,0.602,0.595,111,198,0.561,165,359,524,243,66,76,126,252,637
2019,Miles Plumlee,C,30,ATL,18,0,173,32,48,0.667,0,0,NA,32,48,0.667,0.667,16,30,0.533,16,23,39,17,6,4,10,14,80
2019,Quincy Pondexter,SF,30,SAS,53,0,292,29,58,0.5,6,18,0.333,23,40,0.575,0.552,34,42,0.81,8,38,46,24,11,1,13,24,98
2019,Otto Porter Jr.,SF,25,WAS,41,28,1191,202,442,0.457,65,176,0.369,137,266,0.515,0.531,49,64,0.766,40,191,231,80,64,22,40,79,518
2019,Otto Porter Jr.,SF,25,CHI,15,15,492,97,201,0.483,39,80,0.488,58,121,0.479,0.58,29,32,0.906,14,69,83,40,18,9,25,29,262
2019,Bobby Portis,PF,23,CHI,22,6,531,122,271,0.45,27,72,0.375,95,199,0.477,0.5,39,50,0.78,46,115,161,29,11,8,29,61,310
2019,Bobby Portis,PF,23,WAS,28,22,768,157,357,0.44,48,119,0.403,109,238,0.458,0.507,38,47,0.809,63,179,242,43,24,12,45,84,400
2019,Dwight Powell,C,27,DAL,77,22,1662,290,486,0.597,39,127,0.307,251,359,0.699,0.637,196,254,0.772,140,271,411,112,44,50,67,201,815
2019,Norman Powell,SG,25,TOR,60,3,1126,193,400,0.483,68,170,0.4,125,230,0.543,0.568,62,75,0.827,16,123,139,91,39,13,65,96,516
2019,Taurean Prince,SF,24,ATL,55,47,1552,262,594,0.441,123,315,0.39,139,279,0.498,0.545,95,116,0.819,22,177,199,118,53,19,100,141,742
2019,Chasson Randle,PG,25,WAS,49,2,743,91,217,0.419,46,115,0.4,45,102,0.441,0.525,43,62,0.694,10,46,56,97,25,3,43,91,271
2019,J.J. Redick,SG,34,PHI,76,63,2379,452,1027,0.44,240,605,0.397,212,422,0.502,0.557,228,255,0.894,20,166,186,206,32,17,101,129,1372
2019,Cameron Reynolds,SG,23,MIN,19,0,259,33,78,0.423,21,51,0.412,12,27,0.444,0.558,8,9,0.889,4,27,31,13,6,2,5,26,95
2019,Malachi Richardson,SG,23,TOR,22,0,103,9,29,0.31,8,25,0.32,1,4,0.25,0.448,4,5,0.8,2,11,13,0,1,0,8,13,30
2019,Austin Rivers,SG,26,WAS,29,2,683,76,194,0.392,33,106,0.311,43,88,0.489,0.477,25,46,0.543,10,61,71,58,18,10,36,72,210
2019,Austin Rivers,SG,26,HOU,47,13,1345,156,378,0.413,71,221,0.321,85,157,0.541,0.507,25,49,0.51,15,76,91,109,29,13,32,135,408
2019,Glenn Robinson III,SF,25,DET,47,18,610,74,176,0.42,18,62,0.29,56,114,0.491,0.472,32,40,0.8,17,54,71,21,14,8,18,45,198
2019,Jerome Robinson,SG,21,LAC,33,0,320,44,110,0.4,18,57,0.316,26,53,0.491,0.482,6,9,0.667,3,38,41,19,11,3,13,46,112
2019,Rajon Rondo,PG,32,LAL,46,29,1369,175,432,0.405,51,142,0.359,124,290,0.428,0.464,23,36,0.639,34,209,243,367,57,7,127,100,424
2019,Derrick Rose,PG,30,MIN,51,13,1392,363,753,0.482,54,146,0.37,309,607,0.509,0.518,137,160,0.856,33,107,140,220,31,12,82,57,917
2019,Terrence Ross,SG,27,ORL,81,0,2150,440,1027,0.428,217,566,0.383,223,461,0.484,0.534,126,144,0.875,27,253,280,135,72,29,90,119,1223
2019,D'Angelo Russell,PG,22,BRK,81,81,2448,659,1517,0.434,234,635,0.369,425,882,0.482,0.512,160,205,0.78,53,262,315,563,100,20,253,141,1712
2019,JaKarr Sampson,SF,25,CHI,4,0,127,29,54,0.537,5,14,0.357,24,40,0.6,0.583,17,21,0.81,5,27,32,4,4,3,4,8,80
2019,Dario Šarić,PF,24,PHI,13,13,396,48,132,0.364,21,70,0.3,27,62,0.435,0.443,27,30,0.9,21,65,86,26,4,3,25,39,144
2019,Dario Šarić,PF,24,MIN,68,28,1627,256,564,0.454,97,253,0.383,159,311,0.511,0.54,105,120,0.875,105,266,371,101,41,6,72,143,714
2019,Mike Scott,PF,30,LAC,52,0,748,92,230,0.4,52,133,0.391,40,97,0.412,0.513,12,18,0.667,24,150,174,44,17,8,27,88,248
2019,Mike Scott,PF,30,PHI,27,3,647,76,190,0.4,49,119,0.412,27,71,0.38,0.529,10,15,0.667,19,83,102,22,9,5,17,68,211
2019,Thabo Sefolosha,SF,34,UTA,50,2,609,71,149,0.477,34,78,0.436,37,71,0.521,0.591,14,22,0.636,8,115,123,27,43,5,25,41,190
2019,Wayne Selden,SG,24,MEM,32,0,455,65,161,0.404,20,63,0.317,45,98,0.459,0.466,22,29,0.759,16,28,44,36,10,6,23,48,172
2019,Wayne Selden,SG,24,CHI,43,13,984,131,322,0.407,35,111,0.315,96,211,0.455,0.461,45,63,0.714,21,115,136,73,23,7,56,83,342
2019,Landry Shamet,SG,21,PHI,54,4,1108,153,347,0.441,99,245,0.404,54,102,0.529,0.584,44,54,0.815,14,64,78,59,24,8,26,106,449
2019,Landry Shamet,SG,21,LAC,25,23,694,87,210,0.414,68,151,0.45,19,59,0.322,0.576,31,39,0.795,7,49,56,58,13,2,19,49,273
2019,Iman Shumpert,SG,28,SAC,42,40,1099,133,348,0.382,74,202,0.366,59,146,0.404,0.489,34,41,0.829,19,110,129,91,47,20,38,92,374
2019,Iman Shumpert,SG,28,HOU,20,1,382,34,98,0.347,21,71,0.296,13,27,0.481,0.454,2,4,0.5,8,46,54,21,12,4,12,35,91
2019,Jonathon Simmons,SG,29,ORL,41,9,845,104,286,0.364,19,83,0.229,85,203,0.419,0.397,56,72,0.778,23,77,100,95,18,14,56,68,283
2019,Jonathon Simmons,SF,29,PHI,15,0,219,29,64,0.453,9,21,0.429,20,43,0.465,0.523,16,25,0.64,4,22,26,33,11,1,12,21,83
2019,Dennis Smith Jr.,PG,21,DAL,32,32,908,157,357,0.44,43,125,0.344,114,232,0.491,0.5,57,82,0.695,18,79,97,138,40,11,100,82,414
2019,Dennis Smith Jr.,PG,21,NYK,21,18,600,121,293,0.413,24,83,0.289,97,210,0.462,0.454,42,74,0.568,14,44,58,114,27,9,54,47,308
2019,Ish Smith,PG,30,DET,56,0,1251,205,489,0.419,44,135,0.326,161,354,0.455,0.464,47,62,0.758,23,122,145,203,28,11,61,109,501
2019,J.R. Smith,SG,33,CLE,11,4,222,27,79,0.342,12,39,0.308,15,40,0.375,0.418,8,10,0.8,0,18,18,21,11,3,11,19,74
2019,Jason Smith,C,32,WAS,12,1,130,15,37,0.405,4,10,0.4,11,27,0.407,0.459,10,12,0.833,11,26,37,12,1,5,7,21,44
2019,Jason Smith,PF,32,MIL,6,0,40,4,13,0.308,3,9,0.333,1,4,0.25,0.423,2,2,1,3,8,11,1,2,2,5,6,13
2019,Jason Smith,C,32,NOP,2,0,20,2,9,0.222,2,7,0.286,0,2,0,0.333,2,2,1,2,2,4,1,0,0,1,3,8
2019,Ray Spalding,PF,21,DAL,1,0,1,0,0,NA,0,0,NA,0,0,NA,NA,0,0,NA,0,0,0,0,0,0,0,0,0
2019,Ray Spalding,PF,21,PHO,13,3,147,25,47,0.532,0,3,0,25,44,0.568,0.532,4,12,0.333,15,33,48,5,9,8,9,23,54
2019,Nik Stauskas,SG,25,POR,44,0,673,96,229,0.419,43,125,0.344,53,104,0.51,0.513,32,36,0.889,10,70,80,62,14,4,40,31,267
2019,Nik Stauskas,SG,25,CLE,24,0,342,40,109,0.367,27,63,0.429,13,46,0.283,0.491,25,28,0.893,8,39,47,19,7,3,11,19,132
2019,Lance Stephenson,SG,28,LAL,68,3,1123,184,432,0.426,73,197,0.371,111,235,0.472,0.51,50,73,0.685,32,183,215,140,41,7,86,111,491
2019,Caleb Swanigan,PF,21,POR,18,0,145,14,44,0.318,1,5,0.2,13,39,0.333,0.33,6,7,0.857,13,39,52,7,4,0,16,22,35
2019,Caleb Swanigan,PF,21,SAC,3,0,33,4,9,0.444,0,2,0,4,7,0.571,0.444,0,2,0,4,8,12,4,2,1,2,6,8
2019,Jeff Teague,PG,30,MIN,42,41,1264,176,416,0.423,35,105,0.333,141,311,0.453,0.465,123,153,0.804,16,90,106,343,43,18,97,90,510
2019,Garrett Temple,SG,32,MEM,49,49,1530,166,387,0.429,74,210,0.352,92,177,0.52,0.525,57,76,0.75,18,134,152,69,50,25,54,134,463
2019,Garrett Temple,SG,32,LAC,26,6,510,42,106,0.396,16,54,0.296,26,52,0.5,0.472,23,31,0.742,10,54,64,37,26,5,16,70,123
2019,Emanuel Terry,PF,22,PHO,2,0,20,4,6,0.667,0,0,NA,4,6,0.667,0.667,1,2,0.5,2,4,6,1,3,0,2,4,9
2019,Emanuel Terry,PF,22,MIA,1,0,3,0,1,0,0,0,NA,0,1,0,0,1,2,0.5,1,0,1,1,0,0,0,0,1
2019,Daniel Theis,C,26,BOS,66,2,908,146,266,0.549,26,67,0.388,120,199,0.603,0.598,56,76,0.737,87,138,225,68,21,42,33,161,374
2019,Isaiah Thomas,SG,29,DEN,12,0,181,34,99,0.343,12,43,0.279,22,56,0.393,0.404,17,27,0.63,5,8,13,23,5,1,18,17,97
2019,Lance Thomas,PF,30,NYK,46,17,783,78,197,0.396,22,79,0.278,56,118,0.475,0.452,27,36,0.75,21,96,117,27,17,7,24,83,205
2019,Sindarius Thornwell,SG,24,LAC,64,1,313,17,49,0.347,3,15,0.2,14,34,0.412,0.378,25,34,0.735,5,39,44,18,14,7,20,41,62
2019,Anthony Tolliver,PF,33,MIN,65,0,1079,99,259,0.382,81,215,0.377,18,44,0.409,0.539,47,60,0.783,15,162,177,46,17,21,36,91,326
2019,Gary Trent Jr.,SG,20,POR,15,1,111,16,50,0.32,5,21,0.238,11,29,0.379,0.37,3,7,0.429,1,10,11,5,1,2,4,4,40
2019,P.J. Tucker,PF,33,HOU,82,82,2802,207,523,0.396,146,387,0.377,61,136,0.449,0.535,41,59,0.695,121,358,479,96,132,39,63,252,601
2019,Evan Turner,PG,30,POR,73,2,1605,204,443,0.46,11,52,0.212,193,391,0.494,0.473,75,106,0.708,37,291,328,283,33,18,114,110,494
2019,Ekpe Udoh,C,31,UTA,51,1,320,50,72,0.694,0,0,NA,50,72,0.694,0.694,19,30,0.633,27,63,90,28,10,31,13,36,119
2019,Jonas Valančiūnas,C,26,TOR,30,10,564,149,259,0.575,9,30,0.3,140,229,0.611,0.593,77,94,0.819,54,162,216,29,13,23,39,82,384
2019,Jonas Valančiūnas,C,26,MEM,19,17,527,152,279,0.545,5,18,0.278,147,261,0.563,0.554,70,91,0.769,52,151,203,41,6,30,51,64,379
2019,Jarred Vanderbilt,PF,19,DEN,17,0,69,9,19,0.474,0,1,0,9,18,0.5,0.474,6,10,0.6,7,16,23,3,6,1,8,8,24
2019,Noah Vonleh,PF,23,NYK,68,57,1722,207,440,0.47,46,137,0.336,161,303,0.531,0.523,111,156,0.712,113,415,528,129,46,51,88,174,571
2019,Nikola Vučević,C,28,ORL,80,80,2510,701,1354,0.518,84,231,0.364,617,1123,0.549,0.549,179,227,0.789,224,736,960,307,81,89,159,157,1665
2019,Dwyane Wade,SG,37,MIA,72,2,1885,416,960,0.433,86,261,0.33,330,699,0.472,0.478,165,233,0.708,69,216,285,301,59,38,166,118,1083
2019,Moritz Wagner,C,21,LAL,43,5,446,71,171,0.415,22,77,0.286,49,94,0.521,0.48,43,53,0.811,17,68,85,24,11,13,39,57,207
2019,Dion Waiters,SG,27,MIA,44,28,1138,198,478,0.414,109,289,0.377,89,189,0.471,0.528,22,44,0.5,7,109,116,121,29,9,64,72,527
2019,Brad Wanamaker,PG,29,BOS,36,0,343,50,105,0.476,16,39,0.41,34,66,0.515,0.552,24,28,0.857,3,38,41,56,12,2,19,34,140
2019,Andrew Wiggins,SF,23,MIN,73,73,2543,498,1209,0.412,118,348,0.339,380,861,0.441,0.461,207,296,0.699,83,269,352,184,70,48,138,153,1321
2019,Lou Williams,SG,32,LAC,75,1,1993,484,1138,0.425,105,291,0.361,379,847,0.447,0.471,425,485,0.876,40,182,222,402,57,11,181,80,1498
2019,Marvin Williams,PF,32,CHO,75,75,2133,275,652,0.422,140,382,0.366,135,270,0.5,0.529,66,86,0.767,76,331,407,92,71,61,47,156,756
2019,Troy Williams,SF,24,SAC,21,0,312,44,98,0.449,14,44,0.318,30,54,0.556,0.52,9,15,0.6,12,47,59,11,10,8,9,37,111
2019,D.J. Wilson,PF,22,MIL,48,3,882,104,251,0.414,46,127,0.362,58,124,0.468,0.506,26,47,0.553,45,177,222,52,18,20,32,85,280
2019,Christian Wood,PF,23,MIL,13,0,62,12,25,0.48,3,5,0.6,9,20,0.45,0.54,10,15,0.667,4,16,20,2,0,0,3,3,37
2019,Christian Wood,PF,23,NOP,8,2,189,49,92,0.533,6,21,0.286,43,71,0.606,0.565,31,41,0.756,13,50,63,6,7,10,14,14,135
2019,Delon Wright,PG,26,TOR,49,2,897,127,293,0.433,30,90,0.333,97,203,0.478,0.485,53,61,0.869,39,86,125,110,46,15,37,53,337
2019,Delon Wright,PG,26,MEM,26,11,802,115,265,0.434,20,78,0.256,95,187,0.508,0.472,66,89,0.742,29,112,141,138,42,15,40,50,316
2019,Nick Young,SG,33,DEN,4,0,37,3,9,0.333,3,8,0.375,0,1,0,0.5,0,0,NA,0,1,1,2,0,1,2,4,9
2019,Thaddeus Young,PF,30,IND,81,81,2489,443,841,0.527,51,146,0.349,392,695,0.564,0.557,87,135,0.644,192,331,523,204,123,36,123,194,1024
2019,Tyler Zeller,C,29,ATL,2,0,11,0,2,0,0,1,0,0,1,0,0,0,0,NA,2,4,6,1,0,0,0,4,0
2019,Tyler Zeller,C,29,MEM,4,1,82,16,28,0.571,0,0,NA,16,28,0.571,0.571,14,18,0.778,9,9,18,3,1,3,4,16,46
2019,Ivica Zubac,C,21,LAL,33,12,516,112,193,0.58,0,0,NA,112,193,0.58,0.58,57,66,0.864,54,108,162,25,4,27,33,73,281
2019,Ivica Zubac,C,21,LAC,26,25,524,100,186,0.538,0,0,NA,100,186,0.538,0.538,44,60,0.733,61,139,200,38,10,24,37,64,244
2020,LaMarcus Aldridge,C,34,SAS,53,53,1754,391,793,0.493,61,157,0.389,330,636,0.519,0.532,158,191,0.827,103,289,392,129,36,87,74,128,1001
2020,Jarrett Allen,C,21,BRK,70,64,1852,302,465,0.649,0,6,0,302,459,0.658,0.649,171,270,0.633,216,455,671,110,40,92,77,162,775
2020,Al-Farouq Aminu,PF,29,ORL,18,2,380,25,86,0.291,9,36,0.25,16,50,0.32,0.343,19,29,0.655,24,63,87,21,18,8,17,27,78
2020,Justin Anderson,SG,26,BRK,10,1,107,10,38,0.263,6,29,0.207,4,9,0.444,0.342,2,4,0.5,1,20,21,8,0,6,4,13,28
2020,Ryan Anderson,C,31,HOU,2,0,14,2,7,0.286,1,5,0.2,1,2,0.5,0.357,0,0,NA,0,7,7,2,1,0,1,1,5
2020,Carmelo Anthony,PF,35,POR,58,58,1902,336,782,0.43,87,226,0.385,249,556,0.448,0.485,136,161,0.845,71,297,368,85,49,27,100,171,895
2020,Trevor Ariza,SF,34,SAC,32,0,791,64,165,0.388,43,122,0.352,21,43,0.488,0.518,21,27,0.778,21,125,146,50,35,7,28,63,192
2020,Trevor Ariza,SF,34,POR,21,21,702,78,159,0.491,34,85,0.4,44,74,0.595,0.597,41,47,0.872,13,87,100,41,34,8,28,48,231
2020,D.J. Augustin,PG,32,ORL,57,13,1420,184,461,0.399,70,201,0.348,114,260,0.438,0.475,161,181,0.89,22,100,122,262,34,1,86,72,599
2020,Harrison Barnes,PF,27,SAC,72,72,2482,365,793,0.46,102,268,0.381,263,525,0.501,0.525,214,267,0.801,77,278,355,159,43,12,88,93,1046
2020,Will Barton,SF,29,DEN,58,58,1916,332,738,0.45,108,288,0.375,224,450,0.498,0.523,102,133,0.767,76,289,365,212,61,29,88,121,874
2020,Keita Bates-Diop,PF,24,MIN,37,0,646,87,206,0.422,31,94,0.33,56,112,0.5,0.498,46,65,0.708,21,89,110,30,17,20,14,36,251
2020,Keita Bates-Diop,SF,24,DEN,7,0,98,13,28,0.464,3,9,0.333,10,19,0.526,0.518,8,10,0.8,4,13,17,0,2,4,3,7,37
2020,Kent Bazemore,SF,30,POR,43,21,1111,113,326,0.347,56,171,0.327,57,155,0.368,0.433,58,72,0.806,13,159,172,61,45,31,60,121,340
2020,Kent Bazemore,SF,30,SAC,25,0,577,87,208,0.418,28,73,0.384,59,135,0.437,0.486,55,75,0.733,14,108,122,32,29,9,31,75,257
2020,Malik Beasley,SG,23,DEN,41,0,746,117,301,0.389,58,161,0.36,59,140,0.421,0.485,33,38,0.868,9,68,77,48,31,6,36,50,325
2020,Malik Beasley,SG,23,MIN,14,14,463,110,233,0.472,49,115,0.426,61,118,0.517,0.577,21,28,0.75,9,62,71,27,9,2,21,27,290
2020,Marco Belinelli,SG,33,SAS,57,0,883,123,314,0.392,67,178,0.376,56,136,0.412,0.498,48,58,0.828,7,92,99,69,12,1,19,45,361
2020,Jordan Bell,C,25,MIN,27,0,235,32,60,0.533,2,9,0.222,30,51,0.588,0.55,17,29,0.586,28,50,78,14,2,10,18,17,83
2020,Jordan Bell,C,25,MEM,2,0,21,3,7,0.429,2,3,0.667,1,4,0.25,0.571,2,2,1,2,1,3,2,1,0,3,2,10
2020,Dragan Bender,C,22,MIL,7,0,91,10,21,0.476,4,9,0.444,6,12,0.5,0.571,2,3,0.667,0,20,20,9,0,5,5,16,26
2020,Dragan Bender,PF,22,GSW,9,3,195,31,71,0.437,11,34,0.324,20,37,0.541,0.514,8,11,0.727,16,37,53,19,4,4,16,26,81
2020,Khem Birch,C,27,ORL,48,24,922,73,143,0.51,0,1,0,73,142,0.514,0.51,66,101,0.653,91,129,220,50,20,23,31,91,212
2020,Nemanja Bjelica,PF,31,SAC,72,67,2011,314,653,0.481,134,320,0.419,180,333,0.541,0.583,69,84,0.821,111,347,458,203,62,40,99,216,831
2020,Eric Bledsoe,PG,30,MIL,61,61,1646,334,703,0.475,74,215,0.344,260,488,0.533,0.528,169,214,0.79,43,239,282,328,57,26,148,128,911
2020,Bojan Bogdanović,SF,30,UTA,63,63,2083,418,935,0.447,189,457,0.414,229,478,0.479,0.548,250,277,0.903,39,220,259,131,34,7,159,110,1275
2020,Jonah Bolden,C,24,PHI,4,0,14,2,3,0.667,0,1,0,2,2,1,0.667,0,2,0,0,1,1,0,1,0,2,4,4
2020,Jonah Bolden,C,24,PHO,3,0,33,2,8,0.25,0,3,0,2,5,0.4,0.25,2,2,1,3,5,8,0,2,2,0,6,6
2020,Avery Bradley,SG,29,LAL,49,44,1186,170,383,0.444,63,173,0.364,107,210,0.51,0.526,20,24,0.833,18,97,115,63,43,5,47,110,423
2020,Tony Bradley,C,22,UTA,58,3,663,126,189,0.667,3,3,1,123,186,0.661,0.675,30,46,0.652,111,156,267,23,14,33,30,115,285
2020,Ignas Brazdeikis,SF,21,NYK,9,0,53,6,22,0.273,1,9,0.111,5,13,0.385,0.295,4,5,0.8,2,3,5,4,0,1,2,3,17
2020,Corey Brewer,PF,33,SAC,5,0,33,2,4,0.5,0,1,0,2,3,0.667,0.5,1,3,0.333,2,6,8,2,4,0,2,7,5
2020,Troy Brown Jr.,SF,20,WAS,69,22,1782,273,622,0.439,61,179,0.341,212,443,0.479,0.488,109,139,0.784,76,307,383,178,85,7,79,132,716
2020,Reggie Bullock,SG,28,NYK,29,19,684,90,224,0.402,37,111,0.333,53,113,0.469,0.484,17,21,0.81,13,55,68,42,25,3,19,56,234
2020,Trey Burke,PG,27,PHI,25,0,329,59,127,0.465,16,38,0.421,43,89,0.483,0.528,13,18,0.722,15,20,35,53,7,1,12,21,147
2020,Trey Burke,PG,27,DAL,8,1,191,35,82,0.427,16,37,0.432,19,45,0.422,0.524,10,11,0.909,1,14,15,30,9,1,9,12,96
2020,Alec Burks,SF,28,GSW,48,18,1390,244,601,0.406,84,224,0.375,160,377,0.424,0.476,201,224,0.897,37,189,226,151,50,17,76,107,773
2020,Alec Burks,SG,28,PHI,18,1,364,77,167,0.461,32,77,0.416,45,90,0.5,0.557,34,41,0.829,11,45,56,38,12,0,15,21,220
2020,Jimmy Butler,SF,30,MIA,58,58,1959,345,758,0.455,29,119,0.244,316,639,0.495,0.474,438,525,0.834,106,280,386,350,103,32,127,81,1157
2020,Bruno Caboclo,C,24,MEM,22,0,192,28,69,0.406,4,25,0.16,24,44,0.545,0.435,2,3,0.667,17,27,44,10,10,12,7,23,62
2020,Bruno Caboclo,C,24,HOU,8,0,52,10,20,0.5,2,8,0.25,8,12,0.667,0.55,6,6,1,6,10,16,2,5,5,6,8,28
2020,DeMarre Carroll,SF,33,SAS,15,0,135,9,29,0.31,3,13,0.231,6,16,0.375,0.362,12,20,0.6,7,24,31,11,2,2,10,20,33
2020,DeMarre Carroll,C,33,HOU,9,0,155,16,37,0.432,5,20,0.25,11,17,0.647,0.5,17,22,0.773,5,19,24,14,6,3,7,12,54
2020,Vince Carter,PF,43,ATL,60,0,876,107,304,0.352,61,202,0.302,46,102,0.451,0.452,23,29,0.793,18,106,124,48,23,25,33,90,298
2020,Wendell Carter Jr.,C,20,CHI,43,43,1256,183,343,0.534,6,29,0.207,177,314,0.564,0.542,112,152,0.737,139,266,405,51,33,36,72,162,484
2020,Michael Carter-Williams,SG,28,ORL,45,0,833,111,260,0.427,22,75,0.293,89,185,0.481,0.469,79,95,0.832,46,101,147,109,49,22,52,87,323
2020,Willie Cauley-Stein,C,26,GSW,41,37,940,144,257,0.56,0,0,NA,144,257,0.56,0.56,35,57,0.614,71,184,255,60,45,50,35,102,323
2020,Willie Cauley-Stein,C,26,DAL,13,2,157,31,45,0.689,0,1,0,31,44,0.705,0.689,5,9,0.556,13,47,60,10,4,11,5,19,67
2020,Tyson Chandler,C,37,HOU,26,5,219,14,18,0.778,0,0,NA,14,18,0.778,0.778,6,13,0.462,25,41,66,6,6,8,8,32,34
2020,Wilson Chandler,PF,32,BRK,35,3,734,74,183,0.404,37,121,0.306,37,62,0.597,0.505,20,23,0.87,11,134,145,39,16,12,34,79,205
2020,Chris Chiozza,PG,24,WAS,10,0,123,10,34,0.294,7,16,0.438,3,18,0.167,0.397,0,0,NA,0,15,15,28,10,2,9,12,27
2020,Chris Chiozza,PG,24,BRK,18,2,278,45,106,0.425,20,56,0.357,25,50,0.5,0.519,5,5,1,9,29,38,55,11,2,23,25,115
2020,Marquese Chriss,PF,22,GSW,59,21,1196,210,385,0.545,8,39,0.205,202,346,0.584,0.556,120,156,0.769,114,251,365,114,39,62,78,122,548
2020,Gary Clark,PF,25,HOU,18,0,212,23,59,0.39,18,51,0.353,5,8,0.625,0.542,6,7,0.857,11,29,40,12,2,7,2,21,70
2020,Gary Clark,SF,25,ORL,24,5,355,31,74,0.419,21,60,0.35,10,14,0.714,0.561,3,3,1,26,44,70,5,4,15,8,25,86
2020,Jordan Clarkson,SG,27,CLE,29,0,666,144,326,0.442,59,159,0.371,85,167,0.509,0.532,76,86,0.884,21,48,69,70,17,8,39,33,423
2020,Jordan Clarkson,SG,27,UTA,42,2,1039,250,541,0.462,93,254,0.366,157,287,0.547,0.548,62,79,0.785,29,89,118,66,29,8,58,75,655
2020,Antonius Cleveland,SG,25,DAL,11,0,46,4,14,0.286,0,3,0,4,11,0.364,0.286,3,5,0.6,2,5,7,1,1,3,2,8,11
2020,Quinn Cook,PG,26,LAL,44,1,508,91,214,0.425,31,85,0.365,60,129,0.465,0.498,11,14,0.786,11,40,51,49,12,2,33,27,224
2020,Tyler Cook,PF,22,CLE,11,0,35,7,10,0.7,0,0,NA,7,10,0.7,0.7,5,6,0.833,4,6,10,1,1,0,1,4,19
2020,Tyler Cook,SF,22,DEN,2,0,19,1,2,0.5,0,0,NA,1,2,0.5,0.5,2,2,1,2,2,4,0,2,0,2,1,4
2020,Robert Covington,PF,29,MIN,48,47,1411,216,496,0.435,108,312,0.346,108,184,0.587,0.544,75,94,0.798,36,251,287,56,80,45,73,148,615
2020,Robert Covington,C,29,HOU,22,21,726,89,227,0.392,53,168,0.315,36,59,0.61,0.509,24,30,0.8,27,149,176,32,35,48,30,72,255
2020,Allen Crabbe,SG,27,ATL,28,1,522,52,143,0.364,30,93,0.323,22,50,0.44,0.469,9,12,0.75,10,55,65,28,15,4,12,36,143
2020,Allen Crabbe,SF,27,MIN,9,0,131,11,34,0.324,6,26,0.231,5,8,0.625,0.412,1,2,0.5,1,11,12,5,0,0,5,11,29
2020,Torrey Craig,SF,29,DEN,58,27,1072,124,269,0.461,45,138,0.326,79,131,0.603,0.545,22,36,0.611,63,126,189,47,23,36,25,135,315
2020,Jamal Crawford,SG,39,BRK,1,0,6,2,4,0.5,1,2,0.5,1,2,0.5,0.625,0,0,NA,0,0,0,3,0,0,0,1,5
2020,Jae Crowder,SF,29,MEM,45,45,1322,147,399,0.368,78,266,0.293,69,133,0.519,0.466,75,95,0.789,40,237,277,125,47,14,54,85,447
2020,Jae Crowder,PF,29,MIA,20,8,553,79,164,0.482,57,128,0.445,22,36,0.611,0.655,22,30,0.733,12,95,107,36,25,10,15,58,237
2020,Seth Curry,SG,29,DAL,64,25,1576,284,574,0.495,145,321,0.452,139,253,0.549,0.621,80,97,0.825,27,118,145,124,38,9,62,113,793
2020,Troy Daniels,SG,28,LAL,41,0,456,62,158,0.392,40,112,0.357,22,46,0.478,0.519,10,16,0.625,12,34,46,14,8,3,9,30,174
2020,Troy Daniels,SG,28,DEN,6,0,76,10,28,0.357,6,20,0.3,4,8,0.5,0.464,0,0,NA,0,6,6,3,3,0,3,7,26
2020,Ed Davis,C,30,UTA,28,1,303,22,46,0.478,0,0,NA,22,46,0.478,0.478,7,14,0.5,35,70,105,12,11,9,13,61,51
2020,Terence Davis,SG,22,TOR,72,4,1209,199,436,0.456,94,242,0.388,105,194,0.541,0.564,51,59,0.864,50,187,237,115,39,14,76,124,543
2020,Dewayne Dedmon,C,30,SAC,34,10,541,69,171,0.404,14,71,0.197,55,100,0.55,0.444,23,28,0.821,46,121,167,15,15,26,47,93,175
2020,Dewayne Dedmon,C,30,ATL,10,8,233,33,84,0.393,8,36,0.222,25,48,0.521,0.44,7,8,0.875,14,68,82,7,10,15,10,40,81
2020,Matthew Dellavedova,PG,29,CLE,57,4,821,62,175,0.354,21,91,0.231,41,84,0.488,0.414,32,37,0.865,18,57,75,180,20,2,59,78,177
2020,Hamidou Diallo,SF,21,OKC,46,3,896,132,296,0.446,16,57,0.281,116,239,0.485,0.473,38,63,0.603,44,123,167,36,37,9,51,101,318
2020,Gorgui Dieng,C,30,MIN,46,17,778,124,277,0.448,46,120,0.383,78,157,0.497,0.531,47,59,0.797,73,183,256,58,37,42,44,89,341
2020,Gorgui Dieng,C,30,MEM,17,0,318,42,87,0.483,8,32,0.25,34,55,0.618,0.529,31,42,0.738,18,80,98,15,14,17,16,35,123
2020,Goran Dragić,PG,33,MIA,59,3,1663,319,724,0.441,124,338,0.367,195,386,0.505,0.526,191,246,0.776,29,158,187,301,40,10,144,124,953
2020,Andre Drummond,C,26,DET,49,48,1654,360,679,0.53,1,21,0.048,359,658,0.546,0.531,149,255,0.584,226,549,775,138,97,82,174,176,870
2020,Andre Drummond,C,26,CLE,8,8,225,58,105,0.552,4,14,0.286,54,91,0.593,0.571,20,39,0.513,24,65,89,14,12,11,29,25,140
2020,Jared Dudley,PF,34,LAL,45,1,364,24,60,0.4,18,42,0.429,6,18,0.333,0.55,2,2,1,6,46,52,28,15,3,8,41,68
2020,Henry Ellenson,C,23,BRK,5,0,15,1,7,0.143,0,4,0,1,3,0.333,0.143,0,0,NA,2,4,6,1,0,0,0,1,2
2020,Wayne Ellington,SG,32,NYK,36,1,558,61,174,0.351,50,143,0.35,11,31,0.355,0.494,11,13,0.846,4,61,65,44,13,4,18,41,183
2020,James Ennis III,SF,29,PHI,49,0,776,100,226,0.442,37,106,0.349,63,120,0.525,0.524,48,61,0.787,48,102,150,41,23,14,31,85,285
2020,James Ennis III,SG,29,ORL,20,18,489,60,133,0.451,18,63,0.286,42,70,0.6,0.519,31,37,0.838,23,72,95,22,12,8,27,52,169
2020,Jacob Evans,SG,22,GSW,27,1,414,45,133,0.338,13,38,0.342,32,95,0.337,0.387,25,29,0.862,9,32,41,31,11,12,25,41,128
2020,Jacob Evans,SG,22,MIN,2,0,4,0,1,0,0,1,0,0,0,NA,0,0,0,NA,0,0,0,0,0,0,0,0,0
2020,Dante Exum,SG,24,UTA,11,0,83,10,23,0.435,2,6,0.333,8,17,0.471,0.478,2,2,1,3,9,12,7,1,2,10,8,24
2020,Dante Exum,SG,24,CLE,24,1,402,46,96,0.479,13,37,0.351,33,59,0.559,0.547,30,41,0.732,9,46,55,33,12,6,21,30,135
2020,Derrick Favors,C,28,NOP,51,49,1243,209,339,0.617,1,7,0.143,208,332,0.627,0.618,40,71,0.563,163,338,501,81,30,46,55,107,459
2020,Yogi Ferrell,PG,26,SAC,50,0,530,79,188,0.42,24,79,0.304,55,109,0.505,0.484,36,42,0.857,6,43,49,69,18,4,28,38,218
2020,Evan Fournier,SF,27,ORL,66,66,2076,434,929,0.467,173,434,0.399,261,495,0.527,0.56,180,220,0.818,18,153,171,209,71,15,125,161,1221
2020,Tim Frazier,PG,29,DET,27,11,355,34,94,0.362,10,30,0.333,24,64,0.375,0.415,19,24,0.792,9,24,33,93,14,4,36,42,97
2020,Enes Freedom,C,27,BOS,58,7,983,199,348,0.572,1,7,0.143,198,341,0.581,0.573,70,99,0.707,163,268,431,56,22,41,56,100,469
2020,Wenyen Gabriel,PF,22,SAC,11,0,61,6,17,0.353,1,8,0.125,5,9,0.556,0.382,6,10,0.6,4,6,10,3,3,2,5,7,19
2020,Wenyen Gabriel,PF,22,POR,19,1,174,15,31,0.484,5,12,0.417,10,19,0.526,0.565,9,12,0.75,17,25,42,5,8,5,11,32,44
2020,Daniel Gafford,C,21,CHI,43,7,609,94,134,0.701,0,0,NA,94,134,0.701,0.701,32,60,0.533,52,54,106,21,13,56,29,98,220
2020,Danilo Gallinari,PF,31,OKC,62,62,1834,358,817,0.438,178,439,0.405,180,378,0.476,0.547,266,298,0.893,34,288,322,119,42,5,76,75,1160
2020,Langston Galloway,SG,28,DET,66,6,1702,236,542,0.435,132,331,0.399,104,211,0.493,0.557,73,85,0.859,33,116,149,101,48,11,40,96,677
2020,Marc Gasol,C,35,TOR,44,43,1161,119,279,0.427,57,148,0.385,62,131,0.473,0.529,36,49,0.735,31,244,275,147,34,38,59,124,331
2020,Rudy Gay,PF,33,SAS,67,5,1461,266,596,0.446,74,220,0.336,192,376,0.511,0.508,120,136,0.882,61,301,362,114,35,33,88,103,726
2020,Taj Gibson,C,34,NYK,62,56,1025,167,286,0.584,4,14,0.286,163,272,0.599,0.591,41,56,0.732,111,156,267,52,27,30,47,122,379
2020,Aaron Gordon,PF,24,ORL,62,62,2017,335,767,0.437,73,237,0.308,262,530,0.494,0.484,151,224,0.674,107,368,475,228,51,39,100,125,894
2020,Treveon Graham,SF,26,MIN,33,20,663,62,175,0.354,20,83,0.241,42,92,0.457,0.411,27,37,0.73,29,71,100,30,17,2,19,66,171
2020,Treveon Graham,SF,26,ATL,22,0,266,25,67,0.373,13,37,0.351,12,30,0.4,0.47,9,19,0.474,22,28,50,15,7,4,10,36,72
2020,Jerami Grant,PF,25,DEN,71,24,1892,303,634,0.478,98,252,0.389,205,382,0.537,0.555,147,196,0.75,58,190,248,88,50,57,63,154,851
2020,JaMychal Green,PF,29,LAC,63,1,1307,151,352,0.429,92,238,0.387,59,114,0.518,0.56,36,48,0.75,77,311,388,49,29,24,54,174,430
2020,Javonte Green,SG,26,BOS,48,2,468,63,126,0.5,9,33,0.273,54,93,0.581,0.536,28,42,0.667,24,69,93,26,24,8,23,43,163
2020,Jeff Green,PF,33,UTA,30,2,553,75,195,0.385,34,104,0.327,41,91,0.451,0.472,49,63,0.778,14,67,81,20,12,10,27,46,233
2020,Jeff Green,C,33,HOU,18,2,407,84,149,0.564,28,79,0.354,56,70,0.8,0.658,24,28,0.857,10,42,52,30,14,9,15,43,220
2020,Blake Griffin,PF,30,DET,18,18,512,88,250,0.352,27,111,0.243,61,139,0.439,0.406,76,98,0.776,17,67,84,59,7,7,40,27,279
2020,Donta Hall,PF,22,DET,4,0,48,1,4,0.25,0,0,NA,1,4,0.25,0.25,4,6,0.667,6,9,15,2,1,1,2,9,6
2020,Donta Hall,C,22,BRK,5,0,85,14,18,0.778,0,0,NA,14,18,0.778,0.778,5,12,0.417,8,15,23,2,2,5,3,14,33
2020,Tim Hardaway Jr.,SG,27,DAL,71,58,2091,384,884,0.434,204,513,0.398,180,371,0.485,0.55,149,182,0.819,25,207,232,137,41,5,69,125,1121
2020,James Harden,SG,30,HOU,68,68,2483,672,1514,0.444,299,843,0.355,373,671,0.556,0.543,692,800,0.865,70,376,446,512,125,60,308,227,2335
2020,Maurice Harkless,PF,26,LAC,50,38,1141,112,217,0.516,27,73,0.37,85,144,0.59,0.578,24,42,0.571,47,153,200,48,49,30,46,120,275
2020,Maurice Harkless,SF,26,NYK,12,10,286,30,66,0.455,7,25,0.28,23,41,0.561,0.508,15,24,0.625,8,32,40,20,9,3,7,28,82
2020,Gary Harris,SG,25,DEN,56,55,1780,218,519,0.42,70,210,0.333,148,309,0.479,0.487,75,92,0.815,26,137,163,118,76,14,60,116,581
2020,Tobias Harris,PF,27,PHI,72,72,2469,553,1173,0.471,131,357,0.367,422,816,0.517,0.527,174,216,0.806,69,426,495,227,53,40,104,165,1411
2020,Shaquille Harrison,SG,26,CHI,43,10,484,77,165,0.467,16,42,0.381,61,123,0.496,0.515,39,50,0.78,22,64,86,49,34,19,19,55,209
2020,Isaiah Hartenstein,C,21,HOU,23,2,266,44,67,0.657,0,5,0,44,62,0.71,0.657,19,28,0.679,29,61,90,18,9,12,16,41,107
2020,John Henson,C,29,CLE,29,2,412,61,120,0.508,6,31,0.194,55,89,0.618,0.533,17,33,0.515,32,82,114,43,16,32,21,55,145
2020,John Henson,C,29,DET,11,6,188,34,51,0.667,2,5,0.4,32,46,0.696,0.686,6,13,0.462,14,34,48,11,8,10,15,23,76
2020,Juancho Hernangómez,PF,24,DEN,34,0,422,38,110,0.345,15,60,0.25,23,50,0.46,0.414,16,25,0.64,24,71,95,22,5,5,18,29,107
2020,Juancho Hernangómez,PF,24,MIN,14,14,411,62,137,0.453,29,69,0.42,33,68,0.485,0.558,28,46,0.609,19,83,102,18,14,4,14,35,181
2020,Willy Hernangómez,C,25,CHO,31,0,375,74,139,0.532,5,22,0.227,69,117,0.59,0.55,37,59,0.627,43,91,134,29,10,7,30,32,190
2020,Buddy Hield,SG,27,SAC,72,44,2216,498,1162,0.429,271,688,0.394,227,474,0.479,0.545,115,136,0.846,57,271,328,213,66,17,168,165,1382
2020,George Hill,PG,33,MIL,59,2,1271,194,376,0.516,81,176,0.46,113,200,0.565,0.624,85,101,0.842,50,127,177,180,47,5,57,84,554
2020,Solomon Hill,PF,28,MEM,48,3,901,96,233,0.412,56,147,0.381,40,86,0.465,0.532,26,38,0.684,24,120,144,94,31,7,40,73,274
2020,Solomon Hill,PF,28,MIA,11,1,187,14,45,0.311,7,24,0.292,7,21,0.333,0.389,14,16,0.875,5,16,21,10,12,5,11,12,49
2020,Justin Holiday,SF,30,IND,73,6,1826,208,486,0.428,134,331,0.405,74,155,0.477,0.566,53,67,0.791,32,206,238,93,87,46,44,137,603
2020,Rodney Hood,SF,27,POR,21,21,619,87,172,0.506,35,71,0.493,52,101,0.515,0.608,21,27,0.778,10,62,72,32,17,4,19,46,230
2020,Chandler Hutchison,SF,23,CHI,28,10,527,80,175,0.457,12,38,0.316,68,137,0.496,0.491,46,78,0.59,18,90,108,26,27,7,27,47,218
2020,Serge Ibaka,C,30,TOR,55,27,1485,343,670,0.512,70,182,0.385,273,488,0.559,0.564,89,124,0.718,114,338,452,77,28,46,109,153,845
2020,Ersan İlyasova,PF,32,MIL,63,8,986,146,313,0.466,50,137,0.365,96,176,0.545,0.546,72,87,0.828,62,240,302,49,24,17,34,95,414
2020,Wes Iwundu,SF,25,ORL,52,21,953,97,233,0.416,28,82,0.341,69,151,0.457,0.476,78,97,0.804,24,107,131,60,25,13,26,80,300
2020,Justin Jackson,PF,24,DAL,65,3,1045,135,341,0.396,48,163,0.294,87,178,0.489,0.466,42,50,0.84,27,127,154,52,15,10,14,69,360
2020,Reggie Jackson,PG,29,DET,14,10,381,76,198,0.384,31,82,0.378,45,116,0.388,0.462,26,33,0.788,11,30,41,72,8,1,23,21,209
2020,Reggie Jackson,SG,29,LAC,17,6,362,58,128,0.453,26,63,0.413,32,65,0.492,0.555,19,21,0.905,6,45,51,54,5,4,28,38,161
2020,DaQuan Jeffries,SG,22,SAC,13,0,141,20,40,0.5,5,18,0.278,15,22,0.682,0.563,5,6,0.833,3,15,18,7,4,1,2,19,50
2020,B.J. Johnson,SF,24,ORL,10,0,83,9,32,0.281,3,9,0.333,6,23,0.261,0.328,9,10,0.9,3,12,15,3,3,0,6,3,30
2020,James Johnson,PF,32,MIA,18,0,281,39,87,0.448,16,45,0.356,23,42,0.548,0.54,8,14,0.571,8,44,52,21,6,13,15,34,102
2020,James Johnson,C,32,MIN,14,1,338,64,128,0.5,17,46,0.37,47,82,0.573,0.566,23,34,0.676,17,49,66,53,19,19,33,46,168
2020,Stanley Johnson,PF,23,TOR,25,0,150,22,59,0.373,7,24,0.292,15,35,0.429,0.432,9,16,0.563,7,30,37,20,6,4,15,16,60
2020,Tyler Johnson,PG,27,PHO,31,3,515,65,171,0.38,24,83,0.289,41,88,0.466,0.45,24,32,0.75,10,42,52,50,12,8,24,43,178
2020,Tyler Johnson,SG,27,BRK,8,4,194,32,79,0.405,14,36,0.389,18,43,0.419,0.494,18,18,1,8,16,24,24,4,1,5,15,96
2020,Damian Jones,C,24,ATL,55,27,887,121,178,0.68,2,9,0.222,119,169,0.704,0.685,62,84,0.738,74,132,206,35,26,40,28,149,306
2020,Derrick Jones Jr.,SF,22,MIA,59,16,1375,184,349,0.527,37,132,0.28,147,217,0.677,0.58,95,123,0.772,66,167,233,62,58,38,30,130,500
2020,DeAndre Jordan,C,31,BRK,56,6,1234,191,287,0.666,0,0,NA,191,287,0.666,0.666,83,122,0.68,141,420,561,105,18,52,74,114,465
2020,Cory Joseph,PG,28,SAC,72,26,1759,171,412,0.415,56,159,0.352,115,253,0.455,0.483,60,70,0.857,44,144,188,251,53,21,80,133,458
2020,Mfiondu Kabengele,C,22,LAC,12,0,64,14,32,0.438,9,20,0.45,5,12,0.417,0.578,5,5,1,1,10,11,2,2,2,2,9,42
2020,Michael Kidd-Gilchrist,PF,26,CHO,12,0,160,18,53,0.34,5,17,0.294,13,36,0.361,0.387,7,9,0.778,9,26,35,10,0,3,7,18,48
2020,Michael Kidd-Gilchrist,PF,26,DAL,13,0,121,4,13,0.308,0,3,0,4,10,0.4,0.308,4,5,0.8,5,27,32,4,2,3,9,19,12
2020,Brandon Knight,SG,28,CLE,16,0,241,28,86,0.326,19,64,0.297,9,22,0.409,0.436,4,13,0.308,3,17,20,31,5,2,16,20,79
2020,Brandon Knight,PG,28,DET,9,3,221,31,81,0.383,26,67,0.388,5,14,0.357,0.543,16,21,0.762,1,20,21,38,5,1,22,20,104
2020,Luke Kornet,C,24,CHI,36,14,559,82,187,0.439,31,108,0.287,51,79,0.646,0.521,20,28,0.714,22,62,84,32,11,26,14,54,215
2020,Kyle Korver,SF,38,MIL,58,1,960,126,293,0.43,99,237,0.418,27,56,0.482,0.599,35,41,0.854,15,107,122,68,26,12,48,78,386
2020,Rodions Kurucs,PF,21,BRK,47,9,684,79,177,0.446,33,90,0.367,46,87,0.529,0.54,24,38,0.632,25,112,137,51,25,5,46,90,215
2020,Skal Labissière,C,23,POR,33,1,567,81,147,0.551,3,13,0.231,78,134,0.582,0.561,25,33,0.758,65,104,169,42,7,31,30,89,190
2020,Courtney Lee,SG,34,DAL,24,9,345,40,82,0.488,21,47,0.447,19,35,0.543,0.616,6,7,0.857,7,25,32,12,18,6,11,33,107
2020,Alex Len,C,26,ATL,40,9,745,142,260,0.546,14,56,0.25,128,204,0.627,0.573,51,81,0.63,69,161,230,42,20,33,39,93,349
2020,Alex Len,C,26,SAC,15,3,225,35,59,0.593,2,3,0.667,33,56,0.589,0.61,17,24,0.708,31,60,91,8,3,15,16,34,89
2020,Caris LeVert,SG,25,BRK,45,31,1330,311,732,0.425,80,220,0.364,231,512,0.451,0.48,140,197,0.711,49,140,189,199,53,10,118,81,842
2020,Kyle Lowry,PG,33,TOR,58,58,2098,334,803,0.416,164,466,0.352,170,337,0.504,0.518,294,343,0.857,32,260,292,433,82,26,178,190,1126
2020,Timothé Luwawu-Cabarrot,SF,24,BRK,47,2,853,117,269,0.435,62,160,0.388,55,109,0.505,0.55,69,81,0.852,29,98,127,29,18,7,37,106,365
2020,Thon Maker,C,22,DET,60,14,776,93,193,0.482,22,64,0.344,71,129,0.55,0.539,73,110,0.664,54,113,167,43,25,39,45,102,281
2020,Boban Marjanović,C,31,DAL,44,5,422,121,211,0.573,4,17,0.235,117,194,0.603,0.583,43,57,0.754,66,131,197,20,8,10,30,56,289
2020,Wesley Matthews,SG,33,MIL,67,67,1635,167,422,0.396,108,297,0.364,59,125,0.472,0.524,52,68,0.765,22,144,166,92,38,9,43,103,494
2020,Luc Mbah a Moute,PF,33,HOU,3,0,25,2,5,0.4,0,2,0,2,3,0.667,0.4,1,2,0.5,1,1,2,0,2,0,1,0,5
2020,Patrick McCaw,SF,24,TOR,37,12,908,67,162,0.414,23,71,0.324,44,91,0.484,0.485,13,18,0.722,19,67,86,79,39,4,29,60,170
2020,Doug McDermott,PF,28,IND,69,0,1372,267,547,0.488,128,294,0.435,139,253,0.549,0.605,48,58,0.828,26,148,174,78,12,5,42,117,710
2020,JaVale McGee,C,32,LAL,68,68,1130,195,306,0.637,3,6,0.5,192,300,0.64,0.642,53,82,0.646,125,265,390,37,36,94,55,159,446
2020,Ben McLemore,SF,26,HOU,71,23,1619,242,545,0.444,181,452,0.4,61,93,0.656,0.61,50,67,0.746,21,136,157,58,45,16,50,155,715
2020,Jordan McRae,SG,28,WAS,29,4,654,133,317,0.42,40,106,0.377,93,211,0.441,0.483,64,83,0.771,17,87,104,82,19,15,38,61,370
2020,Jordan McRae,SG,28,DEN,4,0,32,2,6,0.333,2,4,0.5,0,2,0,0.5,3,4,0.75,1,4,5,4,2,1,0,2,9
2020,Jordan McRae,SG,28,DET,4,0,98,14,43,0.326,3,16,0.188,11,27,0.407,0.36,16,22,0.727,0,15,15,7,0,0,5,10,47
2020,Nicolò Melli,C,29,NOP,60,8,1042,136,323,0.421,69,206,0.335,67,117,0.573,0.528,54,73,0.74,38,142,180,82,34,23,46,124,395
2020,C.J. Miles,SF,32,WAS,10,0,161,19,59,0.322,11,35,0.314,8,24,0.333,0.415,15,20,0.75,4,8,12,12,10,4,4,14,64
2020,Marcus Morris,SF,30,NYK,43,43,1387,281,636,0.442,116,264,0.439,165,372,0.444,0.533,163,198,0.823,48,185,233,59,34,17,73,128,841
2020,Marcus Morris,PF,30,LAC,19,19,549,74,174,0.425,26,84,0.31,48,90,0.533,0.5,18,22,0.818,11,67,78,27,13,13,24,52,192
2020,Markieff Morris,PF,30,DET,44,16,988,175,389,0.45,75,189,0.397,100,200,0.5,0.546,61,79,0.772,24,149,173,69,26,11,70,104,486
2020,Markieff Morris,PF,30,LAL,14,1,199,28,69,0.406,13,39,0.333,15,30,0.5,0.5,5,6,0.833,16,29,45,8,5,6,6,29,74
2020,Emmanuel Mudiay,PG,23,UTA,54,2,850,151,327,0.462,30,87,0.345,121,240,0.504,0.508,63,83,0.759,18,108,126,116,24,10,76,72,395
2020,Mike Muscala,C,28,OKC,47,2,572,77,189,0.407,54,143,0.378,23,46,0.5,0.55,18,22,0.818,16,92,108,40,9,12,17,58,226
2020,Svi Mykhailiuk,SF,22,DET,56,27,1265,166,405,0.41,115,285,0.404,51,120,0.425,0.552,57,70,0.814,17,87,104,106,41,4,61,87,504
2020,Larry Nance Jr.,PF,27,CLE,56,10,1472,229,431,0.531,56,159,0.352,173,272,0.636,0.596,50,74,0.676,106,303,409,123,56,22,60,91,564
2020,Shabazz Napier,PG,28,MIN,36,22,856,114,283,0.403,47,159,0.296,67,124,0.54,0.486,72,88,0.818,17,93,110,187,40,7,76,62,347
2020,Shabazz Napier,PG,28,WAS,20,10,488,74,173,0.428,29,81,0.358,45,92,0.489,0.512,54,65,0.831,9,39,48,75,29,4,52,39,231
2020,Nerlens Noel,C,25,OKC,61,7,1127,184,269,0.684,1,3,0.333,183,266,0.688,0.686,80,106,0.755,91,209,300,57,59,91,66,166,449
2020,Zach Norvell,SG,22,LAL,2,0,5,0,1,0,0,0,NA,0,1,0,0,0,0,NA,0,1,1,0,0,0,0,0,0
2020,Zach Norvell,SG,22,GSW,3,0,36,3,11,0.273,3,8,0.375,0,3,0,0.409,1,1,1,0,5,5,3,2,0,3,4,10
2020,Jusuf Nurkić,C,25,POR,8,8,253,54,109,0.495,2,10,0.2,52,99,0.525,0.505,31,35,0.886,23,59,82,32,11,16,19,39,141
2020,Jahlil Okafor,C,24,NOP,30,9,467,101,162,0.623,1,3,0.333,100,159,0.629,0.627,40,62,0.645,48,79,127,37,7,22,38,67,243
2020,Victor Oladipo,SG,27,IND,19,16,528,97,246,0.394,33,104,0.317,64,142,0.451,0.461,48,59,0.814,9,66,75,56,17,4,47,36,275
2020,Kelly Olynyk,C,28,MIA,67,9,1300,184,398,0.462,95,234,0.406,89,164,0.543,0.582,86,100,0.86,44,261,305,116,45,23,71,173,549
2020,Kelly Oubre Jr.,SF,24,PHO,56,55,1933,373,826,0.452,108,307,0.352,265,519,0.511,0.517,192,246,0.78,67,294,361,85,71,40,83,192,1046
2020,Jeremy Pargo,PG,33,GSW,3,0,44,11,22,0.5,3,7,0.429,8,15,0.533,0.568,0,1,0,1,2,3,8,1,0,4,8,25
2020,Jabari Parker,PF,24,ATL,32,23,837,198,393,0.504,31,115,0.27,167,278,0.601,0.543,53,72,0.736,54,137,191,58,42,15,60,93,480
2020,Jabari Parker,PF,24,SAC,6,0,80,21,36,0.583,1,4,0.25,20,32,0.625,0.597,8,9,0.889,7,16,23,10,3,1,4,6,51
2020,Patrick Patterson,PF,30,LAC,59,18,776,95,233,0.408,67,172,0.39,28,61,0.459,0.552,35,43,0.814,35,116,151,41,7,3,21,54,292
2020,Cameron Payne,SG,25,PHO,8,0,183,33,68,0.485,15,29,0.517,18,39,0.462,0.596,6,7,0.857,4,27,31,24,8,2,11,20,87
2020,Elfrid Payton,PG,25,NYK,45,36,1246,193,440,0.439,14,69,0.203,179,371,0.482,0.455,49,86,0.57,52,160,212,323,70,17,96,89,449
2020,Gary Payton II,SF,27,WAS,29,17,432,48,116,0.414,13,46,0.283,35,70,0.5,0.47,4,8,0.5,26,54,80,48,33,7,20,54,113
2020,Norvel Pelle,C,26,PHI,24,0,232,25,48,0.521,0,1,0,25,47,0.532,0.521,7,14,0.5,20,52,72,8,3,31,18,55,57
2020,Mason Plumlee,C,29,DEN,61,1,1057,177,288,0.615,0,5,0,177,283,0.625,0.615,83,155,0.535,98,219,317,154,33,38,82,143,437
2020,Otto Porter Jr.,SF,26,CHI,14,9,331,62,140,0.443,24,62,0.387,38,78,0.487,0.529,19,27,0.704,13,35,48,25,15,6,11,31,167
2020,Bobby Portis,PF,24,NYK,66,5,1393,265,589,0.45,67,187,0.358,198,402,0.493,0.507,71,93,0.763,80,258,338,98,32,18,73,110,668
2020,Dwight Powell,C,28,DAL,40,37,1061,146,229,0.638,10,39,0.256,136,190,0.716,0.659,74,111,0.667,75,152,227,59,34,22,36,102,376
2020,Norman Powell,SG,26,TOR,52,26,1479,296,598,0.495,109,273,0.399,187,325,0.575,0.586,129,153,0.843,26,164,190,91,60,21,77,108,830
2020,Taurean Prince,PF,25,BRK,64,61,1857,278,739,0.376,146,431,0.339,132,308,0.429,0.475,71,89,0.798,50,331,381,116,57,25,127,159,773
2020,Chasson Randle,PG,26,GSW,3,0,40,0,4,0,0,2,0,0,2,0,0,5,6,0.833,0,2,2,5,2,0,0,3,5
2020,J.J. Redick,SG,35,NOP,60,36,1581,286,631,0.453,180,397,0.453,106,234,0.453,0.596,165,185,0.892,10,141,151,119,20,10,75,96,917
2020,Austin Rivers,SG,27,HOU,68,4,1594,211,501,0.421,96,270,0.356,115,231,0.498,0.517,78,111,0.703,27,148,175,113,49,10,50,129,596
2020,Glenn Robinson III,SF,26,GSW,48,48,1516,244,507,0.481,68,170,0.4,176,337,0.522,0.548,63,74,0.851,66,160,226,85,45,14,50,82,619
2020,Glenn Robinson III,SF,26,PHI,14,4,270,44,85,0.518,9,27,0.333,35,58,0.603,0.571,11,12,0.917,15,29,44,11,9,2,5,18,108
2020,Jerome Robinson,SG,22,LAC,42,1,476,46,136,0.338,19,67,0.284,27,69,0.391,0.408,11,19,0.579,5,55,60,46,13,8,26,55,122
2020,Jerome Robinson,SG,22,WAS,21,5,503,69,174,0.397,30,86,0.349,39,88,0.443,0.483,29,38,0.763,8,61,69,41,15,9,23,57,197
2020,Rajon Rondo,PG,33,LAL,48,3,984,137,328,0.418,41,125,0.328,96,203,0.473,0.48,27,41,0.659,23,119,142,240,40,2,91,58,342
2020,Derrick Rose,PG,31,DET,50,15,1298,369,753,0.49,45,147,0.306,324,606,0.535,0.52,121,139,0.871,27,94,121,278,40,16,126,49,904
2020,Terrence Ross,SG,28,ORL,69,0,1889,341,846,0.403,177,504,0.351,164,342,0.48,0.508,157,184,0.853,13,209,222,82,77,24,70,109,1016
2020,D'Angelo Russell,PG,23,GSW,33,33,1060,273,635,0.43,120,321,0.374,153,314,0.487,0.524,113,144,0.785,14,108,122,206,31,9,101,64,779
2020,D'Angelo Russell,PG,23,MIN,12,12,392,87,211,0.412,38,110,0.345,49,101,0.485,0.502,48,55,0.873,3,52,55,79,17,4,46,22,260
2020,JaKarr Sampson,PF,26,IND,34,12,471,68,115,0.591,2,13,0.154,66,102,0.647,0.6,18,27,0.667,20,68,88,21,16,12,15,64,156
2020,Dario Šarić,PF,25,PHO,66,51,1632,256,538,0.476,84,235,0.357,172,303,0.568,0.554,108,128,0.844,100,306,406,123,37,16,88,156,704
2020,Mike Scott,PF,31,PHI,68,11,1207,149,350,0.426,80,217,0.369,69,133,0.519,0.54,30,37,0.811,65,183,248,56,21,5,26,96,408
2020,Thabo Sefolosha,PF,35,HOU,41,0,436,37,91,0.407,15,54,0.278,22,37,0.595,0.489,3,8,0.375,21,72,93,25,24,12,15,43,92
2020,Landry Shamet,SG,22,LAC,53,30,1452,158,391,0.404,111,296,0.375,47,95,0.495,0.546,65,76,0.855,6,94,100,99,20,10,42,142,492
2020,Iman Shumpert,SF,29,BRK,13,0,241,21,64,0.328,8,33,0.242,13,31,0.419,0.391,4,7,0.571,9,25,34,12,12,2,10,21,54
2020,Chris Silva,PF,23,MIA,44,0,346,48,78,0.615,0,3,0,48,75,0.64,0.615,37,55,0.673,60,66,126,23,9,21,32,85,133
2020,Dennis Smith Jr.,PG,22,NYK,34,3,537,72,211,0.341,16,54,0.296,56,157,0.357,0.379,27,53,0.509,21,57,78,98,28,8,58,65,187
2020,Ish Smith,PG,31,WAS,68,23,1787,308,689,0.447,62,169,0.367,246,520,0.473,0.492,62,86,0.721,30,189,219,334,59,30,95,106,740
2020,J.R. Smith,SG,34,LAL,6,0,79,7,22,0.318,1,11,0.091,6,11,0.545,0.341,2,2,1,0,5,5,3,1,0,4,5,17
2020,Caleb Swanigan,C,22,SAC,7,0,23,2,4,0.5,0,0,NA,2,4,0.5,0.5,1,2,0.5,2,5,7,2,1,2,6,8,5
2020,Caleb Swanigan,PF,22,POR,20,1,265,26,43,0.605,0,2,0,26,41,0.634,0.605,8,15,0.533,25,68,93,29,2,5,31,54,60
2020,Jeff Teague,PG,31,MIN,34,13,945,145,324,0.448,33,87,0.379,112,237,0.473,0.498,125,144,0.868,15,73,88,208,25,13,76,70,448
2020,Jeff Teague,PG,31,ATL,25,4,519,68,165,0.412,10,30,0.333,58,135,0.43,0.442,47,53,0.887,12,42,54,100,19,6,40,36,193
2020,Garrett Temple,SG,33,BRK,62,35,1730,222,587,0.378,127,386,0.329,95,201,0.473,0.486,70,87,0.805,29,189,218,156,49,29,62,108,641
2020,Daniel Theis,C,27,BOS,65,64,1566,241,426,0.566,32,96,0.333,209,330,0.633,0.603,87,114,0.763,140,286,426,111,37,84,54,219,601
2020,Isaiah Thomas,PG,30,WAS,40,37,925,174,426,0.408,78,189,0.413,96,237,0.405,0.5,62,76,0.816,11,57,68,146,13,6,77,77,488
2020,Lance Thomas,PF,31,BRK,7,4,98,8,23,0.348,4,13,0.308,4,10,0.4,0.435,4,4,1,2,11,13,6,0,0,6,11,24
2020,Matt Thomas,SG,25,TOR,41,1,440,73,150,0.487,47,99,0.475,26,51,0.51,0.643,9,12,0.75,9,52,61,22,10,1,16,38,202
2020,Sindarius Thornwell,SF,25,NOP,2,0,35,6,11,0.545,2,4,0.5,4,7,0.571,0.636,2,4,0.5,0,4,4,4,1,1,2,2,16
2020,Anthony Tolliver,PF,34,POR,33,9,554,43,117,0.368,30,89,0.337,13,28,0.464,0.496,13,19,0.684,27,83,110,29,8,9,21,54,129
2020,Anthony Tolliver,PF,34,SAC,9,0,82,3,17,0.176,2,15,0.133,1,2,0.5,0.235,1,2,0.5,2,9,11,3,4,1,4,6,9
2020,Anthony Tolliver,PF,34,MEM,13,4,236,19,48,0.396,17,41,0.415,2,7,0.286,0.573,7,8,0.875,5,28,33,10,7,1,9,14,62
2020,Gary Trent Jr.,SF,21,POR,61,8,1332,196,441,0.444,112,268,0.418,84,173,0.486,0.571,37,45,0.822,25,75,100,61,48,16,21,90,541
2020,P.J. Tucker,PF,34,HOU,72,72,2467,177,426,0.415,107,299,0.358,70,127,0.551,0.541,39,48,0.813,112,364,476,115,77,36,72,229,500
2020,Evan Turner,SG,31,ATL,19,0,251,25,67,0.373,0,5,0,25,62,0.403,0.373,12,14,0.857,8,30,38,38,9,8,26,20,62
2020,Jarrod Uthoff,PF,26,MEM,4,0,14,1,7,0.143,0,4,0,1,3,0.333,0.143,2,2,1,1,0,1,0,1,0,0,1,4
2020,Jarrod Uthoff,PF,26,WAS,3,0,39,6,11,0.545,3,5,0.6,3,6,0.5,0.682,0,0,NA,1,4,5,0,0,0,0,1,15
2020,Jonas Valančiūnas,C,27,MEM,70,70,1845,432,739,0.585,32,91,0.352,400,648,0.617,0.606,148,200,0.74,213,575,788,131,30,76,127,185,1044
2020,Jarred Vanderbilt,PF,20,DEN,9,0,41,5,7,0.714,0,0,NA,5,7,0.714,0.714,0,0,NA,3,5,8,2,3,1,7,6,10
2020,Jarred Vanderbilt,PF,20,MIN,2,0,5,0,1,0,0,1,0,0,0,NA,0,2,2,1,0,1,1,0,0,0,0,0,2
2020,Noah Vonleh,C,24,MIN,29,1,347,47,86,0.547,2,14,0.143,45,72,0.625,0.558,23,28,0.821,34,82,116,26,11,6,19,36,119
2020,Noah Vonleh,C,24,DEN,7,0,30,5,6,0.833,1,1,1,4,5,0.8,0.917,2,4,0.5,3,5,8,2,0,0,2,4,13
2020,Nikola Vučević,C,29,ORL,62,62,1998,493,1033,0.477,98,289,0.339,395,744,0.531,0.525,131,167,0.784,140,533,673,222,54,47,88,135,1215
2020,Moritz Wagner,C,22,WAS,45,5,835,145,266,0.545,25,80,0.313,120,186,0.645,0.592,78,95,0.821,56,163,219,56,28,19,66,152,393
2020,Dion Waiters,SG,28,MIA,3,0,42,10,26,0.385,8,17,0.471,2,9,0.222,0.538,0,1,0,0,11,11,3,0,2,3,5,28
2020,Dion Waiters,SG,28,LAL,7,0,165,31,73,0.425,7,30,0.233,24,43,0.558,0.473,14,16,0.875,2,11,13,17,4,4,13,16,83
2020,Derrick Walton,PG,24,LAC,23,1,222,17,36,0.472,9,21,0.429,8,15,0.533,0.597,7,9,0.778,2,13,15,22,4,0,4,19,50
2020,Derrick Walton,PG,24,DET,3,0,26,1,3,0.333,1,3,0.333,0,0,NA,0.5,0,0,NA,0,1,1,5,3,0,1,2,3
2020,Brad Wanamaker,PG,30,BOS,71,1,1369,162,362,0.448,37,102,0.363,125,260,0.481,0.499,126,136,0.926,22,122,144,179,61,14,76,133,487
2020,Paul Watson,SF,25,ATL,2,0,17,0,7,0,0,3,0,0,4,0,0,0,0,NA,0,2,2,3,1,0,0,1,0
2020,Paul Watson,SF,25,TOR,8,0,70,10,19,0.526,4,9,0.444,6,10,0.6,0.632,7,9,0.778,2,13,15,5,3,1,3,4,31
2020,Andrew Wiggins,SF,24,MIN,42,42,1455,351,790,0.444,91,275,0.331,260,515,0.505,0.502,149,207,0.72,48,171,219,155,29,36,107,101,942
2020,Andrew Wiggins,SF,24,GSW,12,12,403,86,188,0.457,20,59,0.339,66,129,0.512,0.511,41,61,0.672,18,37,55,43,16,17,25,26,233
2020,Lou Williams,PG,33,LAC,65,8,1864,391,936,0.418,111,315,0.352,280,621,0.451,0.477,292,339,0.861,31,170,201,365,43,12,182,80,1185
2020,Marvin Williams,PF,33,CHO,41,1,808,94,210,0.448,44,117,0.376,50,93,0.538,0.552,43,50,0.86,15,94,109,41,26,22,25,71,275
2020,Marvin Williams,PF,33,MIL,17,0,321,25,57,0.439,12,39,0.308,13,18,0.722,0.544,6,7,0.857,15,59,74,19,10,8,8,32,68
2020,D.J. Wilson,PF,23,MIL,37,1,363,52,132,0.394,18,73,0.247,34,59,0.576,0.462,11,18,0.611,12,80,92,25,3,5,19,33,133
2020,Christian Wood,PF,24,DET,62,12,1325,288,508,0.567,54,140,0.386,234,368,0.636,0.62,180,242,0.744,104,286,390,60,34,54,84,98,810
2020,Delon Wright,PG,27,DAL,73,5,1570,190,411,0.462,47,127,0.37,143,284,0.504,0.519,77,100,0.77,70,210,280,244,85,22,73,93,504
2020,Thaddeus Young,PF,31,CHI,64,16,1591,269,601,0.448,79,222,0.356,190,379,0.501,0.513,42,72,0.583,94,221,315,117,92,23,102,134,659
2020,Tyler Zeller,C,30,SAS,2,0,4,1,4,0.25,0,0,NA,1,4,0.25,0.25,0,0,NA,3,1,4,0,0,0,0,0,2
2020,Ivica Zubac,C,22,LAC,72,70,1326,236,385,0.613,0,2,0,236,383,0.616,0.613,124,166,0.747,197,346,543,82,16,66,61,168,596
2021,LaMarcus Aldridge,C,35,SAS,21,18,544,115,248,0.464,27,75,0.36,88,173,0.509,0.518,31,37,0.838,17,77,94,36,8,18,20,36,288
2021,LaMarcus Aldridge,C,35,BRK,5,5,130,25,48,0.521,4,5,0.8,21,43,0.488,0.563,10,10,1,2,22,24,13,3,11,7,11,64
2021,Jarrett Allen,C,22,BRK,12,5,320,44,65,0.677,0,0,NA,44,65,0.677,0.677,46,61,0.754,38,87,125,20,7,19,22,21,134
2021,Jarrett Allen,C,22,CLE,51,40,1544,254,417,0.609,6,19,0.316,248,398,0.623,0.616,158,229,0.69,158,348,506,86,25,71,78,75,672
2021,Al-Farouq Aminu,PF,30,ORL,17,14,367,36,89,0.404,7,31,0.226,29,58,0.5,0.444,14,17,0.824,20,71,91,29,17,9,25,22,93
2021,Al-Farouq Aminu,PF,30,CHI,6,0,67,2,10,0.2,1,6,0.167,1,4,0.25,0.25,4,5,0.8,2,17,19,2,2,0,3,7,9
2021,Carmelo Anthony,PF,36,POR,69,3,1690,327,777,0.421,133,325,0.409,194,452,0.429,0.506,137,154,0.89,32,182,214,104,46,38,61,144,924
2021,Trevor Ariza,SF,35,MIA,30,27,841,99,241,0.411,50,143,0.35,49,98,0.5,0.515,34,44,0.773,27,117,144,55,31,18,21,55,282
2021,D.J. Augustin,PG,33,MIL,37,6,713,71,192,0.37,49,129,0.38,22,63,0.349,0.497,36,40,0.9,11,39,50,110,20,1,34,33,227
2021,D.J. Augustin,PG,33,HOU,20,6,416,64,151,0.424,34,88,0.386,30,63,0.476,0.536,49,54,0.907,9,35,44,78,8,0,31,23,211
2021,Harrison Barnes,PF,28,SAC,58,58,2102,319,642,0.497,100,256,0.391,219,386,0.567,0.575,195,235,0.83,64,321,385,201,43,11,93,75,933
2021,Will Barton,SF,30,DEN,56,52,1736,259,608,0.426,98,257,0.381,161,351,0.459,0.507,95,121,0.785,39,187,226,181,50,23,96,95,711
2021,Keita Bates-Diop,SF,25,SAS,30,0,245,30,67,0.448,5,17,0.294,25,50,0.5,0.485,14,21,0.667,9,40,49,12,11,5,7,11,79
2021,Kent Bazemore,SF,31,GSW,67,18,1333,176,392,0.449,75,184,0.408,101,208,0.486,0.545,54,78,0.692,26,203,229,108,69,33,82,158,481
2021,Malik Beasley,SG,24,MIN,37,36,1214,264,600,0.44,128,321,0.399,136,279,0.487,0.547,68,80,0.85,28,134,162,88,30,7,60,62,724
2021,Jordan Bell,C,26,WAS,5,1,67,7,20,0.35,0,2,0,7,18,0.389,0.35,0,0,NA,6,13,19,5,3,3,3,5,14
2021,Jordan Bell,C,26,GSW,1,0,15,0,2,0,0,0,NA,0,2,0,0,1,2,0.5,1,4,5,2,0,2,1,2,1
2021,Khem Birch,C,28,ORL,48,5,952,94,209,0.45,4,21,0.19,90,188,0.479,0.459,63,85,0.741,117,126,243,53,32,28,23,67,255
2021,Khem Birch,C,28,TOR,19,17,577,95,171,0.556,9,31,0.29,86,140,0.614,0.582,28,44,0.636,57,87,144,36,16,22,21,46,227
2021,Nemanja Bjelica,PF,32,SAC,26,1,439,69,150,0.46,17,58,0.293,52,92,0.565,0.517,32,42,0.762,24,76,100,49,8,2,28,48,187
2021,Nemanja Bjelica,PF,32,MIA,11,2,156,20,46,0.435,10,27,0.37,10,19,0.526,0.543,5,9,0.556,5,22,27,20,7,3,5,20,55
2021,Eric Bledsoe,SG,31,NOP,71,70,2111,307,730,0.421,121,355,0.341,186,375,0.496,0.503,134,195,0.687,29,215,244,268,55,24,114,112,869
2021,Bojan Bogdanović,SF,31,UTA,72,72,2216,406,925,0.439,180,461,0.39,226,464,0.487,0.536,233,265,0.879,40,241,281,136,45,4,128,115,1225
2021,Avery Bradley,SG,30,MIA,10,1,211,31,66,0.47,16,38,0.421,15,28,0.536,0.591,7,9,0.778,2,16,18,14,7,1,9,26,85
2021,Avery Bradley,SG,30,HOU,17,5,391,33,105,0.314,17,63,0.27,16,42,0.381,0.395,5,6,0.833,6,33,39,32,14,2,19,29,88
2021,Tony Bradley,C,23,PHI,20,8,287,51,75,0.68,0,1,0,51,74,0.689,0.68,7,11,0.636,39,65,104,17,6,13,6,28,109
2021,Tony Bradley,C,23,OKC,22,0,397,80,122,0.656,0,2,0,80,120,0.667,0.656,31,44,0.705,46,89,135,20,9,17,27,33,191
2021,Ignas Brazdeikis,SF,22,NYK,4,0,7,0,1,0,0,0,NA,0,1,0,0,2,2,1,1,1,2,1,0,0,1,0,2
2021,Ignas Brazdeikis,SF,22,PHI,1,0,8,0,3,0,0,1,0,0,2,0,0,0,0,NA,0,2,2,0,0,0,0,0,0
2021,Ignas Brazdeikis,SF,22,ORL,8,0,234,35,79,0.443,11,27,0.407,24,52,0.462,0.513,8,12,0.667,10,31,41,16,4,3,11,22,89
2021,Troy Brown Jr.,SF,21,WAS,21,0,287,33,89,0.371,14,46,0.304,19,43,0.442,0.449,10,15,0.667,11,50,61,19,3,4,16,29,90
2021,Troy Brown Jr.,SF,21,CHI,13,0,237,29,55,0.527,8,24,0.333,21,31,0.677,0.6,5,6,0.833,9,35,44,10,7,2,5,20,71
2021,Reggie Bullock,SF,29,NYK,65,64,1949,248,561,0.442,163,398,0.41,85,163,0.521,0.587,50,55,0.909,16,207,223,99,52,11,45,146,709
2021,Trey Burke,PG,28,DAL,62,1,911,151,353,0.428,58,164,0.354,93,189,0.492,0.51,51,57,0.895,10,44,54,81,36,7,33,64,411
2021,Alec Burks,SG,29,NYK,49,5,1255,210,500,0.42,102,246,0.415,108,254,0.425,0.522,101,118,0.856,21,206,227,107,31,14,49,102,623
2021,Jimmy Butler,SF,31,MIA,52,52,1745,366,736,0.497,25,102,0.245,341,634,0.538,0.514,359,416,0.863,94,265,359,369,108,18,109,71,1116
2021,Bruno Caboclo,PF,25,HOU,6,0,36,8,17,0.471,0,5,0,8,12,0.667,0.471,1,2,0.5,3,11,14,1,0,2,4,6,17
2021,Wendell Carter Jr.,C,21,CHI,32,25,792,129,252,0.512,8,22,0.364,121,230,0.526,0.528,82,111,0.739,70,180,250,69,18,24,49,96,348
2021,Wendell Carter Jr.,C,21,ORL,22,19,583,101,205,0.493,7,29,0.241,94,176,0.534,0.51,49,68,0.721,62,131,193,35,17,18,29,50,258
2021,Michael Carter-Williams,SG,29,ORL,31,25,800,105,270,0.389,15,61,0.246,90,209,0.431,0.417,49,80,0.613,39,100,139,129,25,17,69,81,274
2021,Willie Cauley-Stein,C,27,DAL,53,16,906,115,182,0.632,1,11,0.091,114,171,0.667,0.635,49,78,0.628,66,170,236,35,21,43,29,129,280
2021,Chris Chiozza,PG,25,BRK,22,1,232,31,88,0.352,13,42,0.31,18,46,0.391,0.426,13,17,0.765,3,21,24,65,7,6,16,19,88
2021,Marquese Chriss,PF,23,GSW,2,0,27,5,14,0.357,1,5,0.2,4,9,0.444,0.393,2,4,0.5,3,10,13,2,0,2,2,3,13
2021,Gary Clark,SF,26,ORL,35,11,637,40,131,0.305,31,108,0.287,9,23,0.391,0.424,8,10,0.8,33,79,112,30,12,7,17,34,119
2021,Gary Clark,SF,26,DEN,2,0,4,0,0,NA,0,0,NA,0,0,NA,NA,0,0,NA,0,1,1,0,0,0,0,0,0
2021,Gary Clark,PF,26,PHI,2,0,13,0,1,0,0,0,NA,0,1,0,0,0,0,NA,0,2,2,1,1,0,0,1,0
2021,Jordan Clarkson,SG,28,UTA,68,1,1818,457,1075,0.425,208,599,0.347,249,476,0.523,0.522,129,144,0.896,47,227,274,168,61,10,115,110,1251
2021,Quinn Cook,PG,27,LAL,16,0,62,12,26,0.462,5,13,0.385,7,13,0.538,0.558,4,5,0.8,0,5,5,5,1,1,3,2,33
2021,Quinn Cook,PG,27,CLE,7,0,95,17,42,0.405,6,13,0.462,11,29,0.379,0.476,3,3,1,2,10,12,13,3,0,4,8,43
2021,Tyler Cook,PF,23,BRK,4,0,17,1,3,0.333,0,0,NA,1,3,0.333,0.333,0,0,NA,1,1,2,2,0,0,1,2,2
2021,Tyler Cook,SF,23,DET,28,1,421,68,100,0.68,1,2,0.5,67,98,0.684,0.685,17,35,0.486,27,66,93,15,8,2,20,33,154
2021,DeMarcus Cousins,C,30,HOU,25,11,506,79,210,0.376,39,116,0.336,40,94,0.426,0.469,44,59,0.746,30,161,191,60,21,18,39,74,241
2021,DeMarcus Cousins,C,30,LAC,16,0,207,51,95,0.537,8,19,0.421,43,76,0.566,0.579,15,22,0.682,23,49,72,16,13,6,25,33,125
2021,Robert Covington,PF,30,POR,70,70,2243,204,509,0.401,135,356,0.379,69,153,0.451,0.533,50,62,0.806,61,405,466,117,101,84,64,195,593
2021,Torrey Craig,SF,30,MIL,18,0,201,18,46,0.391,8,22,0.364,10,24,0.417,0.478,1,2,0.5,13,30,43,16,9,7,5,24,45
2021,Torrey Craig,SF,30,PHO,32,8,602,91,181,0.503,31,84,0.369,60,97,0.619,0.588,16,20,0.8,44,110,154,33,19,19,20,59,229
2021,Jae Crowder,PF,30,PHO,60,42,1648,199,492,0.404,148,380,0.389,51,112,0.455,0.555,57,75,0.76,32,250,282,127,48,27,55,125,603
2021,Seth Curry,SG,30,PHI,57,57,1638,258,552,0.467,126,280,0.45,132,272,0.485,0.582,69,77,0.896,10,126,136,155,44,8,65,96,711
2021,Ed Davis,C,31,MIN,23,7,299,19,44,0.432,0,0,NA,19,44,0.432,0.432,10,12,0.833,46,69,115,21,13,13,7,56,48
2021,Terence Davis,SG,23,TOR,34,4,493,87,210,0.414,44,122,0.361,43,88,0.489,0.519,16,18,0.889,9,57,66,37,17,7,29,48,234
2021,Terence Davis,SG,23,SAC,27,0,581,108,246,0.439,54,145,0.372,54,101,0.535,0.549,29,37,0.784,11,77,88,46,27,7,34,49,299
2021,Dewayne Dedmon,C,31,MIA,16,0,210,46,65,0.708,1,5,0.2,45,60,0.75,0.715,20,27,0.741,28,58,86,12,9,6,13,36,113
2021,Matthew Dellavedova,PG,30,CLE,13,1,224,14,56,0.25,4,25,0.16,10,31,0.323,0.286,4,4,1,6,18,24,58,4,1,6,21,36
2021,Hamidou Diallo,SG,22,OKC,32,5,761,143,297,0.481,12,41,0.293,131,256,0.512,0.502,83,132,0.629,37,128,165,77,31,12,49,83,381
2021,Hamidou Diallo,SF,22,DET,20,4,465,81,173,0.468,16,41,0.39,65,132,0.492,0.514,45,68,0.662,22,85,107,24,10,12,27,51,223
2021,Gorgui Dieng,C,31,MEM,22,1,371,56,108,0.519,23,48,0.479,33,60,0.55,0.625,38,43,0.884,28,70,98,29,17,14,22,38,173
2021,Gorgui Dieng,C,31,SAS,16,0,181,29,55,0.527,7,22,0.318,22,33,0.667,0.591,20,24,0.833,12,30,42,19,9,2,10,18,85
2021,Goran Dragić,PG,34,MIA,50,11,1337,240,555,0.432,91,244,0.373,149,311,0.479,0.514,101,122,0.828,25,144,169,219,33,8,118,113,672
2021,Andre Drummond,C,27,CLE,25,25,722,180,380,0.474,0,8,0,180,372,0.484,0.474,77,129,0.597,101,236,337,64,40,29,81,69,437
2021,Andre Drummond,C,27,LAL,21,21,520,102,192,0.531,0,0,NA,102,192,0.531,0.531,46,76,0.605,65,149,214,30,23,20,43,80,250
2021,Jared Dudley,PF,35,LAL,12,0,81,2,9,0.222,2,6,0.333,0,3,0,0.333,0,0,NA,4,17,21,5,1,1,2,7,6
2021,Henry Ellenson,PF,24,TOR,2,0,38,5,14,0.357,2,9,0.222,3,5,0.6,0.429,3,4,0.75,3,9,12,5,0,0,0,7,15
2021,Wayne Ellington,SG,33,DET,46,31,1012,149,338,0.441,116,275,0.422,33,63,0.524,0.612,28,35,0.8,12,73,85,67,18,9,33,59,442
2021,James Ennis III,SF,30,ORL,41,37,986,115,243,0.473,45,104,0.433,70,139,0.504,0.566,70,87,0.805,43,123,166,62,32,7,36,84,345
2021,Dante Exum,SG,25,CLE,6,3,116,10,26,0.385,2,11,0.182,8,15,0.533,0.423,1,2,0.5,2,15,17,13,4,2,7,9,23
2021,Derrick Favors,C,29,UTA,68,0,1039,155,243,0.638,0,2,0,155,241,0.643,0.638,59,80,0.738,138,238,376,44,32,68,36,143,369
2021,Yogi Ferrell,PG,27,CLE,2,0,40,8,21,0.381,3,9,0.333,5,12,0.417,0.452,0,2,0,3,4,7,5,3,1,3,4,19
2021,Yogi Ferrell,PG,27,LAC,8,0,96,12,36,0.333,6,19,0.316,6,17,0.353,0.417,7,7,1,2,10,12,17,4,2,0,7,37
2021,Evan Fournier,SF,28,ORL,26,26,787,170,369,0.461,73,188,0.388,97,181,0.536,0.56,98,123,0.797,5,70,75,95,27,9,54,55,511
2021,Evan Fournier,SG,28,BOS,16,10,472,77,172,0.448,44,95,0.463,33,77,0.429,0.576,10,14,0.714,5,48,53,49,20,10,19,41,208
2021,Tim Frazier,PG,30,MEM,5,0,62,3,20,0.15,0,8,0,3,12,0.25,0.15,2,6,0.333,0,8,8,16,2,1,4,7,8
2021,Enes Freedom,C,28,POR,72,35,1758,339,561,0.604,1,4,0.25,338,557,0.607,0.605,127,164,0.774,284,511,795,84,33,48,78,168,806
2021,Wenyen Gabriel,PF,23,NOP,21,0,241,24,60,0.4,13,32,0.406,11,28,0.393,0.508,11,17,0.647,20,34,54,11,9,8,15,32,72
2021,Daniel Gafford,PF,22,CHI,31,11,383,60,87,0.69,0,0,NA,60,87,0.69,0.69,27,41,0.659,44,59,103,17,11,34,22,54,147
2021,Daniel Gafford,C,22,WAS,23,0,408,94,138,0.681,0,0,NA,94,138,0.681,0.681,45,67,0.672,50,78,128,12,15,41,19,44,233
2021,Danilo Gallinari,PF,32,ATL,51,4,1222,206,475,0.434,103,254,0.406,103,221,0.466,0.542,161,174,0.925,17,194,211,76,30,10,43,105,676
2021,Langston Galloway,SG,29,PHO,40,0,438,66,147,0.449,36,85,0.424,30,62,0.484,0.571,22,23,0.957,7,35,42,26,8,0,13,25,190
2021,Marc Gasol,C,36,LAL,52,42,993,88,194,0.454,50,122,0.41,38,72,0.528,0.582,36,50,0.72,38,177,215,109,26,58,53,115,262
2021,Rudy Gay,PF,34,SAS,63,1,1358,264,628,0.42,106,278,0.381,158,350,0.451,0.505,82,102,0.804,42,261,303,88,45,40,65,115,716
2021,Taj Gibson,C,35,NYK,45,3,936,99,158,0.627,3,15,0.2,96,143,0.671,0.636,40,55,0.727,99,151,250,36,31,49,22,99,241
2021,Aaron Gordon,PF,25,ORL,25,25,736,128,293,0.437,42,112,0.375,86,181,0.475,0.509,66,105,0.629,39,127,166,105,16,20,67,49,364
2021,Aaron Gordon,PF,25,DEN,25,25,648,103,206,0.5,17,64,0.266,86,142,0.606,0.541,31,44,0.705,38,80,118,56,17,14,30,40,254
2021,Jerami Grant,SF,26,DET,54,54,1829,400,932,0.429,115,329,0.35,285,603,0.473,0.491,290,343,0.845,35,215,250,152,35,58,109,125,1205
2021,JaMychal Green,PF,30,DEN,58,5,1120,173,374,0.463,79,198,0.399,94,176,0.534,0.568,46,57,0.807,85,192,277,53,26,22,53,144,471
2021,Javonte Green,SF,27,BOS,25,2,345,39,71,0.549,7,22,0.318,32,49,0.653,0.599,20,30,0.667,20,32,52,11,18,2,13,32,105
2021,Javonte Green,SG,27,CHI,16,0,128,14,31,0.452,3,8,0.375,11,23,0.478,0.5,10,10,1,6,13,19,6,10,4,6,13,41
2021,Jeff Green,PF,34,BRK,68,38,1835,261,530,0.492,103,250,0.412,158,280,0.564,0.59,125,161,0.776,34,229,263,108,36,27,54,122,750
2021,Blake Griffin,PF,31,DET,20,20,626,81,222,0.365,39,124,0.315,42,98,0.429,0.453,44,62,0.71,7,97,104,77,14,2,32,42,245
2021,Blake Griffin,PF,31,BRK,26,10,560,93,189,0.492,31,81,0.383,62,108,0.574,0.574,43,55,0.782,28,93,121,63,18,13,30,69,260
2021,Donta Hall,PF,23,ORL,13,0,179,25,35,0.714,0,0,NA,25,35,0.714,0.714,23,34,0.676,24,38,62,11,5,10,8,18,73
2021,R.J. Hampton,PG,19,DEN,25,0,233,25,60,0.417,5,18,0.278,20,42,0.476,0.458,9,12,0.75,10,40,50,14,5,2,11,22,64
2021,R.J. Hampton,SG,19,ORL,26,1,655,111,253,0.439,22,69,0.319,89,184,0.484,0.482,46,70,0.657,19,110,129,73,16,8,42,39,290
2021,Tim Hardaway Jr.,SG,28,DAL,70,31,1985,407,911,0.447,207,529,0.391,200,382,0.524,0.56,142,174,0.816,20,209,229,126,31,11,64,111,1163
2021,James Harden,PG,31,HOU,8,8,290,60,135,0.444,25,72,0.347,35,63,0.556,0.537,53,60,0.883,5,36,41,83,7,6,34,14,198
2021,James Harden,PG,31,BRK,36,35,1319,282,599,0.471,96,262,0.366,186,337,0.552,0.551,225,263,0.856,30,277,307,392,46,27,143,85,885
2021,Maurice Harkless,SF,27,MIA,11,3,124,5,13,0.385,5,11,0.455,0,2,0,0.577,0,2,0,2,11,13,7,2,4,3,14,15
2021,Maurice Harkless,PF,27,SAC,26,20,648,64,152,0.421,18,73,0.247,46,79,0.582,0.48,33,41,0.805,11,65,76,37,28,16,19,72,179
2021,Gary Harris,SG,26,DEN,19,19,581,69,156,0.442,24,75,0.32,45,81,0.556,0.519,22,30,0.733,13,34,47,32,17,4,14,37,184
2021,Gary Harris,SG,26,ORL,20,19,499,69,189,0.365,24,66,0.364,45,123,0.366,0.429,42,48,0.875,8,24,32,46,11,7,23,34,204
2021,Tobias Harris,PF,28,PHI,62,62,2014,473,924,0.512,82,208,0.394,391,716,0.546,0.556,182,204,0.892,62,357,419,220,55,51,107,119,1210
2021,Shaquille Harrison,SG,27,UTA,17,0,56,6,20,0.3,0,2,0,6,18,0.333,0.3,5,6,0.833,3,6,9,9,2,0,5,3,17
2021,Shaquille Harrison,SG,27,DEN,17,0,277,20,58,0.345,3,14,0.214,17,44,0.386,0.371,13,16,0.813,4,35,39,16,15,5,6,30,56
2021,Isaiah Hartenstein,C,22,DEN,30,0,272,41,80,0.513,0,0,NA,41,80,0.513,0.513,22,36,0.611,40,45,85,15,11,20,21,59,104
2021,Isaiah Hartenstein,C,22,CLE,16,2,287,53,91,0.582,2,6,0.333,51,85,0.6,0.593,24,35,0.686,25,71,96,40,8,19,23,45,132
2021,Juancho Hernangómez,PF,25,MIN,52,6,900,130,299,0.435,55,168,0.327,75,131,0.573,0.527,60,97,0.619,45,160,205,35,19,7,27,52,375
2021,Willy Hernangómez,C,26,NOP,47,12,846,151,268,0.563,1,10,0.1,150,258,0.581,0.565,62,93,0.667,117,217,334,50,22,23,34,68,365
2021,Buddy Hield,SG,28,SAC,71,71,2433,403,992,0.406,282,721,0.391,121,271,0.446,0.548,88,104,0.846,29,305,334,257,63,30,130,175,1176
2021,George Hill,PG,34,OKC,14,14,369,61,120,0.508,22,57,0.386,39,63,0.619,0.6,21,25,0.84,8,21,29,43,12,2,12,12,165
2021,George Hill,PG,34,PHI,16,3,303,34,77,0.442,9,23,0.391,25,54,0.463,0.5,19,25,0.76,8,24,32,30,11,3,19,19,96
2021,Solomon Hill,PF,29,ATL,71,16,1513,107,298,0.359,68,212,0.321,39,86,0.453,0.473,35,46,0.761,42,172,214,75,50,11,42,116,317
2021,Justin Holiday,SG,31,IND,72,52,2183,258,625,0.413,173,453,0.382,85,172,0.494,0.551,67,85,0.788,32,224,256,119,74,41,54,135,756
2021,Rodney Hood,SF,28,POR,38,5,726,73,201,0.363,25,84,0.298,48,117,0.41,0.425,9,12,0.75,18,55,73,47,20,4,31,59,180
2021,Rodney Hood,SF,28,TOR,17,0,216,21,59,0.356,9,29,0.31,12,30,0.4,0.432,15,16,0.938,5,25,30,6,4,3,5,15,66
2021,Chandler Hutchison,SF,24,CHI,7,0,64,5,18,0.278,1,3,0.333,4,15,0.267,0.306,2,2,1,1,19,20,4,1,0,5,9,13
2021,Chandler Hutchison,SF,24,WAS,18,1,282,34,85,0.4,7,19,0.368,27,66,0.409,0.441,19,23,0.826,5,53,58,13,11,5,15,24,94
2021,Serge Ibaka,C,31,LAC,41,39,955,186,365,0.51,39,115,0.339,147,250,0.588,0.563,43,53,0.811,73,202,275,74,9,47,44,76,454
2021,Ersan İlyasova,PF,33,UTA,17,1,148,21,54,0.389,18,41,0.439,3,13,0.231,0.556,5,5,1,7,22,29,4,10,3,8,29,65
2021,Wes Iwundu,SF,26,DAL,23,3,288,17,52,0.327,3,23,0.13,14,29,0.483,0.356,12,14,0.857,6,38,44,10,9,3,6,26,49
2021,Wes Iwundu,SF,26,NOP,18,1,251,17,50,0.34,2,18,0.111,15,32,0.469,0.36,14,17,0.824,9,37,46,8,6,1,13,23,50
2021,Justin Jackson,SF,25,OKC,33,3,544,86,212,0.406,34,111,0.306,52,101,0.515,0.486,30,35,0.857,14,57,71,51,15,2,31,31,236
2021,Justin Jackson,SF,25,MIL,1,0,33,3,9,0.333,2,6,0.333,1,3,0.333,0.444,1,2,0.5,2,4,6,1,0,0,1,1,9
2021,Reggie Jackson,SG,30,LAC,67,43,1544,263,585,0.45,122,282,0.433,141,303,0.465,0.554,67,82,0.817,24,168,192,205,41,7,74,127,715
2021,Mike James,PG,30,BRK,13,1,236,34,92,0.37,11,31,0.355,23,61,0.377,0.429,21,27,0.778,3,29,32,54,6,1,20,10,100
2021,DaQuan Jeffries,SG,23,SAC,18,2,232,24,57,0.421,9,28,0.321,15,29,0.517,0.5,6,7,0.857,9,20,29,6,7,4,8,23,63
2021,DaQuan Jeffries,SG,23,HOU,13,3,261,26,63,0.413,11,39,0.282,15,24,0.625,0.5,1,1,1,10,32,42,16,8,6,6,25,64
2021,James Johnson,PF,33,DAL,29,1,504,67,145,0.462,15,60,0.25,52,85,0.612,0.514,17,29,0.586,14,72,86,50,24,23,27,59,166
2021,James Johnson,PF,33,NOP,22,11,539,79,182,0.434,16,60,0.267,63,122,0.516,0.478,28,47,0.596,18,73,91,48,18,19,28,61,202
2021,Stanley Johnson,PF,24,TOR,61,13,1006,89,233,0.382,45,137,0.328,44,96,0.458,0.479,44,55,0.8,29,124,153,89,52,18,54,116,267
2021,Tyler Johnson,SG,28,BRK,39,3,684,72,183,0.393,48,132,0.364,24,51,0.471,0.525,18,21,0.857,6,71,77,47,14,0,17,43,210
2021,Damian Jones,C,25,PHO,14,0,94,8,16,0.5,0,1,0,8,15,0.533,0.5,6,11,0.545,7,11,18,4,1,5,6,19,22
2021,Damian Jones,C,25,LAL,8,6,112,16,17,0.941,0,0,NA,16,17,0.941,0.941,11,12,0.917,8,18,26,1,1,7,5,22,43
2021,Damian Jones,C,25,SAC,17,4,341,46,70,0.657,1,4,0.25,45,66,0.682,0.664,25,35,0.714,21,56,77,24,9,17,15,36,118
2021,Derrick Jones Jr.,SF,23,POR,58,43,1318,147,304,0.484,43,136,0.316,104,168,0.619,0.554,59,91,0.648,77,128,205,47,37,54,32,127,396
2021,Mason Jones,SG,22,HOU,26,1,307,47,114,0.412,23,64,0.359,24,50,0.48,0.513,35,57,0.614,4,47,51,39,6,1,28,22,152
2021,Mason Jones,SG,22,PHI,6,0,27,5,9,0.556,1,2,0.5,4,7,0.571,0.611,5,7,0.714,3,1,4,3,1,0,1,2,16
2021,DeAndre Jordan,C,32,BRK,57,43,1246,190,249,0.763,0,1,0,190,248,0.766,0.763,46,92,0.5,117,310,427,93,17,65,85,116,426
2021,Cory Joseph,PG,29,SAC,44,2,944,111,250,0.444,31,94,0.33,80,156,0.513,0.506,36,47,0.766,25,74,99,108,39,9,44,98,289
2021,Cory Joseph,PG,29,DET,19,11,502,89,176,0.506,14,38,0.368,75,138,0.543,0.545,36,41,0.878,10,50,60,105,22,9,35,41,228
2021,Mfiondu Kabengele,PF,23,LAC,23,0,94,9,32,0.281,4,18,0.222,5,14,0.357,0.344,5,6,0.833,1,13,14,5,2,3,6,18,27
2021,Mfiondu Kabengele,PF,23,CLE,16,0,186,24,57,0.421,9,32,0.281,15,25,0.6,0.5,11,14,0.786,11,35,46,12,6,10,9,18,68
2021,Luke Kornet,PF,25,CHI,13,0,94,9,27,0.333,6,23,0.261,3,4,0.75,0.444,2,4,0.5,1,14,15,4,2,7,1,1,26
2021,Luke Kornet,C,25,BOS,18,2,254,35,74,0.473,9,36,0.25,26,38,0.684,0.534,1,2,0.5,13,39,52,20,2,25,6,19,80
2021,Rodions Kurucs,PF,22,BRK,5,0,16,1,3,0.333,1,2,0.5,0,1,0,0.5,0,0,NA,0,3,3,2,0,0,0,1,3
2021,Rodions Kurucs,SF,22,HOU,11,0,75,5,21,0.238,2,15,0.133,3,6,0.5,0.286,1,2,0.5,2,9,11,4,6,4,9,7,13
2021,Rodions Kurucs,SF,22,MIL,5,0,34,5,8,0.625,3,4,0.75,2,4,0.5,0.813,2,2,1,3,6,9,4,3,0,4,8,15
2021,Alex Len,C,27,TOR,7,2,76,5,10,0.5,3,6,0.5,2,4,0.5,0.65,3,6,0.5,0,11,11,3,1,6,8,10,16
2021,Alex Len,C,27,WAS,57,40,903,166,268,0.619,5,19,0.263,161,249,0.647,0.629,70,110,0.636,78,171,249,46,19,58,47,117,407
2021,Caris LeVert,SG,26,BRK,12,4,334,87,200,0.435,22,63,0.349,65,137,0.474,0.49,26,34,0.765,10,42,52,72,13,6,26,20,222
2021,Caris LeVert,SG,26,IND,35,35,1152,272,614,0.443,62,195,0.318,210,419,0.501,0.493,120,146,0.822,23,139,162,173,53,24,76,85,726
2021,Kyle Lowry,PG,34,TOR,46,46,1601,260,596,0.436,131,331,0.396,129,265,0.487,0.546,140,160,0.875,35,212,247,338,45,14,126,143,791
2021,Timothé Luwawu-Cabarrot,SF,25,BRK,58,7,1050,130,356,0.365,75,239,0.314,55,117,0.47,0.471,35,43,0.814,28,101,129,69,33,6,43,99,370
2021,Thon Maker,C,23,CLE,8,0,76,10,18,0.556,0,2,0,10,16,0.625,0.556,10,11,0.909,8,10,18,4,2,4,3,7,30
2021,Boban Marjanović,C,32,DAL,33,3,271,62,122,0.508,1,8,0.125,61,114,0.535,0.512,31,38,0.816,47,81,128,10,2,6,12,29,156
2021,Wesley Matthews,SG,34,LAL,58,10,1130,89,252,0.353,66,197,0.335,23,55,0.418,0.484,35,41,0.854,20,73,93,54,38,17,26,80,279
2021,Patrick McCaw,SF,25,TOR,5,0,33,1,1,1,0,0,NA,1,1,1,1,3,3,1,1,2,3,4,2,0,0,6,5
2021,Doug McDermott,PF,29,IND,66,29,1619,354,665,0.532,111,286,0.388,243,379,0.641,0.616,80,98,0.816,60,161,221,85,20,6,53,117,899
2021,JaVale McGee,C,33,CLE,33,1,503,112,215,0.521,5,20,0.25,107,195,0.549,0.533,36,55,0.655,54,116,170,33,16,40,45,80,265
2021,JaVale McGee,C,33,DEN,13,1,175,32,67,0.478,0,4,0,32,63,0.508,0.478,8,12,0.667,23,46,69,6,3,14,15,41,72
2021,Ben McLemore,SG,27,HOU,32,4,537,80,224,0.357,55,166,0.331,25,58,0.431,0.48,23,32,0.719,11,55,66,28,20,3,28,51,238
2021,Ben McLemore,SG,27,LAL,21,1,368,55,141,0.39,42,114,0.368,13,27,0.481,0.539,16,21,0.762,4,30,34,11,3,6,14,37,168
2021,Nicolò Melli,PF,30,NOP,22,0,241,15,59,0.254,7,37,0.189,8,22,0.364,0.314,6,7,0.857,12,45,57,25,9,1,7,28,43
2021,Nicolò Melli,PF,30,DAL,23,4,325,31,82,0.378,16,48,0.333,15,34,0.441,0.476,13,18,0.722,17,48,65,19,5,2,5,30,91
2021,Marcus Morris,PF,31,LAC,57,29,1502,276,584,0.473,140,296,0.473,136,288,0.472,0.592,73,89,0.82,35,199,234,58,34,15,57,117,765
2021,Markieff Morris,PF,31,LAL,61,27,1200,153,378,0.405,65,209,0.311,88,169,0.521,0.491,36,50,0.72,48,218,266,73,22,19,54,105,407
2021,Mike Muscala,C,29,OKC,35,0,645,119,267,0.446,68,184,0.37,51,83,0.614,0.573,33,36,0.917,19,113,132,28,8,11,21,54,339
2021,Svi Mykhailiuk,SF,23,DET,36,5,634,84,223,0.377,57,171,0.333,27,52,0.519,0.504,24,30,0.8,11,63,74,57,27,6,39,33,249
2021,Svi Mykhailiuk,SG,23,OKC,30,9,690,124,283,0.438,48,143,0.336,76,140,0.543,0.523,14,20,0.7,13,76,89,53,24,6,49,30,310
2021,Larry Nance Jr.,PF,28,CLE,35,27,1091,128,272,0.471,41,114,0.36,87,158,0.551,0.546,30,49,0.612,54,181,235,107,61,17,55,72,327
2021,Nerlens Noel,C,26,NYK,64,41,1547,137,223,0.614,0,3,0,137,220,0.623,0.614,50,70,0.714,142,266,408,46,70,141,65,176,324
2021,James Nunnally,SF,30,NOP,9,0,48,5,13,0.385,4,12,0.333,1,1,1,0.538,1,2,0.5,2,7,9,3,0,0,2,1,15
2021,Jusuf Nurkić,C,26,POR,37,37,880,171,333,0.514,12,30,0.4,159,303,0.525,0.532,70,113,0.619,86,246,332,125,38,39,73,103,424
2021,Jahlil Okafor,C,25,DET,27,2,347,63,102,0.618,2,9,0.222,61,93,0.656,0.627,17,24,0.708,23,43,66,13,6,5,21,39,145
2021,Victor Oladipo,SG,28,IND,9,9,300,64,152,0.421,25,69,0.362,39,83,0.47,0.503,27,37,0.73,1,50,51,38,15,2,18,23,180
2021,Victor Oladipo,SG,28,HOU,20,20,669,155,381,0.407,49,153,0.32,106,228,0.465,0.471,65,83,0.783,8,87,95,99,24,10,51,45,424
2021,Victor Oladipo,SG,28,MIA,4,4,111,16,43,0.372,4,17,0.235,12,26,0.462,0.419,12,18,0.667,3,11,14,14,7,2,14,13,48
2021,Kelly Olynyk,C,29,MIA,43,38,1157,162,376,0.431,77,243,0.317,85,133,0.639,0.533,31,40,0.775,44,217,261,91,40,26,55,123,432
2021,Kelly Olynyk,PF,29,HOU,27,24,840,175,321,0.545,49,125,0.392,126,196,0.643,0.621,114,135,0.844,43,185,228,112,39,16,71,84,513
2021,Kelly Oubre Jr.,SF,25,GSW,55,50,1687,318,724,0.439,90,285,0.316,228,439,0.519,0.501,123,177,0.695,82,247,329,73,57,42,70,121,849
2021,Jabari Parker,PF,25,SAC,3,0,27,4,7,0.571,0,1,0,4,6,0.667,0.571,0,0,NA,1,5,6,1,0,1,3,4,8
2021,Jabari Parker,PF,25,BOS,10,0,138,26,48,0.542,2,10,0.2,24,38,0.632,0.563,10,13,0.769,9,27,36,10,1,4,7,9,64
2021,Patrick Patterson,PF,31,LAC,38,5,582,72,165,0.436,40,112,0.357,32,53,0.604,0.558,13,17,0.765,19,56,75,29,14,8,11,45,197
2021,Cameron Payne,PG,26,PHO,60,1,1079,191,395,0.484,73,166,0.44,118,229,0.515,0.576,50,56,0.893,16,128,144,217,36,16,60,97,505
2021,Elfrid Payton,PG,26,NYK,63,63,1484,269,622,0.432,28,98,0.286,241,524,0.46,0.455,73,107,0.682,64,152,216,203,47,9,103,116,639
2021,Gary Payton II,PG,28,GSW,10,0,40,10,13,0.769,2,4,0.5,8,9,0.889,0.846,3,4,0.75,2,9,11,1,6,1,1,8,25
2021,Norvel Pelle,C,27,BRK,3,0,28,3,7,0.429,0,0,NA,3,7,0.429,0.429,0,0,NA,3,4,7,0,0,3,3,9,6
2021,Norvel Pelle,C,27,SAC,1,0,4,0,1,0,0,0,NA,0,1,0,0,3,4,0.75,1,0,1,1,0,0,0,1,3
2021,Norvel Pelle,C,27,NYK,9,0,52,5,7,0.714,0,0,NA,5,7,0.714,0.714,1,2,0.5,2,9,11,1,1,6,0,4,11
2021,Mason Plumlee,C,30,DET,56,56,1499,234,381,0.614,0,7,0,234,374,0.626,0.614,113,169,0.669,145,374,519,202,43,50,105,186,581
2021,Otto Porter Jr.,SF,27,CHI,25,6,540,89,202,0.441,38,95,0.4,51,107,0.477,0.535,31,37,0.838,28,110,138,50,12,4,25,37,247
2021,Otto Porter Jr.,PF,27,ORL,3,0,66,9,25,0.36,1,9,0.111,8,16,0.5,0.38,5,5,1,0,14,14,5,4,0,0,4,24
2021,Bobby Portis,C,25,MIL,66,7,1372,313,598,0.523,74,157,0.471,239,441,0.542,0.585,54,73,0.74,124,342,466,71,52,26,56,115,754
2021,Dwight Powell,C,29,DAL,58,19,966,120,194,0.619,5,21,0.238,115,173,0.665,0.631,97,124,0.782,80,154,234,63,36,30,40,135,342
2021,Norman Powell,SG,27,TOR,42,31,1277,282,566,0.498,118,269,0.439,164,297,0.552,0.602,141,163,0.865,19,107,126,77,47,8,77,98,823
2021,Norman Powell,SF,27,POR,27,27,928,156,352,0.443,53,147,0.361,103,205,0.502,0.518,95,108,0.88,23,66,89,52,35,10,42,62,460
2021,Taurean Prince,PF,26,BRK,12,4,218,30,74,0.405,13,37,0.351,17,37,0.459,0.493,24,27,0.889,2,32,34,7,8,8,11,21,97
2021,Taurean Prince,PF,26,CLE,29,6,687,101,253,0.399,49,118,0.415,52,135,0.385,0.496,41,49,0.837,17,91,108,69,20,15,36,54,292
2021,Chasson Randle,PG,27,ORL,41,5,837,92,237,0.388,44,130,0.338,48,107,0.449,0.481,38,48,0.792,7,75,82,74,22,5,46,64,266
2021,J.J. Redick,SG,36,NOP,31,0,576,87,214,0.407,51,140,0.364,36,74,0.486,0.526,45,47,0.957,3,49,52,40,9,2,25,37,270
2021,J.J. Redick,SG,36,DAL,13,0,147,19,53,0.358,15,38,0.395,4,15,0.267,0.5,4,5,0.8,1,11,12,11,2,1,11,13,57
2021,Cameron Reynolds,SF,25,SAS,3,0,6,1,2,0.5,0,0,NA,1,2,0.5,0.5,0,0,NA,0,0,0,0,0,0,0,0,2
2021,Cameron Reynolds,SF,25,HOU,2,0,34,5,16,0.313,3,12,0.25,2,4,0.5,0.406,0,0,NA,2,3,5,2,0,0,0,2,13
2021,Austin Rivers,SG,28,NYK,21,2,442,58,135,0.43,28,77,0.364,30,58,0.517,0.533,10,14,0.714,5,42,47,42,12,0,22,32,154
2021,Austin Rivers,SG,28,DEN,15,5,403,46,110,0.418,27,72,0.375,19,38,0.5,0.541,12,17,0.706,3,32,35,39,18,2,14,32,131
2021,Glenn Robinson III,SF,27,SAC,23,2,369,42,99,0.424,16,44,0.364,26,55,0.473,0.505,21,23,0.913,11,34,45,20,4,3,11,23,121
2021,Jerome Robinson,SG,23,WAS,17,6,305,28,95,0.295,11,42,0.262,17,53,0.321,0.353,16,20,0.8,4,34,38,25,12,6,19,31,83
2021,Rajon Rondo,PG,34,ATL,27,2,402,44,110,0.4,17,45,0.378,27,65,0.415,0.477,1,2,0.5,4,51,55,95,19,2,39,25,106
2021,Rajon Rondo,PG,34,LAC,18,1,368,51,105,0.486,19,44,0.432,32,61,0.525,0.576,15,15,1,14,41,55,104,18,2,40,28,136
2021,Derrick Rose,PG,32,DET,15,0,342,79,184,0.429,13,39,0.333,66,145,0.455,0.465,42,50,0.84,6,23,29,63,18,4,29,17,213
2021,Derrick Rose,PG,32,NYK,35,3,937,208,427,0.487,37,90,0.411,171,337,0.507,0.53,68,77,0.883,14,87,101,146,31,15,49,39,521
2021,Terrence Ross,SG,29,ORL,46,2,1347,254,616,0.412,89,264,0.337,165,352,0.469,0.485,120,138,0.87,15,143,158,108,47,21,74,88,717
2021,D'Angelo Russell,PG,24,MIN,42,26,1196,281,652,0.431,120,310,0.387,161,342,0.471,0.523,114,149,0.765,16,95,111,244,45,18,112,68,796
2021,JaKarr Sampson,PF,27,IND,29,4,316,56,113,0.496,3,15,0.2,53,98,0.541,0.509,19,29,0.655,27,50,77,4,2,14,15,52,134
2021,Dario Šarić,C,26,PHO,50,4,871,153,342,0.447,47,135,0.348,106,207,0.512,0.516,84,99,0.848,46,144,190,65,30,4,57,95,437
2021,Mike Scott,PF,32,PHI,51,12,852,76,211,0.36,53,155,0.342,23,56,0.411,0.486,8,12,0.667,11,109,120,40,24,14,19,72,213
2021,Landry Shamet,SG,23,BRK,61,12,1403,186,456,0.408,129,333,0.387,57,123,0.463,0.549,66,78,0.846,11,101,112,99,31,10,48,93,567
2021,Iman Shumpert,SG,30,BRK,2,0,11,1,4,0.25,0,3,0,1,1,1,0.25,0,0,NA,1,0,1,0,1,0,1,0,2
2021,Chris Silva,PF,24,MIA,11,0,83,9,13,0.692,1,1,1,8,12,0.667,0.731,11,15,0.733,7,18,25,6,1,5,9,20,30
2021,Chris Silva,PF,24,SAC,4,0,9,1,3,0.333,0,0,NA,1,3,0.333,0.333,0,0,NA,0,2,2,0,0,1,1,4,2
2021,Dennis Smith Jr.,PG,23,NYK,3,0,28,2,10,0.2,0,4,0,2,6,0.333,0.2,5,6,0.833,0,2,2,3,3,0,1,4,9
2021,Dennis Smith Jr.,PG,23,DET,20,9,392,56,135,0.415,19,54,0.352,37,81,0.457,0.485,14,20,0.7,12,41,53,74,20,14,25,33,145
2021,Ish Smith,PG,32,WAS,44,1,924,129,297,0.434,18,49,0.367,111,248,0.448,0.465,19,33,0.576,22,128,150,172,32,13,41,62,295
2021,Ray Spalding,C,23,HOU,2,0,19,2,4,0.5,0,1,0,2,3,0.667,0.5,0,2,0,2,2,4,0,0,2,3,3,4
2021,Jeff Teague,PG,32,BOS,34,5,616,78,188,0.415,26,56,0.464,52,132,0.394,0.484,51,61,0.836,10,47,57,73,26,7,39,43,233
2021,Jeff Teague,PG,32,MIL,21,2,334,45,96,0.469,10,26,0.385,35,70,0.5,0.521,38,44,0.864,5,26,31,59,8,5,25,13,138
2021,Garrett Temple,SG,34,CHI,56,25,1528,158,381,0.415,67,200,0.335,91,181,0.503,0.503,40,50,0.8,29,131,160,124,43,30,58,126,423
2021,Daniel Theis,C,28,BOS,42,37,1027,159,288,0.552,33,95,0.347,126,193,0.653,0.609,46,67,0.687,54,166,220,67,25,43,41,120,397
2021,Daniel Theis,C,28,CHI,23,14,574,93,178,0.522,16,57,0.281,77,121,0.636,0.567,28,43,0.651,39,97,136,41,16,14,25,47,230
2021,Brodric Thomas,SG,24,HOU,4,0,24,2,7,0.286,1,6,0.167,1,1,1,0.357,5,7,0.714,1,3,4,4,1,1,4,5,10
2021,Brodric Thomas,SG,24,CLE,28,1,375,37,101,0.366,15,53,0.283,22,48,0.458,0.441,26,39,0.667,7,42,49,26,14,9,18,35,115
2021,Isaiah Thomas,PG,31,NOP,3,0,48,9,27,0.333,3,12,0.25,6,15,0.4,0.389,2,2,1,1,3,4,5,1,0,6,3,23
2021,Matt Thomas,SG,26,TOR,26,0,192,24,62,0.387,17,41,0.415,7,21,0.333,0.524,6,7,0.857,3,18,21,9,2,0,6,10,71
2021,Matt Thomas,SG,26,UTA,19,0,134,26,65,0.4,10,39,0.256,16,26,0.615,0.477,6,7,0.857,4,19,23,10,2,0,8,8,68
2021,Sindarius Thornwell,SG,26,NOP,14,1,73,7,21,0.333,3,9,0.333,4,12,0.333,0.405,0,2,0,1,4,5,4,5,1,4,3,17
2021,Sindarius Thornwell,SG,26,ORL,7,0,144,8,25,0.32,4,14,0.286,4,11,0.364,0.4,4,6,0.667,2,11,13,17,8,1,3,12,24
2021,Anthony Tolliver,PF,35,PHI,11,0,99,4,17,0.235,4,14,0.286,0,3,0,0.353,5,6,0.833,3,7,10,2,3,2,3,7,17
2021,Axel Toupane,SF,28,MIL,8,1,61,4,11,0.364,1,2,0.5,3,9,0.333,0.409,5,7,0.714,0,6,6,4,2,3,0,6,14
2021,Gary Trent Jr.,SG,22,POR,41,23,1262,217,524,0.414,121,305,0.397,96,219,0.438,0.53,58,75,0.773,21,70,91,58,37,6,31,63,613
2021,Gary Trent Jr.,SG,22,TOR,17,15,540,103,261,0.395,44,124,0.355,59,137,0.431,0.479,25,31,0.806,6,55,61,22,19,4,12,29,275
2021,P.J. Tucker,PF,35,HOU,32,32,959,48,131,0.366,27,86,0.314,21,45,0.467,0.469,18,23,0.783,33,115,148,45,29,18,33,91,141
2021,P.J. Tucker,PF,35,MIL,20,1,397,18,46,0.391,13,33,0.394,5,13,0.385,0.533,3,5,0.6,18,38,56,16,10,2,7,34,52
2021,Jonas Valančiūnas,C,28,MEM,62,61,1755,440,743,0.592,21,57,0.368,419,686,0.611,0.606,157,203,0.773,253,523,776,112,35,57,100,179,1058
2021,Jarred Vanderbilt,PF,21,MIN,64,30,1139,143,236,0.606,1,5,0.2,142,231,0.615,0.608,57,102,0.559,118,250,368,76,64,46,53,123,344
2021,Anderson Varejão,C,38,CLE,5,0,36,4,16,0.25,0,1,0,4,15,0.267,0.25,5,9,0.556,7,13,20,3,0,2,1,3,13
2021,Noah Vonleh,C,25,BRK,4,0,11,0,3,0,0,2,0,0,1,0,0,0,0,NA,0,1,1,1,0,0,2,2,0
2021,Nikola Vučević,C,30,ORL,44,44,1500,436,908,0.48,117,288,0.406,319,620,0.515,0.545,91,110,0.827,87,430,517,167,42,28,83,79,1080
2021,Nikola Vučević,C,30,CHI,26,26,848,230,488,0.471,59,152,0.388,171,336,0.509,0.532,40,46,0.87,59,241,300,102,23,20,43,58,559
2021,Moritz Wagner,C,23,WAS,25,13,375,62,122,0.508,13,42,0.31,49,80,0.613,0.561,41,52,0.788,13,60,73,32,22,8,21,62,178
2021,Moritz Wagner,C,23,BOS,9,1,61,4,14,0.286,2,6,0.333,2,8,0.25,0.357,1,2,0.5,3,16,19,6,0,1,9,10,11
2021,Moritz Wagner,C,23,ORL,11,10,286,38,93,0.409,16,43,0.372,22,50,0.44,0.495,29,33,0.879,11,43,54,12,4,9,13,36,121
2021,Brad Wanamaker,PG,31,GSW,39,0,625,61,173,0.353,13,61,0.213,48,112,0.429,0.39,50,56,0.893,8,58,66,99,26,6,37,55,185
2021,Brad Wanamaker,PG,31,CHO,22,0,428,54,126,0.429,3,24,0.125,51,102,0.5,0.44,40,45,0.889,10,29,39,75,17,5,34,39,151
2021,Paul Watson,SF,26,TOR,27,2,297,38,82,0.463,30,64,0.469,8,18,0.444,0.646,5,8,0.625,4,41,45,17,6,3,9,36,111
2021,Andrew Wiggins,PF,25,GSW,71,71,2364,505,1058,0.477,140,368,0.38,365,690,0.529,0.543,170,238,0.714,82,265,347,167,67,70,126,159,1320
2021,Lou Williams,PG,34,LAC,42,3,918,181,430,0.421,45,119,0.378,136,311,0.437,0.473,103,119,0.866,15,73,88,144,39,4,66,42,510
2021,Lou Williams,PG,34,ATL,24,1,505,84,216,0.389,24,54,0.444,60,162,0.37,0.444,47,54,0.87,6,44,50,81,8,2,42,20,239
2021,D.J. Wilson,PF,24,MIL,12,0,105,16,43,0.372,10,28,0.357,6,15,0.4,0.488,1,2,0.5,3,22,25,3,1,4,4,13,43
2021,D.J. Wilson,PF,24,HOU,23,1,328,52,125,0.416,20,59,0.339,32,66,0.485,0.496,16,23,0.696,17,70,87,20,10,12,18,31,140
2021,Christian Wood,C,25,HOU,41,41,1326,329,640,0.514,77,206,0.374,252,434,0.581,0.574,125,198,0.631,76,319,395,71,34,48,80,88,860
2021,Delon Wright,SG,28,DET,36,31,1052,136,293,0.464,31,89,0.348,105,204,0.515,0.517,71,90,0.789,37,127,164,181,58,19,48,45,374
2021,Delon Wright,PG,28,SAC,27,8,696,104,225,0.462,33,83,0.398,71,142,0.5,0.536,30,36,0.833,28,77,105,97,43,11,35,30,271
2021,Thaddeus Young,PF,32,CHI,68,23,1652,370,662,0.559,12,45,0.267,358,617,0.58,0.568,71,113,0.628,168,255,423,291,74,40,137,152,823
2021,Ivica Zubac,C,23,LAC,72,33,1609,257,394,0.652,1,4,0.25,256,390,0.656,0.654,135,171,0.789,189,330,519,90,24,62,81,187,650
